Id,Label,modularity_class,indegree,outdegree,degree,X,Y,Size,Color
11084,hdh,46,9,0,9,0.436616,0.519612,0.002435,"#ffb800"
35993,jbj,39,0,5,5,0.327461,0.336041,0.000487,"#00e8b2"
60283,javierleiva,21,6,0,6,0.445717,0.620292,0.000974,"#006032"
61253,javiermoya,1,11,7,18,0.345961,0.5407,0.006819,"#825403"
62963,jjmerelo,15,0,6,6,0.465257,0.51901,0.000974,"#006032"
420343,uam,49,7,0,7,0.432741,0.511891,0.001461,"#ffa64e"
712963,paulasimoes,39,15,19,34,0.463663,0.469725,0.014613,"#00e8b2"
760807,lacordero,5,8,4,12,0.343904,0.35637,0.003897,"#ff9b8f"
763841,Hipertextual,46,4,0,4,0.43465,0.622945,0,"#ffb800"
782482,paw,0,0,4,4,0.395384,0.389043,0,"#ff77ff"
792920,ecerverab,15,2,3,5,0.48356,0.546976,0.000487,"#ff0d69"
807095,nytimes,46,5,0,5,0.424308,0.569821,0.000487,"#ffb800"
816178,MADRID,28,69,0,69,0.503171,0.31467,0.031661,"#8ecfec"
823905,wordpressdotcom,28,24,0,24,0.403536,0.597759,0.009742,"#8ecfec"
941401,textundblog,0,1,6,7,0.415247,0.459541,0.001461,"#3e93ff"
1091241,jfreire,17,12,2,14,0.381202,0.573382,0.004871,"#3bec00"
1344951,WIRED,28,9,0,9,0.402748,0.414001,0.002435,"#00e8b2"
1818181,jairogalindo,26,14,11,25,0.21551,0.553771,0.010229,"#3bec00"
2170361,olea,1,4,0,4,0.667677,0.663713,0,"#ff12a3"
2280391,adolfoestalella,48,3,3,6,0.42034,0.309282,0.000974,"#ff0d69"
2331061,nopiedra,12,1,6,7,0.409188,0.536644,0.001461,"#ff77ff"
2437791,Sr_Sotomonte,48,1,3,4,0.525595,0.576265,0,"#ff0d69"
2676431,juleniturbe,35,7,6,13,0.642776,0.569527,0.004384,"#008ebb"
2931631,kavango,46,15,49,64,0.387497,0.543298,0.029226,"#ffb800"
2953551,magpie,12,27,3,30,0.386765,0.438525,0.012664,"#ff77ff"
3122211,eraser,1,58,42,100,0.418812,0.45899,0.046761,"#825403"
3365101,versae,46,11,31,42,0.414572,0.498786,0.018509,"#ffb800"
3926511,jborrego,46,0,14,14,0.404069,0.508951,0.004871,"#ffb800"
4046891,ganyet,14,21,2,23,0.568413,0.361879,0.009255,"#b6cb00"
4052731,cesarastudillo,21,6,1,7,0.572535,0.420343,0.001461,"#ffa64e"
4386321,LA,28,4,0,4,0.339428,0.567934,0,"#8ecfec"
5033321,elmorsa,15,0,4,4,0.542613,0.435923,0,"#006032"
5044731,dagosalas,46,1,8,9,0.382576,0.474135,0.002435,"#3bec00"
5127621,upo,22,14,0,14,0.61916,0.535515,0.004871,"#8ecfec"
5251921,julianab,22,5,7,12,0.392538,0.546047,0.003897,"#8ecfec"
5444722,sarok,48,0,11,11,0.477618,0.47085,0.00341,"#006032"
5493242,DiariodeNavarra,49,6,0,6,0.552208,0.481147,0.000974,"#8ecfec"
5520702,esponjita,15,2,3,5,0.511676,0.477244,0.000487,"#ff0d69"
5695032,Yale,1,8,0,8,0.398188,0.525029,0.001948,"#ff12a3"
5713842,antonigr,1,1,5,6,0.402967,0.544058,0.000974,"#825403"
5776732,pbongiovanni,36,14,8,22,0.346596,0.595763,0.008768,"#3bec00"
5967322,jcmorocho,12,0,4,4,0.327477,0.447454,0,"#ff77ff"
6108882,jmcclurken,12,0,4,4,0.225555,0.434413,0,"#ff77ff"
6567482,acastrillejo,46,0,5,5,0.453751,0.485706,0.000487,"#ffb800"
6643882,javiercelaya,1,19,2,21,0.472319,0.604544,0.008281,"#008ebb"
6752632,flamencastone,46,6,0,6,0.458215,0.580051,0.000974,"#ffb800"
6771532,lukasnet,17,4,5,9,0.361193,0.612858,0.002435,"#3bec00"
6964542,alejandroangel,19,6,3,9,0.458014,0.312534,0.002435,"#3e93ff"
7067082,PedroCarrillo,22,20,66,86,0.393753,0.511508,0.039942,"#8ecfec"
7157292,bourdieu,26,4,5,9,0.554053,0.480283,0.002435,"#3e93ff"
7272222,eurom,21,4,0,4,0.574343,0.768673,0,"#ffa64e"
7334402,alfranken,46,4,0,4,0.33483,0.644884,0,"#3bec00"
7465672,quinnanya,12,26,9,35,0.359317,0.465763,0.0151,"#ff77ff"
7506322,edmundogs,17,20,7,27,0.366659,0.589812,0.011203,"#3bec00"
7910642,parselis,17,3,5,8,0.364244,0.628356,0.001948,"#3bec00"
7938852,historiador,48,8,0,8,0.59928,0.367873,0.001948,"#008ebb"
7996082,el_pais,15,67,1,68,0.517188,0.601132,0.031174,"#ffb800"
8083032,nimbusaeta,49,27,18,45,0.433573,0.547607,0.019971,"#ffa64e"
8087392,polisea,15,176,65,241,0.472464,0.516083,0.115441,"#006032"
8097602,Aina_Borras,15,5,11,16,0.425091,0.507076,0.005845,"#ff0d69"
8099802,neuromancien,46,3,8,11,0.410744,0.493211,0.00341,"#ffb800"
8168562,elcomercio,15,5,0,5,0.511855,0.473652,0.000487,"#006032"
8301552,AnthonyMasure,0,4,8,12,0.412718,0.519766,0.003897,"#ffb800"
8536532,tnor27,12,0,5,5,0.325904,0.458832,0.000487,"#ff77ff"
8627932,ictlogist,17,17,8,25,0.444548,0.461727,0.010229,"#006032"
8639402,madrimasd,48,7,6,13,0.528599,0.669209,0.004384,"#008ebb"
8729462,evamoraga,46,10,1,11,0.40741,0.55876,0.00341,"#ffb800"
8742642,evamen,46,10,11,21,0.396413,0.584395,0.008281,"#ffb800"
8816652,busuab,48,0,5,5,0.527176,0.545463,0.000487,"#ff0d69"
8831402,tristan_roddis,39,6,2,8,0.359512,0.383257,0.001948,"#00e8b2"
8874622,mind_booster,39,0,5,5,0.470916,0.43363,0.000487,"#00e8b2"
9276252,terenet,48,68,74,142,0.473058,0.579598,0.067219,"#008ebb"
9546132,Wilsofo,12,2,5,7,0.418629,0.412709,0.001461,"#ff77ff"
9557662,juglardelzipa,12,0,4,4,0.39997,0.298198,0,"#ff77ff"
9590442,patjarmar,19,6,5,11,0.435667,0.529635,0.00341,"#00ed5d"
9633802,ELTIEMPO,19,4,0,4,0.546882,0.464976,0,"#00ed5d"
9676152,SlideShare,46,24,0,24,0.34788,0.511487,0.009742,"#3bec00"
9751592,yobiblioteca,46,12,2,14,0.383444,0.589941,0.004871,"#3bec00"
9758512,prensa14,1,64,4,68,0.35706,0.547982,0.031174,"#825403"
9785862,omeka,39,12,3,15,0.421122,0.44708,0.005358,"#00e8b2"
9846452,paualsina,15,7,19,26,0.435838,0.504983,0.010716,"#ff0d69"
9893772,zotero,12,34,0,34,0.338336,0.469695,0.014613,"#ff77ff"
9894072,mvjbomfim,39,1,8,9,0.398758,0.251298,0.002435,"#00e8b2"
10135862,samadeu,39,4,2,6,0.375145,0.266355,0.000974,"#00e8b2"
10162032,Soares_LucianoS,12,0,7,7,0.390047,0.351529,0.001461,"#ff77ff"
10164002,constnz,46,1,5,6,0.323752,0.564097,0.000974,"#3bec00"
10228272,YouTube,46,92,0,92,0.454435,0.488694,0.042864,"#ffb800"
10278552,craiublletres,48,0,5,5,0.484615,0.589887,0.000487,"#008ebb"
10342242,pabloescandon,48,0,22,22,0.440028,0.532628,0.008768,"#008ebb"
10397822,danipsicologa80,46,0,6,6,0.329357,0.506148,0.000974,"#3bec00"
10535552,ricardov_cl,10,7,14,21,0.295513,0.452431,0.008281,"#3bec00"
10602772,joakinen,48,6,6,12,0.265422,0.583018,0.003897,"#008ebb"
10609732,teadira,50,2,3,5,0.539196,0.388569,0.000487,"#008bdd"
10805852,enmarcha,48,3,1,4,0.42577,0.314712,0,"#3e93ff"
10832182,asantimartinez,26,6,0,6,0.33796,0.399846,0.000974,"#3e93ff"
10863952,rubenman,12,0,4,4,0.381986,0.401688,0,"#ff77ff"
11025592,Maperez324,0,0,34,34,0.364639,0.497854,0.014613,"#3e93ff"
11112192,veek,46,8,2,10,0.334431,0.479322,0.002923,"#3bec00"
11297602,ivdacruz,1,0,5,5,0.34617,0.506504,0.000487,"#825403"
11327242,felixlozano,48,14,10,24,0.528792,0.514566,0.009742,"#008ebb"
11332442,FIDRomanistik,0,28,102,130,0.396226,0.496403,0.061374,"#3e93ff"
11440702,jjbotev,46,0,6,6,0.396322,0.531809,0.000974,"#ffb800"
11553312,aovalle,12,0,4,4,0.342397,0.42907,0,"#ff77ff"
11919222,Aulo,48,2,3,5,0.299586,0.585259,0.000487,"#ffb800"
12035172,patana,46,31,21,52,0.314199,0.475879,0.02338,"#3bec00"
12344732,pilica,15,4,2,6,0.540779,0.484744,0.000974,"#ff0d69"
12346172,metik,0,2,6,8,0.387718,0.422017,0.001948,"#3e93ff"
12563152,mauricioangel,19,0,4,4,0.400651,0.446437,0,"#00ed5d"
12632702,redpuntoes,1,20,0,20,0.363886,0.585412,0.007793,"#825403"
12725692,piscitelli,17,214,69,283,0.379162,0.581794,0.135899,"#3bec00"
12815132,elmostrador,32,8,0,8,0.669692,0.457958,0.001948,"#00ed5d"
13257922,manovich,0,26,7,33,0.404056,0.513641,0.014126,"#ffb800"
13312312,jhidalgo,50,6,1,7,0.532112,0.425114,0.001461,"#3bec00"
13323622,anadefinisterra,39,0,5,5,0.420992,0.321825,0.000487,"#00e8b2"
13344262,sms2sms,39,1,9,10,0.346965,0.289573,0.002923,"#00e8b2"
13493522,saandreoli,46,7,7,14,0.235515,0.569215,0.004871,"#3bec00"
13745182,mgiraldo,19,11,5,16,0.530267,0.38993,0.005845,"#00ed5d"
13790232,mapc,10,0,8,8,0.223083,0.366146,0.001948,"#3bec00"
13883652,danimoi2,46,2,2,4,0.45454,0.618011,0,"#ffb800"
14075146,libreros,39,24,11,35,0.507656,0.544848,0.0151,"#00e8b2"
14078152,alexbensan,49,3,5,8,0.37353,0.593248,0.001948,"#ffb800"
14078613,ERamirez_,0,0,5,5,0.356972,0.488291,0.000487,"#ffb800"
14084406,gworthey,0,15,29,44,0.372396,0.448925,0.019484,"#3e93ff"
14086502,mdalmau,46,2,4,6,0.327019,0.497455,0.000974,"#3bec00"
14086852,UMD_MITH,46,31,6,37,0.335175,0.502854,0.016074,"#3bec00"
14089054,fraistat,0,0,8,8,0.393228,0.474688,0.001948,"#3e93ff"
14093970,estebanmoro,27,0,4,4,0.921903,0.179882,0,"#00ed5d"
14112146,ngc2020,46,0,5,5,0.400043,0.576511,0.000487,"#3bec00"
14114461,angelalmarza,12,9,33,42,0.366814,0.468896,0.018509,"#ff77ff"
14136205,padaguan,0,14,5,19,0.372276,0.368318,0.007306,"#3e93ff"
14149194,KiriCarini,12,5,1,6,0.334394,0.417558,0.000974,"#00e8b2"
14178113,xpectro,17,4,0,4,0.358339,0.560162,0,"#3bec00"
14184585,alaznegonzalez,17,3,1,4,0.507728,0.635838,0,"#008ebb"
14214983,emastromatteo,46,4,12,16,0.410191,0.509285,0.005845,"#3bec00"
14215044,jserranom,48,7,1,8,0.528276,0.582082,0.001948,"#008ebb"
14216117,harmodio,50,3,3,6,0.273528,0.497053,0.000974,"#3e93ff"
14221013,nowviskie,0,3,6,9,0.369496,0.452289,0.002435,"#3e93ff"
14229832,Adam_Crymble,12,70,23,93,0.376915,0.43536,0.043351,"#ff77ff"
14233770,piotrr70,46,2,9,11,0.421286,0.517587,0.00341,"#ffb800"
14234902,benwbrum,46,8,7,15,0.363497,0.430795,0.005358,"#ff77ff"
14299702,diegopimentel,46,7,3,10,0.280252,0.584005,0.002923,"#3bec00"
14308843,kfitz,0,7,8,15,0.325339,0.443129,0.005358,"#ffb800"
14309193,guzmanadrian,17,0,4,4,0.365872,0.590489,0,"#3bec00"
14331818,edsu,39,2,9,11,0.350346,0.340278,0.00341,"#00e8b2"
14349708,esparver,14,0,4,4,0.626992,0.180604,0,"#b6cb00"
14359862,marianorico,48,8,2,10,0.451656,0.62612,0.002923,"#008ebb"
14394972,torressalinas,15,4,2,6,0.53015,0.531665,0.000974,"#006032"
14436030,elmundoes,49,16,0,16,0.417648,0.494543,0.005845,"#ffa64e"
14468423,laurien,42,7,8,15,0.336244,0.323402,0.005358,"#005076"
14517051,renataaquino,46,0,5,5,0.408311,0.557784,0.000487,"#3bec00"
14522154,felipecl,19,10,9,19,0.595957,0.62123,0.007306,"#5456a6"
14526209,ravsirius,48,4,2,6,0.405972,0.606946,0.000974,"#008ebb"
14564385,juanibelbis,46,3,6,9,0.304646,0.50897,0.002435,"#3bec00"
14570718,lisaspiro,0,8,0,8,0.3554,0.433367,0.001948,"#3e93ff"
14571948,arenitasoria,10,12,9,21,0.285199,0.417766,0.008281,"#00ed5d"
14573832,hiperterminal,19,4,6,10,0.482969,0.381852,0.002923,"#6c241e"
14585572,pmhswe,12,1,5,6,0.284589,0.418305,0.000974,"#ff77ff"
14605554,elli_m,46,8,2,10,0.337664,0.484169,0.002923,"#3bec00"
14606609,tithius,46,9,2,11,0.333849,0.549269,0.00341,"#3bec00"
14620824,congosto,21,3,5,8,0.47086,0.614363,0.001948,"#ffa64e"
14661530,jmarinpu,14,0,5,5,0.432131,0.338623,0.000487,"#b6cb00"
14667145,knagasaki,0,0,17,17,0.350569,0.447016,0.006332,"#ffb800"
14698820,mrsnorris,48,0,13,13,0.489618,0.636362,0.004384,"#008ebb"
14726505,WalterScolz,46,4,0,4,0.358214,0.551588,0,"#3bec00"
14758529,cescept,49,3,9,12,0.441408,0.626891,0.003897,"#ff0d69"
14790618,epiccino,39,4,0,4,0.494588,0.007832,0,"#00e8b2"
14821116,charlley,15,3,4,7,0.493995,0.43218,0.001461,"#ff0d69"
14834302,elespectador,19,92,1,93,0.364575,0.71102,0.043351,"#ff77ff"
14842401,balhisay,15,4,2,6,0.520719,0.519462,0.000974,"#006032"
14846961,joguldi,46,2,2,4,0.465744,0.507735,0,"#008ebb"
14919552,UOCuniversitat,15,4,3,7,0.497027,0.529592,0.001461,"#ff0d69"
14960548,acorsin,48,11,3,14,0.485083,0.524176,0.004871,"#008ebb"
14963436,tapiador,48,4,2,6,0.43134,0.552099,0.000974,"#ff0d69"
14992915,ilazaro,48,0,6,6,0.554248,0.551143,0.000974,"#008ebb"
15039663,eitb,48,5,0,5,0.491499,0.80687,0.000487,"#008ebb"
15057943,MuseumModernArt,0,4,0,4,0.36585,0.486524,0,"#3e93ff"
15118387,sociologiac,26,4,1,5,0.672268,0.543353,0.000487,"#3e93ff"
15121709,c0nsaf0s,12,0,6,6,0.292695,0.40606,0.000974,"#ff77ff"
15135596,tarciziosilva,39,10,11,21,0.383516,0.259598,0.008281,"#00e8b2"
15145256,armartinell,0,24,58,82,0.369638,0.467167,0.037993,"#3e93ff"
15175262,scholarslab,12,2,7,9,0.310579,0.432784,0.002435,"#ff77ff"
15181766,marmenes,36,17,8,25,0.267508,0.470874,0.010229,"#6c241e"
15200482,dalareo,48,0,4,4,0.52063,0.559425,0,"#008ebb"
15211031,Coatl_S,17,5,5,10,0.376781,0.57663,0.002923,"#3bec00"
15232111,CinematecaBta,19,6,2,8,0.79666,0.43851,0.001948,"#00ed5d"
15233333,inactinique,46,9,0,9,0.406326,0.471657,0.002435,"#ffb800"
15257730,lachamba,48,0,6,6,0.410411,0.515099,0.000974,"#ff77ff"
15258078,jesusangelpardo,15,2,3,5,0.565177,0.64829,0.000487,"#006032"
15272863,toririo,0,4,2,6,0.328984,0.393815,0.000974,"#ff77ff"
15283118,colfreepress,17,0,19,19,0.363039,0.497899,0.007306,"#3bec00"
15287607,nandanamihindu,48,0,6,6,0.470863,0.655305,0.000974,"#008ebb"
15318025,jamescummings,49,1,9,10,0.36425,0.478837,0.002923,"#3bec00"
15343494,ztante,0,1,4,5,0.363725,0.444279,0.000487,"#3e93ff"
15378599,manlopez,37,5,5,10,0.565891,0.610458,0.002923,"#ffb800"
15378611,FGV,26,13,0,13,0.372806,0.303703,0.004384,"#3e93ff"
15383357,Ricard_Ramon,15,7,7,14,0.51495,0.464409,0.004871,"#006032"
15392976,robertotheron,49,4,0,4,0.349745,0.648698,0,"#ff0d69"
15404821,mincultura,19,32,1,33,0.497724,0.409004,0.014126,"#00ed5d"
15432179,raulpacheco,27,3,9,12,0.509139,0.320408,0.003897,"#00ed5d"
15449070,brettbobley,46,7,1,8,0.3681,0.49971,0.001948,"#ffb800"
15460048,MIT,14,11,0,11,0.499152,0.411251,0.00341,"#b6cb00"
15468302,danidominguez,48,5,0,5,0.588498,0.530113,0.000487,"#008ebb"
15468474,UNED,46,249,11,260,0.425916,0.56443,0.124696,"#ffb800"
15475282,gregniemeyer,15,5,4,9,0.457656,0.496909,0.002435,"#ff0d69"
15581283,heraldoes,25,4,1,5,0.239074,0.584322,0.000487,"#ff0d69"
15635191,FILGuadalajara,1,16,0,16,0.340346,0.477644,0.005845,"#825403"
15637375,UTAustin,0,8,0,8,0.358083,0.49193,0.001948,"#3e93ff"
15655137,gwijthoff,12,31,0,31,0.375141,0.438416,0.013151,"#ff77ff"
15661113,marionlame,39,2,2,4,0.510563,0.435972,0,"#00e8b2"
15695712,JoseCarlosTecno,19,6,0,6,0.561311,0.349252,0.000974,"#00ed5d"
15725794,planetanews,12,3,1,4,0.402262,0.417572,0,"#ff77ff"
15762276,scott_bot,12,38,17,55,0.378858,0.455036,0.024842,"#ff77ff"
15777344,ivanvladimir,0,1,5,6,0.380345,0.415793,0.000974,"#3e93ff"
15837147,sigridth,15,0,4,4,0.491536,0.501668,0,"#006032"
15869696,Jonathangp,0,24,60,84,0.38341,0.441416,0.038967,"#3e93ff"
15901999,fundacionTef,1,106,15,121,0.336817,0.532497,0.05699,"#825403"
15988093,INEHRM,2,19,0,19,0.496767,0.326823,0.007306,"#3e93ff"
15993641,arey,48,8,6,14,0.533805,0.530324,0.004871,"#008ebb"
15997828,vVvA,12,7,13,20,0.394969,0.426826,0.007793,"#ff77ff"
16009158,undars2,0,8,0,8,0.409415,0.447974,0.001948,"#3e93ff"
16040246,josir,39,5,4,9,0.375346,0.446604,0.002435,"#00e8b2"
16041373,rpastorvargas,46,0,5,5,0.477312,0.574519,0.000487,"#ffb800"
16070146,dcasacuberta,48,9,4,13,0.559218,0.47189,0.004384,"#ff0d69"
16085411,danielescandell,46,43,18,61,0.389107,0.522874,0.027764,"#8ecfec"
16126366,UOCuniversidad,15,5,5,10,0.472489,0.521513,0.002923,"#ff0d69"
16132544,IthacaCollege,12,5,0,5,0.315966,0.403372,0.000487,"#ff77ff"
16143105,OKFN,12,2,2,4,0.363689,0.404622,0,"#ff77ff"
16149989,trevormunoz,12,16,5,21,0.287795,0.433292,0.008281,"#ff77ff"
16248551,RominaGironP,0,0,4,4,0.337679,0.387083,0,"#3e93ff"
16267722,hcayless,49,1,3,4,0.264157,0.494814,0,"#3bec00"
16279554,rhemalinder,0,0,5,5,0.348631,0.494664,0.000487,"#ffb800"
16287595,leoba,39,0,6,6,0.321382,0.405075,0.000974,"#00e8b2"
16337414,jujox,46,11,6,17,0.375486,0.541654,0.006332,"#ffb800"
16422908,leormoz,19,0,6,6,0.453806,0.467181,0.000974,"#00ed5d"
16509913,AdrianSantuario,3,6,0,6,0.231662,0.715836,0.000974,"#3e93ff"
16511311,fluipe,12,0,5,5,0.429028,0.260159,0.000487,"#6c241e"
16530643,albertsierra_re,48,1,3,4,0.416986,0.600149,0,"#008ebb"
16571064,epriani,0,318,274,592,0.395931,0.450035,0.28641,"#3e93ff"
16576356,museodelprado,46,10,0,10,0.292482,0.512323,0.002923,"#ffb800"
16590605,pedro_jordano,46,4,1,5,0.467016,0.542402,0.000487,"#ffb800"
16616217,TimHitchcock,12,0,9,9,0.396161,0.430106,0.002435,"#ff77ff"
16627003,jordi_a,48,4,2,6,0.370826,0.480296,0.000974,"#3e93ff"
16656420,sarahsimpkin,12,40,0,40,0.373046,0.438667,0.017535,"#ff77ff"
16673390,tfeliz,46,0,6,6,0.394608,0.569026,0.000974,"#ffb800"
16676396,El_Universal_Mx,8,54,1,55,0.758496,0.220872,0.024842,"#3e93ff"
16708593,fendt,0,5,0,5,0.381647,0.462263,0.000487,"#3e93ff"
16784012,rguareschi,17,15,9,24,0.362866,0.590953,0.009742,"#3bec00"
16808626,bbva,15,15,1,16,0.476683,0.52379,0.005845,"#ff0d69"
17025362,cristobalcobo,17,23,2,25,0.312582,0.512097,0.010229,"#006032"
17025735,txescu,48,1,36,37,0.434368,0.56392,0.016074,"#008ebb"
17106158,Piamonte,46,0,4,4,0.508194,0.513504,0,"#ffb800"
17152842,unav,49,89,0,89,0.524439,0.462497,0.041403,"#8ecfec"
17158016,vlahebo,19,0,4,4,0.450053,0.482288,0,"#3e93ff"
17168087,jguallar,48,13,11,24,0.471961,0.543484,0.009742,"#008ebb"
17177403,plevy,1,13,6,19,0.534418,0.440783,0.007306,"#825403"
17199281,hurukuta,15,1,3,4,0.442955,0.453298,0,"#ffb800"
17231726,NaTransversal,39,0,11,11,0.406892,0.329134,0.00341,"#00e8b2"
17247774,jesuslau,46,0,4,4,0.331876,0.536014,0,"#3bec00"
17278005,CarlosSanzDiaz,46,4,0,4,0.455609,0.601276,0,"#ffb800"
17440110,biblioteca_uc3m,15,19,10,29,0.459463,0.607585,0.012177,"#006032"
17465506,PesquisaFapesp,39,4,0,4,0.627209,0.524283,0,"#00e8b2"
17471538,redHD,0,10,0,10,0.438327,0.440318,0.002923,"#3e93ff"
17490510,juandoming,17,3,9,12,0.450011,0.553036,0.003897,"#008ebb"
17508247,alafuente,48,65,51,116,0.502077,0.510853,0.054554,"#008ebb"
17525491,entretic,28,2,6,8,0.456698,0.54965,0.001948,"#8ecfec"
17534607,richardrogers,36,17,2,19,0.310707,0.517424,0.007306,"#6c241e"
17538765,PerezLatre,49,0,4,4,0.562451,0.531196,0,"#8ecfec"
17563531,mdrechsler,1,1,3,4,0.471934,0.510552,0,"#825403"
17572957,MauricioJaramil,19,5,37,42,0.530779,0.485336,0.018509,"#00ed5d"
17603106,quiquesr,6,5,1,6,0.829774,0.392313,0.000974,"#006032"
17623016,leifuss,46,8,0,8,0.368125,0.489348,0.001948,"#3bec00"
17631406,DialogoUPR,13,4,1,5,0.028931,0.49081,0.000487,"#3a8724"
17651925,NuFdzTor,46,5,8,13,0.385017,0.522233,0.004384,"#ffb800"
17688219,andresgattinoni,12,1,5,6,0.393284,0.41937,0.000974,"#ff77ff"
17751281,aburbano,12,2,3,5,0.464298,0.406009,0.000487,"#ff77ff"
17752454,esdi,14,5,0,5,0.630095,0.211615,0.000487,"#b6cb00"
17777882,urjc,25,10,0,10,0.455585,0.480963,0.002923,"#8ecfec"
17846352,estudosdemidia,39,6,0,6,0.422086,0.322034,0.000974,"#00e8b2"
17872758,unican,48,19,3,22,0.462256,0.597931,0.008768,"#008ebb"
17973773,Markotom,0,12,10,22,0.346034,0.474693,0.008768,"#3e93ff"
18036441,Stanford,15,5,0,5,0.44779,0.561662,0.000487,"#8ecfec"
18047541,0TRANADA,15,0,4,4,0.567893,0.54967,0,"#006032"
18059285,ernestopriego,0,128,46,174,0.386661,0.427206,0.082806,"#3e93ff"
18102873,futuroslibro,48,42,5,47,0.527254,0.498683,0.020945,"#3e93ff"
18116148,denobisipsis,48,3,5,8,0.379852,0.655676,0.001948,"#008ebb"
18129652,wragge,12,0,5,5,0.348938,0.434105,0.000487,"#ff77ff"
18139026,galecengage,10,7,0,7,0.35786,0.365831,0.001461,"#3bec00"
18200400,xataka,48,5,0,5,0.388906,0.657192,0.000487,"#008ebb"
18242628,kyrey,5,8,4,12,0.34758,0.349095,0.003897,"#ff9b8f"
18245049,thaispereira,39,2,3,5,0.355102,0.250072,0.000487,"#00e8b2"
18330892,IvanHerCaz,37,2,15,17,0.383954,0.539486,0.006332,"#ffb800"
18334557,arthurocrates,0,0,6,6,0.316054,0.402779,0.000974,"#3e93ff"
18342865,tonapou,49,2,5,7,0.45403,0.673383,0.001461,"#ff0d69"
18358699,cscolari,17,30,10,40,0.409296,0.583526,0.017535,"#3bec00"
18379914,Pharsiffal,0,0,5,5,0.379312,0.477891,0.000487,"#3e93ff"
18510558,el_BID,15,20,0,20,0.695462,0.942229,0.007793,"#006032"
18512377,ealmirall,14,5,0,5,0.601587,0.284215,0.000487,"#b6cb00"
18539194,marcelamomberg,25,1,6,7,0.386262,0.573636,0.001461,"#ff0d69"
18588154,indierod,19,2,4,6,0.325886,0.218131,0.000974,"#ff77ff"
18617095,julia_flanders,12,7,0,7,0.305215,0.424111,0.001461,"#ff77ff"
18828843,pedrosaliba,39,1,3,4,0.380801,0.346029,0,"#00e8b2"
18981239,postgradoUPO,22,17,3,20,0.34066,0.524502,0.007793,"#8ecfec"
19000141,ProjectMUSE,36,6,2,8,0.408303,0.43111,0.001948,"#ff77ff"
19002571,LauraBorras,37,33,19,52,0.488063,0.518934,0.02338,"#fcae7e"
19027994,estebanllorens,6,12,8,20,0.736669,0.433902,0.007793,"#006032"
19116339,angelalvarez,1,0,6,6,0.358506,0.566103,0.000974,"#825403"
19193598,ullyot,46,7,2,9,0.34602,0.53219,0.002435,"#3bec00"
19350237,robsongfreire,39,2,3,5,0.664602,0.302021,0.000487,"#00e8b2"
19374202,cenfoto_udp,10,2,3,5,0.28556,0.432939,0.000487,"#3bec00"
19392745,danielrruf,48,84,98,182,0.41349,0.591937,0.086702,"#008ebb"
19531716,fgouveia,39,3,2,5,0.396127,0.370276,0.000487,"#00e8b2"
19537216,30dientes,19,38,26,64,0.413645,0.374346,0.029226,"#ff77ff"
19607259,mtenaespinoza,0,7,11,18,0.38787,0.488432,0.006819,"#3e93ff"
19705196,UCC,46,16,0,16,0.420206,0.451892,0.005845,"#ffb800"
19706254,TimUnwin,39,1,12,13,0.417303,0.454098,0.004384,"#ff0d69"
19712523,FCGulbenkian,39,4,0,4,0.444731,0.392501,0,"#00e8b2"
19717756,Huhezi,35,12,7,19,0.611904,0.591217,0.007306,"#008ebb"
19726230,ucatolica,32,20,1,21,0.161336,0.234802,0.008281,"#00ed5d"
19770809,theklaneh,48,4,4,8,0.52004,0.915058,0.001948,"#008ebb"
19890438,misaito,10,1,5,6,0.310684,0.416464,0.000974,"#3bec00"
19907166,nolauren,12,26,5,31,0.378177,0.45433,0.013151,"#ff77ff"
19919242,esenabre,48,10,0,10,0.519059,0.5548,0.002923,"#008ebb"
19923515,abc_es,15,4,0,4,0.491531,0.55289,0,"#006032"
20024751,zerojuls,17,0,5,5,0.363972,0.62346,0.000487,"#3bec00"
20034656,politonaiz,0,39,88,127,0.401281,0.48368,0.059912,"#3e93ff"
20045580,fiocruz,39,7,2,9,0.461096,0.209175,0.002435,"#00e8b2"
20058795,campuspartyco,19,4,0,4,0.526337,0.438459,0,"#00ed5d"
20073834,paulacarina,39,1,4,5,0.431371,0.307596,0.000487,"#00e8b2"
20080117,gajodeluz,0,0,21,21,0.388366,0.437645,0.008281,"#3e93ff"
20156540,data__coso,19,0,4,4,0.447717,0.66387,0,"#3e93ff"
20172480,artepublico,12,17,7,24,0.297416,0.43562,0.009742,"#ff77ff"
20175733,fcampal,46,1,4,5,0.399053,0.53999,0.000487,"#ffb800"
20190072,fesabid,46,3,4,7,0.393045,0.588697,0.001461,"#3bec00"
20213004,timathom,0,2,10,12,0.360266,0.478369,0.003897,"#3e93ff"
20430497,webisblog,0,0,8,8,0.349593,0.494304,0.001948,"#3e93ff"
20448792,DiarioSUR,15,5,3,8,0.529916,0.595579,0.001948,"#ff0d69"
20449367,fabiomalini,39,6,3,9,0.384034,0.26398,0.002435,"#00e8b2"
20507551,alucchesi,39,11,0,11,0.403947,0.378552,0.00341,"#00e8b2"
20521678,IAPHpatrimonio,15,16,3,19,0.476259,0.551912,0.007306,"#ff0d69"
20660144,UmeaUniversity,0,4,0,4,0.439879,0.458398,0,"#ff0d69"
20674258,paulacpereira,39,5,0,5,0.39254,0.292771,0.000487,"#00e8b2"
20724267,DiggingIntoData,10,2,2,4,0.342776,0.411177,0,"#00ed5d"
20733366,costisd,21,0,4,4,0.352854,0.531955,0,"#ffb800"
20774514,mitpress,0,1,5,6,0.354151,0.509074,0.000974,"#ffb800"
20785197,lisagoddard,39,4,0,4,0.354775,0.35365,0,"#00e8b2"
20953990,maolibrarian,46,12,10,22,0.386649,0.558737,0.008768,"#3bec00"
21000110,SussexUni,39,4,0,4,0.422506,0.362706,0,"#00e8b2"
21096079,UEvora,39,6,0,6,0.4035,0.408783,0.000974,"#00e8b2"
21381934,medejean,19,10,11,21,0.423155,0.487693,0.008281,"#3bec00"
21446117,gonetil,46,1,5,6,0.405726,0.44479,0.000974,"#3bec00"
21633561,mferres,14,0,6,6,0.555079,0.340144,0.000974,"#b6cb00"
21744554,britishlibrary,39,4,0,4,0.396691,0.411617,0,"#ff0d69"
21762800,mikecosgrave,0,1,8,9,0.385525,0.513813,0.002435,"#3bec00"
21764132,DianeJakacki,46,2,4,6,0.398858,0.495542,0.000974,"#ffb800"
21861435,ehonorio,48,2,3,5,0.460174,0.497205,0.000487,"#00e8b2"
21874416,superHH,42,10,6,16,0.331914,0.249677,0.005845,"#005076"
21880973,xabuci,39,17,36,53,0.4284,0.576205,0.023867,"#fcae7e"
21926369,jaimealejandro,0,2,22,24,0.448168,0.480793,0.009742,"#3e93ff"
22078875,pucp,46,10,0,10,0.369731,0.470515,0.002923,"#3bec00"
22288099,unam,26,5,0,5,0.312695,0.425073,0.000487,"#3e93ff"
22554860,gabinfantemx,8,0,7,7,0.643591,0.170934,0.001461,"#3e93ff"
22749856,Gephi,39,5,0,5,0.414245,0.395437,0.000487,"#00e8b2"
22756377,MUnibertsitatea,35,25,15,40,0.646344,0.609703,0.017535,"#008ebb"
22809165,academia,15,59,0,59,0.454795,0.480184,0.02679,"#ff0d69"
22847403,karuvf,46,1,11,12,0.200319,0.529969,0.003897,"#3bec00"
22940460,OpenEditionActu,12,2,3,5,0.396113,0.4396,0.000487,"#ff77ff"
22967014,MITGameLab,12,6,0,6,0.498355,0.352307,0.000974,"#ff77ff"
23009730,Troskiller,19,4,0,4,0.372456,0.472369,0,"#00ed5d"
23061724,NoticiasNavarra,49,3,1,4,0.618683,0.425159,0,"#8ecfec"
23117521,nabolom,26,4,4,8,0.350882,0.413314,0.001948,"#3e93ff"
23128421,fredgibbs,12,25,0,25,0.40417,0.447029,0.010229,"#ff77ff"
23207063,brunodesouza,39,0,5,5,0.373318,0.403852,0.000487,"#00e8b2"
23248260,lupicinio,12,1,5,6,0.382456,0.385331,0.000974,"#825403"
23265246,WalterScheidel,15,19,0,19,0.477398,0.482329,0.007306,"#006032"
23316910,dcaraban,46,4,2,6,0.467785,0.553698,0.000974,"#ffb800"
23617197,Javpa1_alien,46,0,4,4,0.281499,0.407618,0,"#ffb800"
23743511,bordalejo,46,2,9,11,0.401346,0.499324,0.00341,"#ffb800"
24075855,roopikarisam,0,9,13,22,0.31734,0.436065,0.008768,"#3e93ff"
24176576,aprestamo,42,0,4,4,0.323885,0.169498,0,"#005076"
24389472,jimccasey1,12,0,5,5,0.278304,0.430775,0.000487,"#ff77ff"
24539732,webnucleo,12,8,21,29,0.395526,0.4071,0.012177,"#ff77ff"
24603962,eagirre,12,0,4,4,0.380031,0.501118,0,"#ff77ff"
24625697,maestroluis,0,0,4,4,0.342661,0.432548,0,"#3e93ff"
24873432,mjuanro,17,1,5,6,0.358881,0.622058,0.000974,"#3bec00"
24925621,juliawants,0,0,9,9,0.331725,0.471405,0.002435,"#ffb800"
25521930,LancasterUni,10,7,0,7,0.428667,0.460919,0.001461,"#00ed5d"
25548535,Cafehistoria,39,5,0,5,0.527238,0.348512,0.000487,"#00e8b2"
25597820,edunisalle,26,2,3,5,0.270932,0.522989,0.000487,"#3bec00"
25702344,luiy,0,4,13,17,0.411201,0.453254,0.006332,"#3e93ff"
25710548,revista_EPI,48,15,3,18,0.46315,0.537357,0.006819,"#008ebb"
25769092,emeziegler,50,1,6,7,0.557171,0.401538,0.001461,"#008bdd"
25832593,llmunro,12,3,3,6,0.342123,0.37456,0.000974,"#ff77ff"
26089319,readingmadrid,46,6,0,6,0.292321,0.473295,0.000974,"#3e93ff"
26124443,esteladomiha67,17,15,16,31,0.370615,0.557288,0.013151,"#3bec00"
26161340,valink,0,0,5,5,0.361929,0.430421,0.000487,"#3e93ff"
26277867,manuelramirez,46,78,31,109,0.42934,0.562584,0.051145,"#ffb800"
26308712,linhd,46,5,0,5,0.41996,0.522933,0.000487,"#ffb800"
26623537,vitormussa,39,12,6,18,0.398855,0.355251,0.006819,"#00e8b2"
26726848,patymurrieta,10,53,27,80,0.395517,0.43011,0.037019,"#00ed5d"
26729931,rtve,14,6,0,6,0.587668,0.496206,0.000974,"#b6cb00"
26988360,gabysued,17,262,27,289,0.363633,0.707408,0.138821,"#3bec00"
27001464,paolalorenzana,46,4,0,4,0.311655,0.644925,0,"#3bec00"
27015594,soni_sandeep,39,8,0,8,0.385876,0.35186,0.001948,"#00e8b2"
27255323,corinakoolen,46,6,3,9,0.366224,0.520795,0.002435,"#3e93ff"
27724657,lenofortal,39,0,5,5,0.416914,0.360583,0.000487,"#00e8b2"
27805363,lavivipineda,12,11,0,11,0.437475,0.339908,0.00341,"#ff77ff"
27807595,utpl,9,15,0,15,0.29563,0.055405,0.005358,"#ff7a78"
27838943,mpmorillo,46,0,10,10,0.426438,0.514215,0.002923,"#ffb800"
27919737,elcorreogallego,54,2,2,4,0.544427,0.540479,0,"#c6cc85"
28162462,villanelle_,46,0,4,4,0.321382,0.538109,0,"#3bec00"
28217357,UFSC,39,4,0,4,0.376467,0.318924,0,"#00e8b2"
28300172,EprintsELIS,39,3,1,4,0.566932,0.236284,0,"#00e8b2"
28313090,UDEP,19,9,0,9,0.61342,0.671753,0.002435,"#5456a6"
28330102,Iturbide,15,0,15,15,0.453084,0.543531,0.005358,"#8ecfec"
28335066,Nancydiana,46,6,9,15,0.392806,0.529992,0.005358,"#ffb800"
28372650,lcborges,46,1,6,7,0.440508,0.471866,0.001461,"#ffb800"
28690738,Mar_pecosa,46,1,14,15,0.431089,0.503053,0.005358,"#ffb800"
28980450,BegoCamblor,25,0,15,15,0.356105,0.52624,0.005358,"#ff0d69"
29069971,lilimelgar,1,4,0,4,0.353725,0.663991,0,"#ffb800"
29107948,carogruffat,17,10,5,15,0.349376,0.544919,0.005358,"#3bec00"
29144052,g_toro,48,0,11,11,0.392412,0.559239,0.00341,"#3bec00"
29173500,apermar,1,2,9,11,0.527071,0.522177,0.00341,"#008ebb"
29175728,mjordano,46,0,8,8,0.407143,0.605967,0.001948,"#ffb800"
29230621,ttasovac,46,10,2,12,0.417499,0.464134,0.003897,"#ffb800"
29420610,ARdelasH,15,47,7,54,0.508833,0.582109,0.024355,"#006032"
29497240,c_magro,15,5,9,14,0.439559,0.531546,0.004871,"#006032"
29500483,jccahuana,0,0,8,8,0.333976,0.426902,0.001948,"#3e93ff"
29750732,lululorena,10,5,5,10,0.301925,0.348522,0.002923,"#3bec00"
29815389,juliagiannella,39,9,4,13,0.371916,0.329975,0.004384,"#00e8b2"
29956706,diraquel,39,0,5,5,0.415189,0.44871,0.000487,"#00e8b2"
30223203,ramon3434,17,23,0,23,0.571284,0.620138,0.009255,"#008ebb"
30697822,radio3_rne,25,4,0,4,0.433373,0.600209,0,"#8ecfec"
31035700,cundurraga,0,1,5,6,0.193693,0.484753,0.000974,"#3bec00"
31130143,ozmosi,39,0,4,4,0.412137,0.320782,0,"#00e8b2"
31487056,lujoyglamour,15,0,4,4,0.539589,0.524359,0,"#006032"
31650488,lcodina,15,3,4,7,0.412089,0.555499,0.001461,"#006032"
31653862,vahidm,0,0,4,4,0.415314,0.47427,0,"#3e93ff"
31676814,JordiJubany,14,4,1,5,0.639289,0.175432,0.000487,"#b6cb00"
31731533,UAM_Madrid,49,44,4,48,0.488662,0.497716,0.021432,"#ffa64e"
32027153,faraondemetal,1,1,3,4,0.443906,0.4564,0,"#ff0d69"
32136778,univgirona,48,6,0,6,0.489242,0.543593,0.000974,"#ff0d69"
32202798,Xim_ena,0,9,14,23,0.358982,0.374589,0.009255,"#3e93ff"
32254788,reformacultura,0,8,2,10,0.294398,0.409837,0.002923,"#00ed5d"
32496255,MarthaGroMills,0,1,12,13,0.342083,0.486006,0.004384,"#3e93ff"
32926265,JoaquimPinheiro,37,0,5,5,0.513455,0.53568,0.000487,"#ffb800"
33214605,UIMP,48,18,3,21,0.480114,0.540772,0.008281,"#008ebb"
33310796,JohnPostill,46,2,4,6,0.333313,0.526594,0.000974,"#3bec00"
33370074,RenataFM,39,1,3,4,0.401099,0.295022,0,"#00e8b2"
33383694,amaliasl,0,22,15,37,0.293916,0.441816,0.016074,"#3e93ff"
33567456,jcordon,46,4,0,4,0.424396,0.603014,0,"#3bec00"
33593435,cgainza,10,96,46,142,0.269548,0.443033,0.067219,"#3bec00"
33632713,BlueBoxTraveler,12,0,4,4,0.35803,0.406802,0,"#ff77ff"
33636080,MaryVillam,10,3,2,5,0.237083,0.445204,0.000487,"#3bec00"
33650538,jimmy_medeiros,39,15,15,30,0.402663,0.372868,0.012664,"#00e8b2"
33667453,AlfredoNarvaez,0,0,11,11,0.392414,0.343404,0.00341,"#3e93ff"
33747454,leilavieira_31,0,5,5,10,0.281761,0.453428,0.002923,"#3e93ff"
33820442,luisenelias,22,32,3,35,0.352901,0.735064,0.0151,"#8ecfec"
33832669,jalonsoarevalo,48,206,3,209,0.460864,0.555902,0.099854,"#008ebb"
33947371,FreeBlackTX,12,24,2,26,0.288072,0.414519,0.010716,"#ff77ff"
33972897,utlibraries,12,5,0,5,0.311819,0.406081,0.000487,"#ff77ff"
34255829,AlbertoCairo,46,4,0,4,0.332358,0.540363,0,"#ffb800"
34587778,Bookess,15,4,0,4,0.517299,0.485859,0,"#ff0d69"
34588566,sergenoiret,48,2,2,4,0.440981,0.487485,0,"#00ed5d"
34606262,ULPGC,37,30,7,37,0.462555,0.583624,0.016074,"#ffb800"
34607715,HASTAC,12,40,6,46,0.284316,0.408818,0.020458,"#ff77ff"
34997892,oalcoba,14,5,0,5,0.61229,0.282161,0.000487,"#b6cb00"
34998963,Rosa152,50,13,18,31,0.665547,0.427512,0.013151,"#008bdd"
35032869,placasa,21,7,5,12,0.499914,0.445874,0.003897,"#ffa64e"
35035282,skuntzficker,26,4,0,4,0.323095,0.31802,0,"#3e93ff"
35043821,followlori,39,25,13,38,0.391192,0.24953,0.016561,"#00e8b2"
35201891,pluraleemsite,39,1,6,7,0.32743,0.229856,0.001461,"#00e8b2"
35343252,phelima,0,1,7,8,0.307177,0.433043,0.001948,"#3bec00"
35403297,thomasgpadilla,12,32,12,44,0.319669,0.476267,0.019484,"#ff77ff"
35423789,mikeasencio,42,1,5,6,0.325646,0.189979,0.000974,"#005076"
35594954,soyjlromo,0,0,4,4,0.410589,0.524672,0,"#3e93ff"
35619075,almaldo2,12,2,5,7,0.382357,0.406572,0.001461,"#3e93ff"
35669324,iniciador_grx,15,0,4,4,0.555501,0.542704,0,"#006032"
35716729,Bibliotecas_IC,1,29,8,37,0.410498,0.582558,0.016074,"#ffb800"
35804229,jenguiliano,12,22,5,27,0.279591,0.429993,0.011203,"#ff77ff"
35807391,behatriztejada,46,17,6,23,0.426757,0.558492,0.009255,"#ffb800"
35910512,diegocraig,46,1,14,15,0.347557,0.576093,0.005358,"#3bec00"
35915291,marianolegname,17,3,1,4,0.373287,0.626223,0,"#3bec00"
36020111,aprensamadrid,15,3,1,4,0.822188,0.714771,0,"#006032"
36107561,Abriluz,0,0,4,4,0.349883,0.421024,0,"#3e93ff"
36323374,radioeuskadi,48,4,0,4,0.53041,0.958627,0,"#008ebb"
36574766,lbros,35,5,0,5,0.236234,0.402311,0.000487,"#c42c63"
36584651,eliterature,12,1,4,5,0.330894,0.46767,0.000487,"#ff77ff"
36596919,ThaianeOliveira,39,12,9,21,0.418657,0.340303,0.008281,"#00e8b2"
36609284,rfagoaga,12,22,51,73,0.366618,0.413852,0.033609,"#3e93ff"
36841223,sidurti,0,0,7,7,0.409553,0.389139,0.001461,"#3e93ff"
36918338,enriquemuriel,39,2,3,5,0.408672,0.467102,0.000487,"#00e8b2"
37226526,julibergmann,0,10,19,29,0.392154,0.466521,0.012177,"#3e93ff"
37244784,juanfermejia,0,8,31,39,0.434064,0.459007,0.017048,"#3e93ff"
37255347,Abuela_Viajera,46,0,13,13,0.349782,0.535439,0.004384,"#3bec00"
37255419,jorvitali,17,3,2,5,0.456212,0.574706,0.000487,"#3bec00"
37283473,jaiderog,46,11,8,19,0.365795,0.561038,0.007306,"#3bec00"
37571068,lenguaaldia,46,3,3,6,0.332511,0.663901,0.000974,"#3bec00"
37864753,evasander,26,4,8,12,0.264943,0.343595,0.003897,"#3e93ff"
37940750,RicardoChew,26,6,1,7,0.33199,0.329213,0.001461,"#3e93ff"
38282454,EmilyDreyfuss,0,1,5,6,0.343971,0.463746,0.000974,"#3e93ff"
38471570,christianlamb,46,11,11,22,0.330542,0.457724,0.008768,"#3bec00"
38562659,leo_elo_ole,10,0,11,11,0.29031,0.473433,0.00341,"#3bec00"
38640768,lavozdegalicia,54,4,0,4,0.486596,0.43401,0,"#c6cc85"
38640989,PRCanfranc,1,1,10,11,0.343739,0.537164,0.00341,"#825403"
38701532,mujeresycia,46,3,4,7,0.500707,0.619697,0.001461,"#ffb800"
38722156,gersonbeltran,54,4,4,8,0.515574,0.496185,0.001948,"#c6cc85"
38829940,miss_celanica,10,1,3,4,0.404277,0.475372,0,"#00ed5d"
39033058,DavidNemer,39,8,0,8,0.405623,0.258118,0.001948,"#00e8b2"
39075275,virginiog,14,73,0,73,0.170794,0.237508,0.033609,"#b6cb00"
39079874,AliciaPomares,48,0,8,8,0.572532,0.565272,0.001948,"#008ebb"
39098763,IC_FormaELE,22,1,4,5,0.34769,0.707216,0.000487,"#8ecfec"
39134945,Giyuela,46,6,0,6,0.370901,0.527068,0.000974,"#3bec00"
39170141,rbnrmz,8,4,0,4,0.43825,0.21689,0,"#3e93ff"
39296194,eliasbitencourt,39,8,10,18,0.404296,0.357329,0.006819,"#00e8b2"
39306293,USouthFlorida,1,8,0,8,0.423024,0.565027,0.001948,"#ff12a3"
39462470,torcuataTK,48,1,6,7,0.496473,0.482045,0.001461,"#008ebb"
39518155,drdianis,9,7,4,11,0.325298,0.166896,0.00341,"#ff7a78"
39520766,todoele,28,4,0,4,0.415353,0.65187,0,"#8ecfec"
39585367,Harvard,0,8,0,8,0.425052,0.488519,0.001948,"#ff77ff"
39587698,uazlibraries,12,12,0,12,0.319114,0.422744,0.003897,"#00e8b2"
39765594,Ucen,46,10,1,11,0.308929,0.473363,0.00341,"#3bec00"
40090034,U_ElClaustro,36,27,4,31,0.297271,0.350146,0.013151,"#00e8b2"
40291830,rosguga,19,0,4,4,0.40634,0.418407,0,"#3e93ff"
40611055,karlamotte,0,3,7,10,0.368603,0.468419,0.002923,"#3e93ff"
40643519,carobotero,19,3,7,10,0.477202,0.417077,0.002923,"#00ed5d"
40953076,dustfruit,0,24,12,36,0.349992,0.437397,0.015587,"#3e93ff"
41190229,alestolk,50,2,2,4,0.494911,0.380594,0,"#825403"
41230160,RadioEducacion,26,18,1,19,0.3165,0.664405,0.007306,"#3e93ff"
41274437,frioconbotas,46,5,3,8,0.301429,0.543966,0.001948,"#3bec00"
41329328,euskaltelebista,48,0,4,4,0.515365,0.912688,0,"#008ebb"
41346792,michiganstateu,0,5,0,5,0.405899,0.432855,0.000487,"#ff77ff"
41371853,Argensola,0,10,51,61,0.382528,0.474354,0.027764,"#3e93ff"
41430015,jiesot,0,0,4,4,0.33705,0.393595,0,"#3e93ff"
41569514,elisabeleta,48,1,10,11,0.431991,0.530192,0.00341,"#008ebb"
41649711,ricvargasmed,46,5,0,5,0.328767,0.550655,0.000487,"#3bec00"
41824898,laurenfklein,39,12,4,16,0.371274,0.362689,0.005845,"#00e8b2"
41830883,limboctante,48,10,0,10,0.516788,0.555856,0.002923,"#008ebb"
41851448,nexosmexico,36,26,0,26,0.552791,0.780197,0.010716,"#3bec00"
41965769,DanielPaulOD,10,20,8,28,0.32749,0.484397,0.01169,"#00ed5d"
42070947,jgob,12,33,31,64,0.33101,0.445998,0.029226,"#ff77ff"
42399225,AgenciaFAPESP,39,6,3,9,0.39299,0.200478,0.002435,"#00e8b2"
42648852,yierva,0,172,222,394,0.400105,0.452912,0.189966,"#3e93ff"
42664928,elcolef,35,7,2,9,0.297911,0.411011,0.002435,"#c42c63"
43167222,zeroig,39,7,1,8,0.517386,0.363039,0.001948,"#00e8b2"
43262326,AAHD,46,11,0,11,0.382655,0.557413,0.00341,"#3bec00"
43323995,albertmeronyo,12,0,5,5,0.423573,0.450869,0.000487,"#ff77ff"
43339914,Sabersinfin,11,4,1,5,0.136835,0.628057,0.000487,"#f4a2ff"
43372273,museonacionalco,19,9,3,12,0.441082,0.405306,0.003897,"#00ed5d"
43379739,mariajoafana,12,300,131,431,0.401914,0.437912,0.207988,"#ff77ff"
43664690,CCCBLab,48,87,17,104,0.518161,0.503941,0.048709,"#ff0d69"
43720617,joseragas,10,12,8,20,0.324615,0.424451,0.007793,"#00ed5d"
43744273,PublicaHistoria,39,2,27,29,0.426328,0.393087,0.012177,"#00e8b2"
43897160,angelespedro,46,4,2,6,0.162725,0.604858,0.000974,"#3bec00"
44046272,blros,35,32,23,55,0.271057,0.41287,0.024842,"#c42c63"
44077581,DX_Esau,15,0,8,8,0.432102,0.490346,0.001948,"#006032"
44151017,Uniandes,12,165,4,169,0.432626,0.392417,0.08037,"#ff77ff"
44318238,mediamusea,15,15,5,20,0.530496,0.548911,0.007793,"#006032"
44379247,michellerserra,1,2,3,5,0.671388,0.4972,0.000487,"#008ebb"
44410209,JuanSteyn,0,0,8,8,0.390704,0.443428,0.001948,"#3e93ff"
44645190,equihua_sm,46,1,3,4,0.354791,0.517265,0,"#3bec00"
44656990,NoloDz,0,1,6,7,0.389959,0.413419,0.001461,"#3e93ff"
44732763,daniel_edutic,0,0,5,5,0.425893,0.443178,0.000487,"#3e93ff"
44946138,ScienceSergio,0,0,10,10,0.42377,0.496396,0.002923,"#3e93ff"
44953355,ocorcho,48,3,3,6,0.489175,0.617123,0.000974,"#008ebb"
45262818,grupobaratz,48,6,1,7,0.386747,0.599987,0.001461,"#8ecfec"
45518743,florasanz,46,0,4,4,0.442274,0.588663,0,"#ffb800"
45554558,morenomulas,28,3,13,16,0.390957,0.578468,0.005845,"#8ecfec"
45816279,octsi,37,0,5,5,0.490476,0.663363,0.000487,"#ffb800"
45825302,bibliotecaaxarq,28,2,5,7,0.408842,0.568232,0.001461,"#8ecfec"
45891631,amgserrano,46,14,0,14,0.466066,0.565864,0.004871,"#ffb800"
46141332,TECcampusMTY,36,5,2,7,0.250557,0.459419,0.001461,"#6c241e"
46244467,elJabberwocky,0,49,36,85,0.35361,0.442989,0.039454,"#3e93ff"
46247496,pacastillo,15,2,4,6,0.556236,0.512456,0.000974,"#006032"
46260308,cunyGClibrary,12,5,0,5,0.340733,0.379982,0.000487,"#ff77ff"
46667480,raffazizzi,46,55,9,64,0.349511,0.486976,0.029226,"#3bec00"
46680156,asungomezperez,48,4,1,5,0.472671,0.660728,0.000487,"#008ebb"
46684832,ylarri,17,1,5,6,0.365917,0.623073,0.000974,"#3bec00"
46700541,ciespal,36,11,0,11,0.45026,0.763875,0.00341,"#008ebb"
46735154,INAImexico,26,9,1,10,0.281784,0.378993,0.002923,"#3e93ff"
46968095,camikant,48,0,4,4,0.581309,0.550634,0,"#008ebb"
47062815,IrinaNanu,12,9,1,10,0.320862,0.412848,0.002923,"#ff77ff"
47334263,JohannesvV,12,0,7,7,0.36469,0.446335,0.001461,"#ff77ff"
47558070,Uli_T,0,0,7,7,0.391574,0.476552,0.001461,"#3e93ff"
47777004,Alexa828,0,2,22,24,0.370866,0.47292,0.009742,"#3e93ff"
47893228,docassar,39,2,10,12,0.353586,0.386576,0.003897,"#00e8b2"
47897751,schallierw,46,7,25,32,0.330965,0.470771,0.013639,"#3bec00"
48015638,juanmanfredi,37,1,7,8,0.474672,0.573468,0.001948,"#fcae7e"
48132342,teoretico,17,0,7,7,0.361632,0.478073,0.001461,"#3e93ff"
48144146,laopinioncucuta,19,4,0,4,0.522337,0.380242,0,"#00ed5d"
48149362,leoperiodista,50,12,0,12,0.630127,0.417129,0.003897,"#008bdd"
48301445,cutuchiqueno,46,0,4,4,0.353765,0.461475,0,"#ffb800"
48356019,mambre61,49,0,10,10,0.432958,0.424984,0.002923,"#ffa64e"
48357126,uprrp,13,5,5,10,0.090436,0.488659,0.002923,"#3a8724"
48360568,dianaharsanyi8,19,0,12,12,0.406717,0.433065,0.003897,"#3e93ff"
48388985,araceletorres,12,8,0,8,0.388176,0.386993,0.001948,"#00e8b2"
48418636,cliocaribe,46,3,1,4,0.379925,0.591021,0,"#ffb800"
48505632,Merca20,46,7,0,7,0.33353,0.626735,0.001461,"#3bec00"
48509947,INMAFIGUEROA,46,3,7,10,0.405466,0.568742,0.002923,"#ffb800"
48818510,PabGonzalo,1,0,4,4,0.32567,0.570766,0,"#825403"
48870122,CarlosRuz_F,10,20,15,35,0.373632,0.449083,0.0151,"#3bec00"
49386593,oeide,0,1,4,5,0.397495,0.463398,0.000487,"#3e93ff"
49429570,giodiros,37,6,0,6,0.471817,0.56644,0.000974,"#fcae7e"
49507898,cwellmon,46,2,2,4,0.459964,0.516453,0,"#ffb800"
49508220,nzerik,46,0,8,8,0.371674,0.47835,0.001948,"#ffb800"
49524592,rafaelmendezro,12,1,3,4,0.337115,0.158336,0,"#00ed5d"
49541564,morenamariah,39,7,2,9,0.391508,0.13322,0.002435,"#00e8b2"
49631501,aloestcuz,36,0,4,4,0.356622,0.321299,0,"#ff77ff"
49724372,NiwanSk,0,0,12,12,0.407585,0.492631,0.003897,"#3e93ff"
49758266,CulturaUNAM,0,5,0,5,0.449077,0.470818,0.000487,"#3e93ff"
49949460,olivianeta,39,6,0,6,0.388254,0.357494,0.000974,"#00e8b2"
50022680,susanirenebrown,46,1,4,5,0.367522,0.524248,0.000487,"#ffb800"
50080991,FiloBlogia,46,0,5,5,0.395086,0.558511,0.000487,"#ffb800"
50098848,Alacranita,12,0,10,10,0.270682,0.409826,0.002923,"#ff77ff"
50131859,Kitsune_Amare_,0,1,4,5,0.355184,0.461136,0.000487,"#3e93ff"
50347559,antropomemoria,46,3,6,9,0.336282,0.650848,0.002435,"#3bec00"
50513654,LuiGiRod,1,6,2,8,0.389513,0.437329,0.001948,"#825403"
50518937,eldardo,17,6,1,7,0.335846,0.605451,0.001461,"#3bec00"
50626996,UNAM_MX,26,120,1,121,0.295791,0.394837,0.05699,"#3e93ff"
51025341,joserovira,28,17,52,69,0.426005,0.57384,0.031661,"#006032"
51081327,EndairaForever,39,2,5,7,0.411112,0.293582,0.001461,"#00e8b2"
51580676,FlavioRocha1,39,2,13,15,0.400023,0.369688,0.005358,"#00e8b2"
51741655,FiestaLibro,19,9,2,11,0.33222,0.409871,0.00341,"#00ed5d"
51862212,noblecavalcante,39,10,6,16,0.393385,0.245581,0.005845,"#00e8b2"
51912077,AlfaVinyl,0,3,8,11,0.346423,0.39846,0.00341,"#3e93ff"
52210899,outecran,15,1,6,7,0.433037,0.485382,0.001461,"#ff0d69"
52392344,BernardoPajares,50,9,4,13,0.646881,0.44621,0.004384,"#008bdd"
52524273,Statick_ds,9,0,4,4,0.3059,0.108318,0,"#ff7a78"
52613498,pfaltay,39,6,3,9,0.381967,0.255097,0.002435,"#00e8b2"
52634100,tais_so,39,11,8,19,0.427702,0.232244,0.007306,"#00e8b2"
52851172,mexiqueancien,10,1,6,7,0.347474,0.320086,0.001461,"#00ed5d"
53049381,codigocero,54,4,0,4,0.390017,0.543056,0,"#c6cc85"
53349508,Ramon_Mendez,28,33,0,33,0.705681,0.63424,0.014126,"#00ed5d"
53403847,BNChile,32,2,3,5,0.11621,0.232434,0.000487,"#00ed5d"
53407007,solorzaja,48,4,7,11,0.445744,0.599766,0.00341,"#008ebb"
53480950,luisalvaz,0,8,6,14,0.463002,0.466147,0.004871,"#3e93ff"
53518873,nigropatricia,15,0,5,5,0.428581,0.455523,0.000487,"#006032"
53683972,RedBibliotecas,19,7,3,10,0.426211,0.409823,0.002923,"#00ed5d"
53691381,nealstimler,0,0,5,5,0.34807,0.490575,0.000487,"#ffb800"
53715488,maprats,14,1,11,12,0.585241,0.284277,0.003897,"#b6cb00"
53840651,elekilla,15,0,5,5,0.462752,0.491096,0.000487,"#006032"
54044382,manuelvarzen,0,0,6,6,0.372037,0.568782,0.000974,"#3e93ff"
54237742,neponita,1,45,0,45,0.337056,0.522187,0.019971,"#825403"
54338577,alasuroboro,0,1,12,13,0.386125,0.367574,0.004384,"#3e93ff"
54404368,UF_SpanPort,42,8,6,14,0.335307,0.252405,0.004871,"#005076"
54461352,Sandradefelipe,19,3,6,9,0.455242,0.426321,0.002435,"#00ed5d"
54658924,paoladel,17,2,2,4,0.509258,0.428067,0,"#008ebb"
54754708,davidvernonbr,1,0,4,4,0.486319,0.599017,0,"#008ebb"
54961149,elpais_cultura,22,6,0,6,0.41972,0.646605,0.000974,"#ffb800"
55539822,lab4O4,39,5,1,6,0.399163,0.346618,0.000974,"#00e8b2"
55987540,ksmksm,0,0,12,12,0.390377,0.452427,0.003897,"#3e93ff"
56321648,La_Cerca,37,0,4,4,0.493186,0.689417,0,"#fcae7e"
56447221,ptqk,48,10,0,10,0.513341,0.554575,0.002923,"#008ebb"
56529080,cbsalej,19,3,1,4,0.488069,0.458637,0,"#3e93ff"
56601879,juanpabangarita,19,5,26,31,0.421351,0.436765,0.013151,"#ff77ff"
56608207,MaximoAfonso,0,1,12,13,0.355992,0.438269,0.004384,"#3e93ff"
56635115,carlosgvidal,36,10,2,12,0.219363,0.330298,0.003897,"#00e8b2"
56688114,MarcosCasero,46,8,0,8,0.531014,0.631616,0.001948,"#ffb800"
56744104,Conicet,46,6,0,6,0.364322,0.580718,0.000974,"#3bec00"
56812711,miriamkp,12,52,4,56,0.368956,0.432324,0.025329,"#ff77ff"
56862964,Hecastanedaf,17,0,4,4,0.420313,0.493811,0,"#3bec00"
56957909,cristobalsuarez,15,230,69,299,0.489662,0.5091,0.143692,"#006032"
57136395,TalitaBaena,39,1,3,4,0.378329,0.261583,0,"#00e8b2"
57157570,Miriposita,0,0,5,5,0.388372,0.452695,0.000487,"#3e93ff"
57205025,lisefer,19,0,4,4,0.469749,0.418359,0,"#00ed5d"
57235167,enurteagaa,12,2,15,17,0.367176,0.483293,0.006332,"#ff77ff"
57351555,joannaprieto,46,1,6,7,0.427499,0.540998,0.001461,"#ff77ff"
57623076,uc3m,21,55,1,56,0.501309,0.567559,0.025329,"#ffa64e"
57659119,joseiaguiar,12,0,12,12,0.398985,0.549948,0.003897,"#3e93ff"
57976060,guicas,39,5,1,6,0.449648,0.456044,0.000974,"#00e8b2"
57985101,CienciaRTVE,27,27,4,31,0.911074,0.200703,0.013151,"#00ed5d"
57986415,rtveplay,27,27,0,27,0.907479,0.19559,0.011203,"#00ed5d"
58073253,espejolento,0,299,193,492,0.348269,0.436475,0.237701,"#3e93ff"
58291700,migueljogja,0,7,19,26,0.380518,0.50263,0.010716,"#3e93ff"
58333207,aizeta,46,4,10,14,0.354058,0.522667,0.004871,"#ffb800"
58398846,sanitare,0,0,4,4,0.30817,0.419238,0,"#ffb800"
58434869,ujaen,22,10,2,12,0.443542,0.628659,0.003897,"#8ecfec"
58492780,joshmacfadyen,12,20,1,21,0.401539,0.422019,0.008281,"#ff77ff"
58555535,fggutierrez,46,26,28,54,0.37009,0.549262,0.024355,"#3bec00"
58598072,ConectaTECmx,36,2,2,4,0.235453,0.484428,0,"#6c241e"
58660358,Cabildo_Digital,19,0,6,6,0.582058,0.409947,0.000974,"#00ed5d"
58803111,pavlvstc,9,1,5,6,0.342941,0.238409,0.000974,"#ff7a78"
58868203,price_bulnes,0,0,5,5,0.411713,0.481388,0.000487,"#3e93ff"
58899916,derechosdigital,1,34,1,35,0.364045,0.384446,0.0151,"#825403"
58949171,natarestrepo,19,1,6,7,0.447377,0.415968,0.001461,"#00ed5d"
59176934,elieallouche,1,13,0,13,0.415169,0.449298,0.004384,"#825403"
59371979,petrohs,0,0,9,9,0.365148,0.409709,0.002435,"#3e93ff"
59528794,El_Mois,0,2,14,16,0.377463,0.425798,0.005845,"#3e93ff"
59541115,luiza_xavier,39,4,0,4,0.37152,0.261037,0,"#00e8b2"
59554649,_Tiagoventura,39,4,0,4,0.399306,0.330122,0,"#00e8b2"
59757142,anaalonsofernan,46,2,7,9,0.445273,0.527748,0.002435,"#3bec00"
59805032,umblaetterer,46,24,41,65,0.393478,0.506775,0.029713,"#ffb800"
59940016,pedroisandretta,39,15,0,15,0.412802,0.300962,0.005358,"#00e8b2"
60004711,mmeduchatelet,50,2,4,6,0.558809,0.402118,0.000974,"#008bdd"
60168652,Titoaguirre,0,0,4,4,0.21679,0.293723,0,"#00ed5d"
60304659,paulopen,39,0,4,4,0.417244,0.309003,0,"#00e8b2"
60439734,danavido,12,13,69,82,0.376676,0.476866,0.037993,"#ff77ff"
60573613,Vivirdecuentos,15,0,4,4,0.387952,0.579258,0,"#006032"
60968015,dantexier,46,0,8,8,0.359869,0.536446,0.001948,"#3bec00"
61010605,LiEspin,12,2,7,9,0.440756,0.437466,0.002435,"#00ed5d"
61093336,julitoalonso,17,15,16,31,0.333934,0.592941,0.013151,"#3bec00"
61195184,CervantesLondon,22,1,3,4,0.350485,0.705679,0,"#8ecfec"
61217392,uff_br,39,4,0,4,0.400523,0.309744,0,"#00e8b2"
61376431,isabelgines,21,3,5,8,0.594312,0.768448,0.001948,"#ffa64e"
61496527,agencia_fiocruz,39,3,1,4,0.454551,0.198594,0,"#00e8b2"
61744008,Telefonica,1,7,1,8,0.211281,0.562754,0.001948,"#825403"
61762488,christof77,0,7,38,45,0.391574,0.485244,0.019971,"#3e93ff"
62030243,ftsaez,15,10,18,28,0.528576,0.509854,0.01169,"#006032"
62065310,vrodes,54,7,6,13,0.469935,0.590545,0.004384,"#c6cc85"
62326766,gyrizar,20,2,4,6,0.360874,0.254359,0.000974,"#f4c8cf"
62616992,erdosain87,10,0,4,4,0.228182,0.335822,0,"#00ed5d"
62830337,mhlarramendi,39,5,3,8,0.441452,0.646676,0.001948,"#fcae7e"
62851712,adrianolcp,39,1,3,4,0.374911,0.283994,0,"#00e8b2"
62867284,mirces69,15,0,5,5,0.429924,0.517275,0.000487,"#006032"
62938801,morenocris,48,1,4,5,0.415767,0.454076,0.000487,"#3bec00"
62976863,AnaXoch,17,1,4,5,0.372643,0.558551,0.000487,"#3bec00"
63079140,eldadodelarte,15,10,5,15,0.466315,0.537941,0.005358,"#ff0d69"
63176407,Stelluchis,19,0,5,5,0.505454,0.383053,0.000487,"#00ed5d"
63411616,TheManilaTimes,25,7,0,7,0.40934,0.600542,0.001461,"#8ecfec"
63421692,unisevilla,22,47,6,53,0.394751,0.554912,0.023867,"#8ecfec"
63715498,n_quiroga,46,33,17,50,0.398048,0.469411,0.022406,"#3bec00"
63765675,undivaga,46,1,3,4,0.439452,0.51212,0,"#ffb800"
63955942,areanorte,48,0,4,4,0.47072,0.618391,0,"#008ebb"
64245814,sethvanhooland,12,30,5,35,0.370278,0.463111,0.0151,"#ff77ff"
64327748,jaroldiazc,15,0,6,6,0.404275,0.522656,0.000974,"#006032"
64368213,mpalafoxp,46,5,8,13,0.436528,0.57964,0.004384,"#ffb800"
64374288,VIIICentenario,28,15,2,17,0.370836,0.578976,0.006332,"#8ecfec"
64660135,conchijimenez,28,4,0,4,0.350217,0.578841,0,"#8ecfec"
64744322,ileana_faerie,0,1,11,12,0.440241,0.493789,0.003897,"#3e93ff"
64863875,platzi,19,10,0,10,0.188317,0.565983,0.002923,"#ff77ff"
64872094,cployola,19,1,7,8,0.419885,0.456899,0.001948,"#3e93ff"
64939623,jamotilla,12,63,32,95,0.398526,0.454203,0.044325,"#ff77ff"
65395760,cpdocfgv,39,88,12,100,0.43245,0.327579,0.046761,"#00e8b2"
65440006,URosario,12,4,1,5,0.400968,0.297592,0.000487,"#00ed5d"
65596331,aboutgeo,46,1,4,5,0.318719,0.509087,0.000487,"#3bec00"
65615210,bibliotecasCSIC,48,33,16,49,0.467381,0.558206,0.021919,"#008ebb"
65723778,tramullas,12,5,5,10,0.470609,0.46302,0.002923,"#ff77ff"
65829641,labalteira,46,1,4,5,0.308304,0.552411,0.000487,"#3bec00"
66205047,historiachiqui,12,3,3,6,0.329815,0.299305,0.000974,"#ff77ff"
66324125,Angeles_Jurado,37,1,5,6,0.329934,0.517006,0.000974,"#ffb800"
66340430,monttm,26,0,8,8,0.357939,0.391626,0.001948,"#3e93ff"
66571267,UniJaveriana,36,22,0,22,0.468581,0.387229,0.008768,"#6c241e"
66636184,marianalojo,0,0,4,4,0.386652,0.413708,0,"#3e93ff"
66685452,rafamadi,15,0,5,5,0.44618,0.513341,0.000487,"#006032"
66703068,adrijg,5,8,0,8,0.340306,0.346891,0.001948,"#ff9b8f"
66739013,lc_rb,12,3,14,17,0.38531,0.400592,0.006332,"#ff77ff"
66933123,Minerva822,0,4,9,13,0.362083,0.4498,0.004384,"#3e93ff"
66942912,fatihaidmhand,0,20,7,27,0.402789,0.478953,0.011203,"#3e93ff"
67039054,canarias7,46,10,0,10,0.454845,0.604233,0.002923,"#ffb800"
67420860,UniversidadUCES,0,41,0,41,0.352337,0.487549,0.018022,"#3bec00"
67690199,CDRH_UNL,12,6,0,6,0.315301,0.44396,0.000974,"#ff77ff"
67873788,filipesaraiva,39,0,4,4,0.415186,0.355053,0,"#00e8b2"
68168216,gato_rorro,32,6,1,7,0,0.137602,0.001461,"#00ed5d"
68204430,NewsNeus,14,1,10,11,0.508189,0.373233,0.00341,"#b6cb00"
68385771,RadioSabadell,14,3,2,5,0.635873,0.276064,0.000487,"#b6cb00"
68507139,UdeA,46,7,0,7,0.241741,0.508809,0.001461,"#3bec00"
68673994,Danny__Mac__,12,20,0,20,0.400511,0.428501,0.007793,"#ff77ff"
68823009,nicvel,12,0,4,4,0.37164,0.406475,0,"#ff77ff"
68947801,JorgeJmzLpz,28,2,5,7,0.395213,0.576486,0.001461,"#8ecfec"
68963332,marceloraimundo,12,10,0,10,0.395998,0.411204,0.002923,"#ff77ff"
69095369,titopage,19,0,12,12,0.450746,0.424587,0.003897,"#00ed5d"
69428531,Lety_Crespillo,15,5,28,33,0.464039,0.524261,0.014126,"#ff0d69"
70102248,AgustiColomines,48,0,5,5,0.444027,0.490088,0.000487,"#008ebb"
70358438,serranocobos,17,5,6,11,0.362475,0.576359,0.00341,"#3bec00"
70619271,alexpintor,15,5,8,13,0.512994,0.507084,0.004384,"#006032"
70695732,wikimedia_ar,46,17,6,23,0.338275,0.509142,0.009255,"#3bec00"
70783234,arualdnas,54,0,4,4,0.620395,0.657049,0,"#c6cc85"
70908416,So_Miyagawa,48,0,4,4,0.426967,0.513847,0,"#008ebb"
70972716,SonogramaMGZN,48,5,2,7,0.25191,0.763022,0.001461,"#008ebb"
71320992,RedeSciELO,39,16,2,18,0.361608,0.415645,0.006819,"#00e8b2"
71370207,christilcara,17,4,2,6,0.342842,0.693589,0.000974,"#3bec00"
71584114,Ariel_Moran,0,23,21,44,0.386574,0.447253,0.019484,"#3e93ff"
71623966,RaquelMesaKC,39,7,2,9,0.337165,0.340079,0.002435,"#00e8b2"
71678953,Perestupinya,27,26,4,30,0.91028,0.192622,0.012664,"#00ed5d"
71779714,EnrikeLopez,1,1,6,7,0.320322,0.553587,0.001461,"#825403"
72149034,FidelRodV,49,6,25,31,0.463983,0.419241,0.013151,"#3bec00"
72296583,enunofg,46,3,3,6,0.379732,0.529385,0.000974,"#8ecfec"
72499358,doctora_alvarez,27,0,4,4,0.918233,0.171819,0,"#00ed5d"
72542703,begonyacayuela,12,1,35,36,0.385236,0.49801,0.015587,"#ff77ff"
72677087,EquipoGNOSS,1,1,3,4,0.223343,0.52397,0,"#825403"
72831953,tedeguarana,0,16,24,40,0.4133,0.491061,0.017535,"#3e93ff"
73024871,udecaldas,19,33,13,46,0.609603,0.630475,0.020458,"#5456a6"
73081185,mikel_uriguen,17,0,4,4,0.502674,0.673507,0,"#3bec00"
73139343,teccogs,39,5,2,7,0.402819,0.314687,0.001461,"#00e8b2"
73197259,eortegag,0,9,13,22,0.379319,0.491442,0.008768,"#3e93ff"
73315263,tttkay,0,15,16,31,0.329735,0.449683,0.013151,"#3bec00"
73350229,japtapias,22,9,0,9,0.571293,0.521738,0.002435,"#8ecfec"
73749456,ju_ms,39,40,35,75,0.392598,0.401275,0.034584,"#00e8b2"
74042304,dennistenen,12,31,5,36,0.367605,0.437472,0.015587,"#ff77ff"
74163875,febab,39,5,0,5,0.523873,0.136298,0.000487,"#00e8b2"
74453123,LaVanguardia,14,31,0,31,0.519326,0.449592,0.013151,"#fcae7e"
74683881,airun72,15,201,121,322,0.440807,0.497636,0.154895,"#ff0d69"
75085818,iiaunam,0,63,13,76,0.393465,0.39108,0.035071,"#3e93ff"
75323881,Omar_r47m4ch1n3,39,4,8,12,0.477809,0.081274,0.003897,"#00e8b2"
75339353,gdabos,15,3,7,10,0.440559,0.528908,0.002923,"#ffb800"
75354109,bla222,0,2,7,9,0.355618,0.397279,0.002435,"#3e93ff"
75671093,revistalafuga,10,3,3,6,0.319459,0.481885,0.000974,"#ff0d69"
76020353,Esri_Spain,49,4,1,5,0.61904,0.460912,0.000487,"#8ecfec"
76146283,CienciaPR,10,3,2,5,0.18097,0.450495,0.000487,"#3bec00"
76547015,pavesipavesi,39,3,12,15,0.40211,0.350338,0.005358,"#00e8b2"
76607286,ElBierzoDigital,21,7,1,8,0.42595,0.879475,0.001948,"#ffa64e"
76674192,CalamoyCran,48,7,1,8,0.524551,0.56274,0.001948,"#ffb800"
76746450,pedro_ojeda,48,4,0,4,0.575393,0.610837,0,"#ffb800"
77185791,silvymargarita,25,6,10,16,0.419849,0.493521,0.005845,"#ff0d69"
77205777,MosaicUOC,36,6,2,8,0.539645,0.284073,0.001948,"#00e8b2"
77209211,Bibliotecas_UC,26,4,3,7,0.30674,0.298439,0.001461,"#3e93ff"
77415983,merinol,50,2,9,11,0.466147,0.430142,0.00341,"#3e93ff"
78068951,undervivi,17,0,4,4,0.366559,0.526513,0,"#3e93ff"
78104190,cliotropic,0,1,4,5,0.302651,0.44112,0.000487,"#ff77ff"
78236617,alimcamara,1,2,4,6,0.364554,0.5762,0.000974,"#825403"
78442404,bestqualitycrab,0,1,4,5,0.340034,0.444323,0.000487,"#3e93ff"
78544627,digibis,39,8,8,16,0.405478,0.631539,0.005845,"#fcae7e"
78841292,BelenaVeleta,15,8,4,12,0.516833,0.538285,0.003897,"#006032"
78887411,UniofHerts,12,2,4,6,0.388919,0.402694,0.000974,"#ff77ff"
79238964,MuseuAstronomia,39,14,4,18,0.425945,0.278434,0.006819,"#00e8b2"
79271706,matthewdlincoln,12,37,6,43,0.405441,0.463785,0.018997,"#ff77ff"
79299249,Europeanaeu,21,12,2,14,0.421418,0.619129,0.004871,"#ffb800"
79570388,_carlosherrera,19,8,10,18,0.477033,0.43706,0.006819,"#ff77ff"
79749280,berrydm,0,8,0,8,0.396903,0.449844,0.001948,"#3e93ff"
79988143,OVTT,15,6,4,10,0.461655,0.51339,0.002923,"#006032"
80206028,Carlosbreporta,50,3,2,5,0.764541,0.429077,0.000487,"#008bdd"
80386427,alexbrey,12,24,3,27,0.387347,0.452017,0.011203,"#ff77ff"
80408010,lacatedra,46,0,14,14,0.38787,0.552816,0.004871,"#3bec00"
80603909,ich_tat,12,0,4,4,0.310943,0.341228,0,"#ff77ff"
80625624,la_UPC,14,5,0,5,0.583748,0.322166,0.000487,"#b6cb00"
80807653,srosmu,46,29,15,44,0.428211,0.528433,0.019484,"#ffb800"
80871603,wcaleb,12,54,3,57,0.386633,0.453434,0.025816,"#ff77ff"
81002479,eco_onis,31,11,25,36,0.372132,0.460756,0.015587,"#3e93ff"
81081065,cronicaglobal,14,10,0,10,0.720104,0.15562,0.002923,"#b6cb00"
81702317,uvigo,0,11,0,11,0.434806,0.451132,0.00341,"#ff0d69"
81893387,cinvestav,46,4,0,4,0.385119,0.513631,0,"#ffb800"
81929909,LauraPLarraya,15,0,4,4,0.502134,0.483254,0,"#006032"
82380256,silvia_cho,12,4,0,4,0.328297,0.342966,0,"#ff77ff"
82409699,UAQmx,0,57,3,60,0.338841,0.40269,0.027277,"#3e93ff"
82445181,llilasbenson,12,19,1,20,0.392996,0.456765,0.007793,"#ff77ff"
82655077,FILMineria,0,12,0,12,0.303029,0.383607,0.003897,"#3e93ff"
82889243,jairoamelo,12,143,113,256,0.403478,0.447249,0.122747,"#ff77ff"
83045340,ibeleno,19,4,13,17,0.408814,0.422867,0.006332,"#ff77ff"
83129069,juanca028,46,0,5,5,0.336127,0.573583,0.000487,"#3bec00"
83180640,JuanSe_417,46,0,6,6,0.3043,0.459013,0.000974,"#3bec00"
83320468,merchesan,37,0,5,5,0.403334,0.59426,0.000487,"#8ecfec"
83582126,acdelion,0,1,3,4,0.432245,0.388216,0,"#3e93ff"
83995049,LuisDeLaPeJ,19,1,5,6,0.520928,0.47993,0.000974,"#00ed5d"
84094267,ufvmadrid,39,4,4,8,0.425352,0.588963,0.001948,"#fcae7e"
84156832,gramelgar,17,0,7,7,0.476631,0.596388,0.001461,"#3bec00"
84633183,AuryGarcia_,0,0,10,10,0.330031,0.491702,0.002923,"#ff0d69"
84702117,AnaCorojan,21,2,4,6,0.478501,0.477396,0.000974,"#ffa64e"
84707102,s_papastamkou,12,1,6,7,0.375001,0.430084,0.001461,"#ff77ff"
84735244,Pintomiraya,0,0,5,5,0.354807,0.456131,0.000487,"#3e93ff"
85001358,PrensaULA,50,19,1,20,0.841182,0.410447,0.007793,"#008bdd"
85130724,saladeprensa,17,53,2,55,0.566616,0.665698,0.024842,"#3bec00"
85343435,unicomplutense,46,66,0,66,0.463299,0.532151,0.0302,"#ffb800"
85627317,interaccio,15,5,1,6,0.45153,0.443599,0.000974,"#ff0d69"
85683238,journalWebSem,0,4,0,4,0.473766,0.486456,0,"#ff0d69"
85788285,elcultural,37,8,0,8,0.397839,0.519592,0.001948,"#fcae7e"
85812259,esMONDRAGON,35,8,1,9,0.573805,0.615521,0.002435,"#008ebb"
86126384,UNAM_FCPyS,26,7,1,8,0.393383,0.375844,0.001948,"#3e93ff"
86380901,adnauseam_,0,9,17,26,0.367372,0.487463,0.010716,"#3e93ff"
86390214,Wikipedia,0,12,0,12,0.382091,0.458957,0.003897,"#3e93ff"
86585500,Cheivs,46,7,6,13,0.4214,0.463863,0.004384,"#3bec00"
86861883,fzerboni,17,0,6,6,0.36893,0.636916,0.000974,"#3bec00"
87068047,rocha_thais,39,2,2,4,0.421345,0.38764,0,"#00e8b2"
87272789,mrockembach,39,7,3,10,0.413617,0.370729,0.002923,"#00e8b2"
87408443,FECYT_Ciencia,46,3,1,4,0.441796,0.544339,0,"#ffb800"
87726517,mataderomadrid,28,4,2,6,0.463276,0.416072,0.000974,"#8ecfec"
87918200,jenniferisve,12,147,131,278,0.355139,0.464741,0.133463,"#ff77ff"
87967640,chaolinliu,0,0,7,7,0.36291,0.463202,0.001461,"#ffb800"
88095677,Purdom_L,0,1,15,16,0.349881,0.47074,0.005845,"#3bec00"
88178223,jatenas,46,5,1,6,0.377121,0.551621,0.000974,"#3bec00"
88259828,BAlmarazC,26,2,5,7,0.2589,0.303547,0.001461,"#c42c63"
88312018,weareDAQ,1,0,5,5,0.311054,0.545652,0.000487,"#825403"
88332362,_AMariela,0,1,3,4,0.35994,0.429539,0,"#3e93ff"
88395586,AntonioDome,46,0,4,4,0.440209,0.58469,0,"#ffb800"
88483635,puc_sp,39,6,0,6,0.41843,0.290228,0.000974,"#00e8b2"
88694828,AgendaUnicamp,39,7,0,7,0.372461,0.240263,0.001461,"#00e8b2"
88699372,ivntres,48,0,9,9,0.52641,0.618921,0.002435,"#008ebb"
88796380,felipe_mexico,0,0,11,11,0.337382,0.476003,0.00341,"#3e93ff"
89176279,issa_ave,46,2,3,5,0.480543,0.464444,0.000487,"#00ed5d"
89258666,fernando__lopez,46,76,41,117,0.35426,0.548926,0.055041,"#3bec00"
89309417,UNIRIO_Oficial,39,6,0,6,0.350083,0.266607,0.000974,"#00e8b2"
89312744,Literature_Geek,12,6,15,21,0.313064,0.467556,0.008281,"#ff77ff"
89472246,UPV,48,15,0,15,0.398324,0.600385,0.005358,"#3bec00"
89525927,citicresearch,49,10,3,13,0.393609,0.56244,0.004384,"#ff0d69"
89607377,julianjem,19,4,18,22,0.413374,0.415462,0.008768,"#ff77ff"
89718182,eumanismo,46,41,78,119,0.386306,0.504489,0.056016,"#3e93ff"
89746885,JAngelLeon,50,12,4,16,0.619819,0.419259,0.005845,"#008bdd"
90000018,frangp,49,0,6,6,0.386213,0.555583,0.000974,"#ff0d69"
90072965,Haviau,0,0,4,4,0.405477,0.413161,0,"#3e93ff"
90324876,digitalmedieval,39,7,0,7,0.345853,0.590678,0.001461,"#fcae7e"
90364910,tic,14,6,0,6,0.532449,0.368753,0.000974,"#b6cb00"
90495916,anacabello,46,11,16,27,0.398622,0.586399,0.011203,"#3bec00"
90549534,dhnow,0,51,0,51,0.361633,0.471045,0.022893,"#ffb800"
90598880,fundacioncd,46,10,4,14,0.449464,0.537947,0.004871,"#3bec00"
90661080,vitoeps,15,2,4,6,0.538852,0.537532,0.000974,"#006032"
90674648,IBERO_mx,12,10,0,10,0.369065,0.367817,0.002923,"#ff77ff"
90828164,hypothesesorg,48,25,1,26,0.475325,0.50236,0.010716,"#8ecfec"
90950560,agumiglio,17,3,6,9,0.363004,0.607927,0.002435,"#3bec00"
91382195,Univ_Villanueva,46,2,2,4,0.555284,0.495943,0,"#ff0d69"
91438333,elotroalex,0,110,36,146,0.343713,0.45478,0.069167,"#3e93ff"
91511905,UAntwerpen,46,9,0,9,0.413537,0.571456,0.002435,"#ffb800"
91601683,mapisaro,19,1,20,21,0.511971,0.445878,0.008281,"#00ed5d"
91612785,jhergony,46,2,2,4,0.134449,0.640603,0,"#3bec00"
91695075,octavioarbelaez,19,1,4,5,0.522075,0.538074,0.000487,"#5456a6"
91927275,DayofDH,46,221,64,285,0.414549,0.490492,0.136873,"#ffb800"
92014786,aleixvalls,14,5,0,5,0.588451,0.283311,0.000487,"#b6cb00"
92231255,rosabelUA,15,1,3,4,0.490287,0.531215,0,"#006032"
92263542,elearningcesga,49,7,3,10,0.302987,0.542036,0.002923,"#c6cc85"
92331865,santiperezisasi,0,22,67,89,0.40422,0.510303,0.041403,"#ff0d69"
92381471,jburnford,12,20,0,20,0.397793,0.425089,0.007793,"#ff77ff"
92443514,SamVGatica,26,0,8,8,0.384273,0.441341,0.001948,"#3e93ff"
92536561,RedAcademica,19,3,2,5,0.535938,0.391518,0.000487,"#00ed5d"
92630324,elpezflaco,0,6,13,19,0.353803,0.46517,0.007306,"#3e93ff"
92634871,ivonnelujano,46,23,13,36,0.344837,0.469997,0.015587,"#3bec00"
93000629,IlzianeLaune,39,2,2,4,0.421677,0.34589,0,"#00e8b2"
93021235,udp_cl,10,6,2,8,0.295152,0.458081,0.001948,"#3bec00"
93074055,UAOCEU,48,2,2,4,0.795152,0.742369,0,"#66e087"
93221940,Mopsos1,46,1,12,13,0.429969,0.552515,0.004384,"#ffb800"
93247565,vgportal,39,2,2,4,0.334893,0.436536,0,"#00e8b2"
93363172,felixtuesta,1,0,4,4,0.22986,0.521329,0,"#825403"
93578999,tihui,0,2,6,8,0.356244,0.422917,0.001948,"#3e93ff"
93655583,filarramendi,39,41,21,62,0.415076,0.600029,0.028251,"#fcae7e"
93735450,BURSofia,46,19,21,40,0.402333,0.567154,0.017535,"#ffb800"
93901769,UAEM_MX,35,14,0,14,0.22919,0.309163,0.004871,"#c42c63"
93972404,LarissaCrespoMx,26,0,4,4,0.402062,0.388498,0,"#3e93ff"
94034938,e_duco,15,1,3,4,0.418477,0.543163,0,"#006032"
94050446,NicksNames,15,0,7,7,0.49784,0.500621,0.001461,"#006032"
94114407,kosmopolisCCCB,1,4,0,4,0.653335,0.612434,0,"#008ebb"
94130850,ljsimonb,17,2,2,4,0.338205,0.562175,0,"#3bec00"
94131301,EHESS_fr,39,6,0,6,0.429415,0.449515,0.000974,"#3bec00"
94265190,FES_ACATLAN,0,24,0,24,0.340386,0.419048,0.009742,"#3e93ff"
94411552,3duard0rivera,0,0,7,7,0.336958,0.413046,0.001461,"#3e93ff"
94637919,aguilandrea,46,0,4,4,0.309692,0.441622,0,"#3bec00"
94803477,carescano,15,5,1,6,0.651832,0.442782,0.000974,"#006032"
95039432,cepmalaga,6,2,5,7,0.864178,0.339715,0.001461,"#006032"
95210070,CasasSilviaS,17,0,4,4,0.44585,0.576894,0,"#3bec00"
95433165,AATSPglobal,0,11,0,11,0.403867,0.451054,0.00341,"#3e93ff"
95446652,Karisma,19,9,0,9,0.469752,0.425867,0.002435,"#00ed5d"
95507710,leonautajujuy,46,2,2,4,0.355576,0.625977,0,"#ffb800"
95654761,BibliotecaNalCo,19,225,62,287,0.481605,0.389388,0.137847,"#00ed5d"
96312462,maurotov,19,7,2,9,0.432594,0.552404,0.002435,"#00ed5d"
96392139,akuestas,46,0,7,7,0.458331,0.502408,0.001461,"#ff0d69"
96683447,mvaldeb,10,4,1,5,0.217646,0.40152,0.000487,"#3bec00"
96837167,robinson_ma,39,0,5,5,0.467152,0.218237,0.000487,"#00e8b2"
97075570,urielcast,0,0,9,9,0.43202,0.443938,0.002435,"#ffb800"
97113902,carsan12,37,11,9,20,0.467067,0.622988,0.007793,"#ffb800"
97257206,cuau_cruz,20,3,5,8,0.375204,0.252918,0.001948,"#f4c8cf"
97260223,sisibuchile,10,12,3,15,0.298692,0.412651,0.005358,"#3bec00"
97405431,ediazsan,22,1,14,15,0.424951,0.559323,0.005358,"#8ecfec"
97591901,nombreimpropio,0,4,14,18,0.434568,0.539133,0.006819,"#ff0d69"
97883387,LluisAgusti,48,4,5,9,0.48882,0.586562,0.002435,"#008ebb"
98636576,ULL,48,21,7,28,0.499113,0.644387,0.01169,"#008ebb"
98660192,cbamadrid,21,60,24,84,0.528228,0.488945,0.038967,"#ffa64e"
99096555,lourdesepstein,26,0,4,4,0.480357,0.437573,0,"#3e93ff"
99707590,mezgravis,39,3,7,10,0.477998,0.473571,0.002923,"#00e8b2"
99869536,DANNIELLA14,12,0,6,6,0.369306,0.432926,0.000974,"#ff77ff"
100033765,perroroque,15,0,4,4,0.544258,0.51499,0,"#ff0d69"
100070760,rocioserna__,28,9,0,9,0.430945,0.591269,0.002435,"#8ecfec"
100118307,Lalysds,46,0,33,33,0.348409,0.536291,0.014126,"#3bec00"
100252669,oscuriosa,0,0,30,30,0.407377,0.506011,0.012664,"#3e93ff"
100440332,leeres,28,15,2,17,0.312954,0.601619,0.006332,"#8ecfec"
100533939,gastonbecerra,36,8,8,16,0.219067,0.484559,0.005845,"#403538"
100592931,Danieldazaprado,46,5,9,14,0.288564,0.535485,0.004871,"#3bec00"
101129558,nesdaniel,35,0,4,4,0.289981,0.460078,0,"#c42c63"
101319424,DIANA_VAL,19,0,10,10,0.35037,0.377241,0.002923,"#00ed5d"
101826976,Mertrak,1,6,10,16,0.242772,0.564304,0.005845,"#825403"
101881914,raypadilla1,36,6,2,8,0.257758,0.269276,0.001948,"#6c241e"
101895548,meigul,46,4,1,5,0.332674,0.61124,0.000487,"#3bec00"
102206860,RadioUNAM,26,6,1,7,0.291683,0.272092,0.001461,"#3e93ff"
102481444,amdvfa,48,0,5,5,0.513492,0.56832,0.000487,"#008ebb"
102535845,IIEs_UNAM,10,11,2,13,0.32388,0.332312,0.004384,"#3e93ff"
102964431,anterotesis,0,8,0,8,0.370272,0.372187,0.001948,"#3e93ff"
102986075,RedCLARA,39,5,0,5,0.377808,0.43516,0.000487,"#00e8b2"
103025842,Tec_CCM,36,6,0,6,0.280335,0.5608,0.000974,"#6c241e"
103258683,MolinodeIdeas,46,0,5,5,0.364921,0.570266,0.000487,"#ffb800"
103280958,gobiline,0,5,1,6,0.396747,0.565291,0.000974,"#8ecfec"
103409751,cibermarikiya,15,14,26,40,0.484118,0.546496,0.017535,"#006032"
103437718,rennygranda,46,0,5,5,0.344947,0.564206,0.000487,"#3bec00"
103596787,betacerq,39,11,7,18,0.438279,0.351125,0.006819,"#00e8b2"
103638498,Trifenol,39,0,5,5,0.405949,0.299521,0.000487,"#00e8b2"
103875784,EditoraFGV,12,7,0,7,0.402192,0.432177,0.001461,"#ff77ff"
103939677,pablodeolavide,22,56,12,68,0.327487,0.52311,0.031174,"#8ecfec"
103992636,yoly_m,54,0,4,4,0.561127,0.527363,0,"#c6cc85"
104062818,MerIriondo,48,3,2,5,0.541081,0.570325,0.000487,"#ff0d69"
104160141,AZuberogoitia,35,4,6,10,0.53321,0.521549,0.002923,"#c42c63"
104250408,traficantes2010,15,6,9,15,0.4871,0.397643,0.005358,"#006032"
104257449,DiplomadosIbero,12,5,2,7,0.358204,0.335504,0.001461,"#ff77ff"
104648362,MaggieNavarr0,46,0,5,5,0.505903,0.61142,0.000487,"#008ebb"
104880391,irvin_psb,35,0,8,8,0.280797,0.395078,0.001948,"#c42c63"
104894644,electricarchaeo,12,28,7,35,0.398484,0.458944,0.0151,"#ff77ff"
105165692,kathrynpiquette,48,2,10,12,0.415256,0.552326,0.003897,"#008ebb"
105237750,T_Organiza,1,0,6,6,0.452927,0.613769,0.000974,"#ff12a3"
105374781,CristobalBarria,39,3,1,4,0.333295,0.348075,0,"#00e8b2"
105560931,ballpa,0,2,8,10,0.406565,0.484093,0.002923,"#3e93ff"
105876020,amdelvaz,22,32,26,58,0.404039,0.543073,0.026303,"#8ecfec"
106065260,mirsantos,39,0,8,8,0.435617,0.359921,0.001948,"#00e8b2"
106093928,mromandl,26,0,9,9,0.321784,0.408338,0.002435,"#3e93ff"
106116553,dancassany,15,7,1,8,0.709783,0.533625,0.001948,"#006032"
106562154,imuguetam,48,2,3,5,0.367424,0.627895,0.000487,"#008ebb"
106769240,elpais_tec,46,4,0,4,0.467853,0.548409,0,"#ffb800"
106770944,yapalf,27,0,4,4,0.926123,0.183048,0,"#00ed5d"
106806419,ValentinCarrera,21,14,19,33,0.430283,0.710833,0.014126,"#ffa64e"
107051182,upvehu,48,17,0,17,0.443663,0.598385,0.006332,"#008ebb"
107114193,freitas_mh,39,0,4,4,0.485385,0.004887,0,"#00e8b2"
107145333,UHouston,12,17,0,17,0.318425,0.426714,0.006332,"#ff77ff"
107374564,AnaSerranoT,48,0,5,5,0.514732,0.573211,0.000487,"#fcae7e"
107393104,GedisaEditorial,22,12,4,16,0.388603,0.615357,0.005845,"#ffb800"
107529577,asicomred,48,0,4,4,0.498711,0.606361,0,"#8ecfec"
107624688,EmelynRobot,17,5,6,11,0.372994,0.583021,0.00341,"#3bec00"
107692607,unelibros,15,2,2,4,0.397269,0.618255,0,"#8ecfec"
107792238,oscarszarate,12,0,5,5,0.380861,0.406187,0.000487,"#ff77ff"
108029164,UCLDH,0,3,1,4,0.367707,0.456181,0,"#3e93ff"
108069810,redeln,0,4,4,8,0.547627,0.360229,0.001948,"#3e93ff"
108124132,adriaceves,0,0,9,9,0.371807,0.494876,0.002435,"#3e93ff"
108273745,citafgsr,46,2,3,5,0.444935,0.589535,0.000487,"#3bec00"
108326567,juanagarciaduqu,19,0,4,4,0.418393,0.416814,0,"#3e93ff"
108440425,UV_EG,15,39,0,39,0.491461,0.477439,0.017048,"#006032"
108467957,Marcus_Camus,12,2,8,10,0.436336,0.469011,0.002923,"#3bec00"
108648804,maturanaricardo,1,13,0,13,0.331294,0.517338,0.004384,"#825403"
108873806,fafddeportes,15,0,8,8,0.510777,0.48501,0.001948,"#006032"
108977809,UninorteCO,19,5,0,5,0.431296,0.473828,0.000487,"#3e93ff"
108987958,Uniandinos,12,5,0,5,0.451874,0.387236,0.000487,"#00ed5d"
109154400,alexsaum,46,18,16,34,0.391605,0.480999,0.014613,"#ffb800"
109432928,felixtrevino,46,2,2,4,0.422417,0.446762,0,"#ffb800"
109502786,MarianaEguaras,48,3,3,6,0.446449,0.549352,0.000974,"#ffb800"
109681332,BeatrizGallardo,0,0,18,18,0.416212,0.525358,0.006819,"#ff0d69"
109705840,DIEB_UNAL,19,0,4,4,0.354651,0.325877,0,"#00ed5d"
110259026,CulturaenBta,19,13,4,17,0.601422,0.363676,0.006332,"#00ed5d"
110312729,LuCerquera,46,0,4,4,0.32029,0.455302,0,"#3bec00"
110423800,imagenfest,19,8,0,8,0.618707,0.586085,0.001948,"#5456a6"
110465562,j_w_baker,12,59,38,97,0.388938,0.456649,0.0453,"#ff77ff"
110652739,CESGA_,49,6,8,14,0.411163,0.570646,0.004871,"#ff0d69"
111075843,LeoEliasDavid,12,4,0,4,0.325354,0.4631,0,"#ff77ff"
111132067,statsmaths,12,30,0,30,0.374766,0.46152,0.012664,"#ff77ff"
111362011,bulpgc,46,0,4,4,0.445553,0.556065,0,"#ffb800"
111423733,siglodelhombre,19,3,1,4,0.544802,0.482956,0,"#00ed5d"
111591104,Nanigs,48,1,6,7,0.420246,0.573554,0.001461,"#008ebb"
111651073,Campusmilenio,39,3,1,4,0.561835,0.423021,0,"#ff0d69"
111702697,apoyomutuo,24,11,3,14,0.588083,0.489302,0.004871,"#3bec00"
112021333,aceballosm,19,6,16,22,0.658805,0.677052,0.008768,"#5456a6"
112033498,MargeFigueroa,19,4,1,5,0.528603,0.465028,0.000487,"#00ed5d"
112284808,BrunabLESSed,0,0,5,5,0.3856,0.418395,0.000487,"#3e93ff"
112498897,sedici_unlp,46,10,0,10,0.422841,0.554838,0.002923,"#3bec00"
112610515,Ted_Underwood,19,10,0,10,0.414894,0.444036,0.002923,"#3e93ff"
112742370,aby_merino,0,3,3,6,0.275636,0.49246,0.000974,"#3e93ff"
113127283,ArchivoGeneral,19,20,2,22,0.534968,0.366644,0.008768,"#00ed5d"
113412296,ciesas,26,8,7,15,0.367176,0.348681,0.005358,"#3e93ff"
113469749,tlatland,46,16,16,32,0.355109,0.543105,0.013639,"#3bec00"
113600987,stefano_2punto0,0,0,13,13,0.396243,0.444182,0.004384,"#3e93ff"
113658962,davidgarrofe,14,5,0,5,0.608767,0.263982,0.000487,"#b6cb00"
113698634,silfemina,48,1,3,4,0.496354,0.629875,0,"#008ebb"
114216982,FredTruyen,15,7,3,10,0.463011,0.590372,0.002923,"#006032"
114388311,sigfridlundberg,49,0,4,4,0.30613,0.523196,0,"#3bec00"
114507083,carlosau7,19,0,11,11,0.381851,0.486346,0.00341,"#3e93ff"
114528144,ernestopena,0,10,15,25,0.423084,0.451551,0.010229,"#3e93ff"
114775508,DialogosCanal11,0,3,5,8,0.244152,0.416674,0.001948,"#3e93ff"
114802918,LasNavesINN,15,2,3,5,0.355653,0.53831,0.000487,"#006032"
115045848,pmorenocollado,46,2,4,6,0.429307,0.590618,0.000974,"#3bec00"
115141670,RodrigoMorenoGu,12,9,3,12,0.425781,0.367135,0.003897,"#ff77ff"
115273149,heberquijano,0,0,4,4,0.329306,0.463088,0,"#3e93ff"
115416310,UNIRuniversidad,25,134,43,177,0.368849,0.508351,0.084267,"#ff0d69"
115478293,IISUE_UNAM,0,21,9,30,0.341888,0.39203,0.012664,"#3e93ff"
115650900,unirioja,43,5,1,6,0.178504,0.595986,0.000974,"#ffb800"
115691686,minotaurodigita,15,3,11,14,0.38599,0.528053,0.004871,"#ff0d69"
115775168,TecdeMonterrey,36,38,0,38,0.249708,0.490881,0.016561,"#00e8b2"
115944812,mbd_uc3m,46,4,1,5,0.400109,0.586032,0.000487,"#ffb800"
116214228,digitaldante,39,0,10,10,0.377016,0.430148,0.002923,"#00e8b2"
116392868,USPCEU,1,10,4,14,0.381211,0.529844,0.004871,"#ff12a3"
116491957,tonywebsoc,46,2,3,5,0.383558,0.56037,0.000487,"#ffb800"
116828005,carmenbeat,50,0,4,4,0.688454,0.405405,0,"#008bdd"
116925166,Banrepcultural,19,73,8,81,0.511792,0.460496,0.037506,"#00ed5d"
117034312,cirollueca,15,21,14,35,0.499203,0.551464,0.0151,"#ff0d69"
117122341,personaGGL,19,0,4,4,0.446492,0.461356,0,"#00ed5d"
117356139,MatiasBarchino,37,7,2,9,0.397136,0.571089,0.002435,"#fcae7e"
117405708,juanjoberger,10,0,7,7,0.285386,0.428684,0.001461,"#3bec00"
117556542,albertcaste,14,9,0,9,0.592523,0.272707,0.002435,"#b6cb00"
117702814,datchery8,0,0,10,10,0.369074,0.479773,0.002923,"#ffb800"
118224151,elcolmex,26,249,36,285,0.344378,0.367401,0.136873,"#3e93ff"
118268716,lemarderi,48,0,9,9,0.41649,0.534851,0.002435,"#008ebb"
118284622,m_chavoya,12,1,5,6,0.355611,0.407575,0.000974,"#ff77ff"
118471077,ebiblioteke,0,3,14,17,0.414469,0.486035,0.006332,"#3e93ff"
118482051,tabitamoreno,46,8,6,14,0.248881,0.484868,0.004871,"#3bec00"
118523988,ariadnalaberint,0,0,4,4,0.423344,0.518678,0,"#ffb800"
118666101,EdinburghUP,39,9,0,9,0.39854,0.440707,0.002435,"#00e8b2"
119229837,IIFL_UNAM,0,66,6,72,0.408205,0.367189,0.033122,"#3e93ff"
119241934,FedesoftCol,46,3,1,4,0.399392,0.65481,0,"#ff77ff"
119427098,HubitoTintel,36,0,4,4,0.166127,0.477285,0,"#00e8b2"
119797535,CIDE_MX,27,4,0,4,0.514781,0.222034,0,"#00ed5d"
119842153,hibridaart,39,1,8,9,0.413542,0.429648,0.002435,"#00e8b2"
120058741,ramonsuarez_,1,3,1,4,0.324898,0.570587,0,"#825403"
120095188,simone_belli_,49,8,3,11,0.467291,0.465862,0.00341,"#ffa64e"
120166541,EnLaCiutat,48,9,5,14,0.406264,0.498337,0.004871,"#ff0d69"
120619507,flalomorales,17,1,3,4,0.338181,0.569337,0,"#3bec00"
121107220,archivadorsalam,21,0,15,15,0.466018,0.527247,0.005358,"#ffa64e"
121207150,SeguNina,12,3,3,6,0.385072,0.362523,0.000974,"#ff77ff"
121217094,arteenteoria,46,0,5,5,0.380412,0.545847,0.000487,"#ffb800"
121257902,Flor52Torrez,46,0,6,6,0.361729,0.528986,0.000974,"#3bec00"
121398330,InfoUMA,15,120,4,124,0.487236,0.530546,0.058451,"#ff0d69"
121425987,BibCraiGandia,31,13,2,15,0.48649,0.354711,0.005358,"#ff0d69"
121530610,AlvarezUned,34,22,21,43,0.595627,0.610611,0.018997,"#ffb800"
121793513,vlatido,0,0,7,7,0.320405,0.416188,0.001461,"#3e93ff"
122017893,eitbeus,48,0,4,4,0.520363,0.910261,0,"#008ebb"
122025737,Red_Carolina,37,3,3,6,0.476349,0.724961,0.000974,"#fcae7e"
122124151,Humanidades_AB,48,7,0,7,0.469632,0.599193,0.001461,"#fcae7e"
122353251,ComunidadMadrid,48,7,0,7,0.602007,0.749127,0.001461,"#008ebb"
122385223,Marianaarqueo,10,0,6,6,0.356377,0.403381,0.000974,"#00ed5d"
122468872,JuanM_Romero,46,0,4,4,0.311438,0.511834,0,"#3bec00"
122520367,romansuarezg,0,2,4,6,0.381339,0.420617,0.000974,"#3e93ff"
123130352,jaruizm,0,2,45,47,0.412078,0.456157,0.020945,"#3e93ff"
123471479,uclm_es,37,49,3,52,0.466521,0.644677,0.02338,"#fcae7e"
123606160,revistasunam,0,4,0,4,0.323096,0.306471,0,"#3e93ff"
123715428,rmcamposvazquez,26,1,4,5,0.327645,0.319048,0.000487,"#3e93ff"
123904982,noraquirozgil,46,0,6,6,0.367041,0.549896,0.000974,"#3bec00"
123944767,_apei,48,3,2,5,0.561532,0.626506,0.000487,"#ff0d69"
123949057,Enriquevillalba,15,96,45,141,0.47282,0.548715,0.066732,"#006032"
124147306,sophiealamo,17,20,17,37,0.366471,0.554348,0.016074,"#3bec00"
124158282,portal_com,17,44,0,44,0.48545,0.649355,0.019484,"#3bec00"
124182351,UdGBiblioteca,48,5,0,5,0.57525,0.546975,0.000487,"#ff0d69"
124420482,angelschacon,14,5,0,5,0.597865,0.281208,0.000487,"#b6cb00"
124503241,j_gorrin,50,0,4,4,0.643728,0.458239,0,"#008bdd"
125112507,isaacbuzo,46,1,3,4,0.392159,0.720061,0,"#ffb800"
125391822,usal,28,115,16,131,0.395181,0.579413,0.061861,"#8ecfec"
125640115,univcadiz,36,4,0,4,0.514856,0.362556,0,"#00e8b2"
125733124,uquipermui,48,2,4,6,0.468013,0.606946,0.000974,"#008ebb"
125951671,akramzarefi,21,1,6,7,0.564276,0.791541,0.001461,"#ffa64e"
126114776,Paukiernan,17,0,5,5,0.3702,0.62366,0.000487,"#3bec00"
126530608,Agnoscisneme,0,11,5,16,0.310834,0.324485,0.005845,"#3e93ff"
126649657,FundacionBarrie,54,3,2,5,0.535576,0.543053,0.000487,"#c6cc85"
126774554,Becante13,46,0,6,6,0.327529,0.558515,0.000974,"#ffb800"
126928429,jean_bauer,0,4,13,17,0.379743,0.469707,0.006332,"#3e93ff"
127021810,elotrojames,54,0,4,4,0.481758,0.482834,0,"#c6cc85"
127161215,educacion3_0,1,4,0,4,0.381335,0.637384,0,"#825403"
127308740,alroca01,19,1,3,4,0.365214,0.404963,0,"#3e93ff"
127680067,lmiguelgs,19,0,4,4,0.592551,0.624107,0,"#5456a6"
127839245,robertoigarza,46,2,3,5,0.340003,0.548029,0.000487,"#3bec00"
127905882,nidiachavez,1,3,11,14,0.33495,0.514825,0.004871,"#825403"
128045880,pacobib,15,0,4,4,0.456881,0.593175,0,"#ff0d69"
128196131,triplingual,46,0,14,14,0.379148,0.475084,0.004871,"#ffb800"
128286711,ap4ntoja,21,3,5,8,0.523002,0.657136,0.001948,"#006032"
128372940,jairbolsonaro,39,4,0,4,0.503926,0.013181,0,"#00e8b2"
128378328,Katjktp,12,2,6,8,0.354955,0.513992,0.001948,"#ff77ff"
128587123,oriolamat,14,6,0,6,0.562496,0.368193,0.000974,"#b6cb00"
128910302,eajournal,0,3,2,5,0.378528,0.516253,0.000487,"#3e93ff"
129253485,museoelder,37,5,0,5,0.485027,0.69214,0.000487,"#ffb800"
129596166,CarmeFenoll,14,1,11,12,0.571648,0.318142,0.003897,"#b6cb00"
129834397,RazonPublica,19,7,2,9,0.455671,0.38442,0.002435,"#3e93ff"
129842675,Ingridguardiola,48,6,2,8,0.593876,0.500806,0.001948,"#ff0d69"
129922490,marinavalles,48,0,4,4,0.513962,0.540036,0,"#008ebb"
130300937,jperezarellano,17,3,2,5,0.348613,0.839498,0.000487,"#3bec00"
130472933,Catigupe,48,2,2,4,0.6288,0.512899,0,"#ff0d69"
130823696,CirculolecRoma,12,0,4,4,0.400284,0.424701,0,"#ff77ff"
130864812,patron_carina,54,0,5,5,0.590727,0.690213,0.000487,"#c6cc85"
130868126,mateotw,22,1,5,6,0.32885,0.570791,0.000974,"#8ecfec"
131138085,exiliadas,15,12,1,13,0.527631,0.588584,0.004384,"#006032"
131288180,casadelahuizote,0,7,6,13,0.326833,0.437591,0.004384,"#3bec00"
131368505,argamax89,0,0,6,6,0.332755,0.461545,0.000974,"#3e93ff"
131720153,Edgar_Ivan_G,15,0,4,4,0.581303,0.53566,0,"#006032"
131811653,dantespuppet,49,0,4,4,0.400287,0.511446,0,"#ffa64e"
131878801,vruizt,17,0,7,7,0.369484,0.610673,0.001461,"#3bec00"
131961403,claudiohhgordo,0,0,4,4,0.395407,0.500079,0,"#3e93ff"
132035959,lamaroc,10,0,5,5,0.301678,0.465964,0.000487,"#3bec00"
132278677,pekitsch39,0,0,9,9,0.414095,0.469902,0.002435,"#3e93ff"
132310937,effusivelynerdy,12,0,8,8,0.39745,0.498366,0.001948,"#ff77ff"
132352604,hilodigital,46,1,21,22,0.439145,0.519027,0.008768,"#ffb800"
132462698,colsocpona,49,2,2,4,0.573975,0.454189,0,"#8ecfec"
132631349,aguiausp,39,4,1,5,0.375636,0.308805,0.000487,"#00e8b2"
132792612,AM_ISRAEL,0,1,3,4,0.377341,0.349583,0,"#3e93ff"
132911490,pepcerda,37,0,4,4,0.483592,0.528633,0,"#fcae7e"
133075303,Tlozferk,48,1,4,5,0.481454,0.400761,0.000487,"#ff77ff"
133361792,institutomora,12,6,3,9,0.313769,0.416658,0.002435,"#3e93ff"
133382202,FIMA_UB,48,8,8,16,0.496256,0.574488,0.005845,"#008ebb"
133415058,casaoswaldocruz,39,32,2,34,0.441667,0.276224,0.014613,"#00e8b2"
133439438,amadeupons,48,0,6,6,0.516114,0.57895,0.000974,"#ff0d69"
133671326,SoniaMulero,48,3,1,4,0.616584,0.520816,0,"#ff0d69"
133740232,ivansottoh,17,9,5,14,0.364481,0.765306,0.004871,"#3bec00"
134296976,hacklib,0,4,14,18,0.332812,0.417262,0.006819,"#3e93ff"
134498026,colegeografos,48,11,5,16,0.524384,0.438653,0.005845,"#008ebb"
134754834,IN3_UOC,15,6,1,7,0.553841,0.545854,0.001461,"#ff0d69"
134908464,virgicinq,49,0,5,5,0.465139,0.513011,0.000487,"#ffa64e"
134921020,K_Leonard_PhD,12,0,5,5,0.278802,0.458629,0.000487,"#ff77ff"
135081147,granadadigital,15,4,6,10,0.480866,0.513981,0.002923,"#006032"
135635051,gustavo_urbano,46,5,0,5,0.328171,0.487856,0.000487,"#3bec00"
135716096,MarcesWisdom,12,0,4,4,0.346597,0.427903,0,"#ff77ff"
135733620,xhardez,46,0,4,4,0.302818,0.550084,0,"#3bec00"
135828994,FBVMC,12,25,14,39,0.345609,0.491801,0.017048,"#ff77ff"
135953646,UIS,30,6,2,8,0.482446,0.266365,0.001948,"#ff77ff"
136072898,Thinksamuel,39,4,2,6,0.424321,0.348459,0.000974,"#00e8b2"
136205259,FGCSIC,48,6,0,6,0.541586,0.527747,0.000974,"#008ebb"
136285682,agenciaiisi,37,5,0,5,0.487315,0.691459,0.000487,"#ffb800"
136370967,uamcuajimalpa,17,4,0,4,0.248257,0.532659,0,"#006032"
136983882,dr_aguarras,12,0,4,4,0.428288,0.42965,0,"#ff77ff"
137224187,MTerelugo,46,0,7,7,0.328754,0.559486,0.001461,"#3bec00"
137273883,diariodeleon,48,11,0,11,0.410113,0.625739,0.00341,"#008ebb"
137292640,mariveh,15,1,4,5,0.507494,0.522253,0.000487,"#006032"
137302034,culturauma,15,6,4,10,0.513085,0.516762,0.002923,"#ff0d69"
137430700,liliana_villet,50,0,4,4,0.704502,0.4129,0,"#008bdd"
137472749,crisfarres,14,9,5,14,0.630032,0.232332,0.004871,"#b6cb00"
137977131,BUCantabria,48,2,3,5,0.421947,0.585217,0.000487,"#008ebb"
137989918,BraisRomanino,15,6,9,15,0.495318,0.399457,0.005358,"#006032"
138030544,107ulafm,50,4,0,4,1,0.358224,0,"#008bdd"
138161380,mbutel,12,30,22,52,0.333217,0.48216,0.02338,"#ff77ff"
138233981,RubriaR,35,0,7,7,0.316703,0.413538,0.001461,"#c42c63"
138329816,bpradosp,15,0,5,5,0.551171,0.54354,0.000487,"#006032"
138458064,FILBogota,19,4,0,4,0.524164,0.479722,0,"#00ed5d"
138619304,vmmonte,39,4,0,4,0.047519,0.712722,0,"#00e8b2"
138813955,eltonteb,46,8,8,16,0.368301,0.494379,0.005845,"#3bec00"
139061771,carlosauthier,46,4,15,19,0.368487,0.535103,0.007306,"#3bec00"
139141820,laura_martinezd,0,8,34,42,0.393696,0.424559,0.018509,"#3e93ff"
139166540,caiocmello,39,0,4,4,0.411123,0.391281,0,"#00e8b2"
139689286,unileon,21,21,5,26,0.42373,0.592816,0.010716,"#ffa64e"
139704156,ANPUH,39,6,1,7,0.405908,0.347627,0.001461,"#00e8b2"
139777050,UniversidadUNAD,34,5,0,5,0.612628,0.603184,0.000487,"#ffb800"
140092403,hebusto,43,5,3,8,0.050568,0.62624,0.001948,"#ffb800"
140152180,navarrotradmed,15,19,7,26,0.442535,0.58474,0.010716,"#ff0d69"
140206203,JaviviRuizJ,19,0,5,5,0.421091,0.383355,0.000487,"#00ed5d"
141244061,tumasymejor,48,7,5,12,0.537117,0.560201,0.003897,"#008ebb"
141462475,jlso1o,0,0,4,4,0.424293,0.462188,0,"#3e93ff"
141472494,alfonsofierroo,46,2,2,4,0.423511,0.44618,0,"#ffb800"
141723734,ronaldfar,39,4,3,7,0.343487,0.473502,0.001461,"#00e8b2"
142005933,vicenele,46,0,8,8,0.392384,0.592174,0.001948,"#3bec00"
142122077,annita_cano,46,6,13,19,0.342204,0.497276,0.007306,"#3bec00"
142367257,UAM_Lerma,0,11,0,11,0.332948,0.44686,0.00341,"#3e93ff"
142454580,Ministerio_TIC,19,5,0,5,0.55614,0.436451,0.000487,"#00ed5d"
142752970,Tasconita,46,21,12,33,0.43627,0.522731,0.014126,"#ffb800"
142772226,elopezri,19,0,7,7,0.424965,0.395114,0.001461,"#00ed5d"
143026537,FundacionCEU,1,1,3,4,0.470591,0.497577,0,"#ff12a3"
143063993,UNISABANETA,19,13,3,16,0.611757,0.927138,0.005845,"#5456a6"
143088135,danielzapater,15,0,4,4,0.498585,0.482289,0,"#006032"
143194163,MargaTwita,17,9,5,14,0.368098,0.573556,0.004871,"#3bec00"
143200737,filosofiauchile,10,30,3,33,0.302776,0.342657,0.014126,"#3bec00"
143288428,Sositap,0,12,8,20,0.358422,0.41596,0.007793,"#3e93ff"
143321650,marcelabeltranb,0,0,7,7,0.360176,0.3918,0.001461,"#3e93ff"
143559488,aurelberra,10,13,12,25,0.371979,0.472775,0.010229,"#ffb800"
143567019,unedtudela,46,4,0,4,0.460384,0.606718,0,"#ffb800"
143607999,PyEC_TecdeMty,36,6,0,6,0.030222,0.578707,0.000974,"#00e8b2"
143779169,onmedic,31,0,7,7,0.485395,0.420678,0.001461,"#ff0d69"
143833319,Juanmhermosillo,46,5,0,5,0.427486,0.678823,0.000487,"#3bec00"
143909021,CNRS,48,9,0,9,0.427075,0.579267,0.002435,"#008ebb"
143924206,Mineducacion,19,4,0,4,0.665847,0.463237,0,"#00ed5d"
143936340,jbm_91,48,0,5,5,0.497544,0.573041,0.000487,"#008ebb"
144158624,Igniru,46,3,1,4,0.503754,0.426594,0,"#ffb800"
144547999,sevillajordi,14,2,2,4,0.485732,0.378043,0,"#ff0d69"
144557786,IberoPuebla,15,4,0,4,0.475582,0.442028,0,"#006032"
144590244,librosybitios,28,20,20,40,0.447319,0.49053,0.017535,"#ffb800"
144598478,AidaBSanchez,1,7,7,14,0.464402,0.537105,0.004871,"#006032"
144621025,kalutah,12,0,6,6,0.426472,0.453083,0.000974,"#ff77ff"
144804999,CanalUGR,15,127,7,134,0.501904,0.538414,0.063322,"#006032"
144945116,sebastiagiralt,48,0,7,7,0.464957,0.527517,0.001461,"#ff0d69"
145017853,jordipujolabcn,12,0,16,16,0.401245,0.49367,0.005845,"#ff77ff"
145670919,govern,14,5,0,5,0.595283,0.278458,0.000487,"#b6cb00"
145686963,GeoCensos,26,2,4,6,0.247146,0.340371,0.000974,"#3e93ff"
146362699,jomacorona,17,1,4,5,0.389995,0.568399,0.000487,"#3bec00"
146435936,pent_flacso,46,7,2,9,0.634154,0.762325,0.002435,"#00a04a"
146476339,dchavezheras,0,0,5,5,0.350143,0.489426,0.000487,"#ffb800"
146494080,ajspadial,12,9,36,45,0.41339,0.499302,0.019971,"#ff77ff"
146579675,Sofikowal,17,4,8,12,0.356524,0.59751,0.003897,"#3bec00"
146773811,amaiaarroyo,15,1,6,7,0.388539,0.504853,0.001461,"#006032"
146887578,USalvador,46,5,0,5,0.298107,0.535713,0.000487,"#3bec00"
146908488,evalezcano,0,0,4,4,0.393378,0.496646,0,"#ffb800"
147319561,cultureplex,19,52,43,95,0.408357,0.451589,0.044325,"#3e93ff"
147634213,hypertaste,25,6,7,13,0.398371,0.521413,0.004384,"#ff0d69"
147950034,napoleonmendez,19,0,5,5,0.465727,0.434086,0.000487,"#3e93ff"
148009767,Hangar_org,48,7,3,10,0.59933,0.497922,0.002923,"#ff0d69"
148238680,mgarciatrevino,0,0,4,4,0.458226,0.38475,0,"#3e93ff"
148398438,nestormarques,1,22,9,31,0.557513,0.495834,0.013151,"#ff12a3"
148722326,ibnreilly,15,2,4,6,0.567855,0.530258,0.000974,"#ff0d69"
149074214,FundacionUNED,46,15,3,18,0.497039,0.545696,0.006819,"#ffb800"
149974969,CataRestrepoD,19,3,7,10,0.53142,0.578511,0.002923,"#00ed5d"
150059762,AngieCabrera_,19,2,2,4,0.506556,0.532405,0,"#3e93ff"
150383840,UBAonline,46,3,3,6,0.245025,0.569535,0.000974,"#3bec00"
151079667,puertodigital,19,0,6,6,0.458989,0.531509,0.000974,"#ff0d69"
151116641,paige_roberts,0,4,3,7,0.303122,0.414043,0.001461,"#3e93ff"
151425419,BBVABancaRespon,48,1,3,4,0.500056,0.518101,0,"#ff0d69"
151432376,vilaadrian,46,0,4,4,0.416916,0.511449,0,"#ffb800"
151661476,juliangomezdel,26,0,4,4,0.331681,0.377286,0,"#3e93ff"
151823931,BURJC,15,4,2,6,0.497674,0.49042,0.000974,"#006032"
152017988,IIBUNAM,0,58,17,75,0.361431,0.410941,0.034584,"#3e93ff"
152051625,heatherfro,12,28,2,30,0.369473,0.417905,0.012664,"#ff77ff"
152093992,SebastianMFA,19,4,1,5,0.511943,0.389649,0.000487,"#00ed5d"
152515820,pabloschiaffino,36,5,1,6,0.55906,0.450496,0.000974,"#00e8b2"
152663628,MeganJMyers,0,6,4,10,0.33792,0.439824,0.002923,"#3e93ff"
152746123,zoso418,1,0,5,5,0.32967,0.496057,0.000487,"#825403"
152778171,rosariorogel,35,106,64,170,0.259769,0.402569,0.080857,"#c42c63"
153221642,taniuskaram,50,2,2,4,0.619444,0.511902,0,"#008bdd"
153320725,Symposium_es,46,0,14,14,0.40354,0.564514,0.004871,"#8ecfec"
153453487,renantomazini,39,2,6,8,0.414159,0.282703,0.001948,"#00e8b2"
153849756,cesarsortiz,25,0,5,5,0.442825,0.540329,0.000487,"#ff0d69"
153894288,RedCarolinaCol,37,2,3,5,0.482768,0.669421,0.000487,"#fcae7e"
154198440,BibloRedBogota,19,28,8,36,0.532269,0.383162,0.015587,"#00ed5d"
154244633,salalm,12,26,3,29,0.322537,0.452895,0.012177,"#00e8b2"
155031277,mariacastro1111,19,0,6,6,0.514138,0.389151,0.000974,"#00ed5d"
155470822,Wikimedia_mx,0,36,8,44,0.350173,0.431777,0.019484,"#3e93ff"
155613307,vjennyffer,19,5,2,7,0.521106,0.427627,0.001461,"#00ed5d"
155733520,MarsiasMarsias,46,17,33,50,0.427372,0.508973,0.022406,"#ffb800"
156078783,jeremythrone,46,0,4,4,0.344651,0.505075,0,"#ffb800"
156365095,Angeles_Addy,17,0,4,4,0.420178,0.681428,0,"#3bec00"
156658740,wp_es,54,9,1,10,0.487621,0.492538,0.002923,"#c6cc85"
156660942,cmvaronc,12,3,7,10,0.388393,0.46037,0.002923,"#ff77ff"
156719746,patobarna,46,2,5,7,0.273456,0.491796,0.001461,"#3bec00"
156775601,birloque,46,2,2,4,0.441152,0.515149,0,"#ffb800"
157030239,victmartinez,0,0,9,9,0.35178,0.430392,0.002435,"#3e93ff"
157248383,jlmunozr,28,0,4,4,0.489218,0.581569,0,"#ffa64e"
157383930,geo_domo,0,2,6,8,0.378134,0.481456,0.001948,"#3e93ff"
157809660,juanengonzalvez,1,7,3,10,0.332771,0.577916,0.002923,"#ff12a3"
157925546,htc_es,1,5,0,5,0.602665,0.61706,0.000487,"#ff12a3"
157981564,EU_Commission,14,5,0,5,0.582179,0.280407,0.000487,"#b6cb00"
158377129,LauraEchague,54,0,5,5,0.588051,0.687247,0.000487,"#c6cc85"
158445401,NEH_ODH,0,40,2,42,0.348042,0.475286,0.018509,"#ffb800"
158461349,MoraVicenteLuis,46,18,7,25,0.458916,0.468487,0.010229,"#ffb800"
158667401,FrederiqueLG,48,5,0,5,0.427592,0.502231,0.000487,"#008ebb"
159065668,lrpbyzard,46,3,7,10,0.315486,0.394234,0.002923,"#3bec00"
159238222,josededalus,46,2,3,5,0.313958,0.664074,0.000487,"#3bec00"
159631280,facu_it,31,0,5,5,0.469216,0.442479,0.000487,"#3bec00"
160346651,paigecmorgan,0,11,14,25,0.340773,0.455157,0.010229,"#ff77ff"
160347095,carojimenezpiza,46,4,2,6,0.301551,0.435712,0.000974,"#ffb800"
160873540,Melabosch,46,29,0,29,0.348634,0.553623,0.012177,"#3bec00"
161082811,UPMexico,39,15,0,15,0.547138,0.469491,0.005358,"#ff0d69"
161245703,toledoayto,37,6,0,6,0.482784,0.642646,0.000974,"#fcae7e"
161557211,fahusac,46,8,0,8,0.646846,0.757308,0.001948,"#00a04a"
162518249,carmonatierno,0,2,5,7,0.426404,0.532225,0.001461,"#ff0d69"
162667212,museudeldisseny,48,8,4,12,0.478143,0.617656,0.003897,"#008ebb"
162693918,fhersanmi,15,3,10,13,0.483071,0.504788,0.004384,"#006032"
162915642,abregotron,0,0,5,5,0.349771,0.491151,0.000487,"#ffb800"
163933146,WookieeTropical,12,0,14,14,0.367679,0.427375,0.004871,"#ff77ff"
164253308,clusterticgal,49,3,5,8,0.421636,0.579733,0.001948,"#ff0d69"
164290943,ericbrasiln,39,68,62,130,0.39345,0.348721,0.061374,"#00e8b2"
164293634,Geniakagi,15,0,4,4,0.51368,0.481951,0,"#006032"
164450358,marioguzzzman,39,5,1,6,0.748685,0.251424,0.000974,"#00e8b2"
164621412,MuseoTransicion,21,6,0,6,0.533114,0.709547,0.000974,"#ffa64e"
164653540,KharolusIII,46,10,17,27,0.360121,0.524373,0.011203,"#3bec00"
164777194,SigloDurango,17,7,1,8,0.346642,0.771242,0.001948,"#3bec00"
164877642,mspillar10,39,0,9,9,0.414084,0.415744,0.002435,"#00e8b2"
164962255,adriansalinasv,0,0,5,5,0.353434,0.488725,0.000487,"#ffb800"
165337642,9vidas,12,1,3,4,0.433446,0.423941,0,"#ff77ff"
165342631,teoriantropolog,26,0,7,7,0.350248,0.427376,0.001461,"#3e93ff"
165484051,RedNel_,19,3,2,5,0.46979,0.411516,0.000487,"#00ed5d"
165626004,DannyYahary,36,0,4,4,0.174302,0.479397,0,"#00e8b2"
165724114,XavierAntich,14,5,0,5,0.574068,0.323722,0.000487,"#b6cb00"
165792584,Gomezjrs,48,0,6,6,0.41968,0.566785,0.000974,"#008ebb"
165841068,NelVillarreal,54,0,4,4,0.627638,0.661823,0,"#c6cc85"
166030592,rivaquiroga,12,36,5,41,0.373385,0.428708,0.018022,"#ff77ff"
166507237,elEconomistaes,22,5,0,5,0.610777,0.596192,0.000487,"#8ecfec"
166513773,melinamasnatta,0,1,4,5,0.336697,0.498659,0.000487,"#3e93ff"
166533671,ConsMadrono,15,34,24,58,0.484222,0.551152,0.026303,"#006032"
166576970,esfera_publica_,12,0,6,6,0.38013,0.265405,0.000974,"#ff77ff"
166649009,DigAmericanists,12,2,3,5,0.310442,0.40205,0.000487,"#ff77ff"
166704830,alereclus,12,0,8,8,0.422763,0.426121,0.001948,"#ff77ff"
167004627,LupitaLGarfias,49,2,249,251,0.385201,0.479749,0.120312,"#3bec00"
167029777,BiblioBurgoa,35,6,2,8,0.238192,0.426481,0.001948,"#c42c63"
167142337,TEIconsortium,49,91,16,107,0.318148,0.472613,0.05017,"#3bec00"
167313469,andalgeos,15,4,4,8,0.64138,0.443318,0.001948,"#ff0d69"
167744248,piapaulette,12,0,4,4,0.563758,0.386774,0,"#ff77ff"
167837430,algonhermen,48,0,4,4,0.468508,0.48,0,"#3e93ff"
167950063,sandvaldettaro,46,6,3,9,0.321489,0.575348,0.002435,"#3bec00"
168447928,emilio_delrio,37,5,2,7,0.621476,0.636308,0.001461,"#ffb800"
168627231,ferli90,0,0,4,4,0.374238,0.503968,0,"#3e93ff"
168636686,BiblogTecarios,46,21,0,21,0.407052,0.620849,0.008281,"#008ebb"
168998883,PIMEC,14,5,0,5,0.600223,0.266683,0.000487,"#b6cb00"
169135109,onica_aguilar,0,2,4,6,0.350739,0.381965,0.000974,"#3e93ff"
169147882,UniversidadEan,19,5,2,7,0.467815,0.42365,0.001461,"#00ed5d"
169317877,josemiguelmuniz,0,2,9,11,0.294894,0.504678,0.00341,"#3e93ff"
169922611,wakelet,34,5,0,5,0.596749,0.648644,0.000487,"#ffb800"
170790316,ivetiga,35,9,4,13,0.241632,0.368419,0.004384,"#c42c63"
171014736,bibupo,22,20,17,37,0.415416,0.567985,0.016074,"#8ecfec"
171047449,UMU,28,14,4,18,0.589382,0.712378,0.006819,"#008ebb"
171285443,Karibenitez34,36,0,6,6,0.125694,0.517257,0.000974,"#00e8b2"
171319361,ArquitectoAB,19,0,4,4,0.562189,0.473233,0,"#5456a6"
171720258,martinalalu,17,6,4,10,0.298521,0.556685,0.002923,"#3bec00"
171881265,marinageli,14,9,0,9,0.593838,0.275277,0.002435,"#b6cb00"
172139322,icanogar,46,9,42,51,0.379429,0.506324,0.022893,"#3bec00"
172368909,BancoRepublica,19,1,3,4,0.46006,0.452007,0,"#3e93ff"
172387310,TraduXio,39,5,0,5,0.404376,0.391074,0.000487,"#00e8b2"
172873047,Kelley_Kreitz,12,2,4,6,0.307344,0.423572,0.000974,"#ff77ff"
173881525,iaravps,39,2,19,21,0.415165,0.400489,0.008281,"#00e8b2"
173915441,DHcenterNet,0,22,0,22,0.37361,0.495743,0.008768,"#ffb800"
174301293,MemoriaChilena,32,407,6,413,0.120387,0.21662,0.199221,"#00ed5d"
174661911,hipermedula,48,6,2,8,0.443774,0.536588,0.001948,"#ff0d69"
174675713,ip_ciisa,10,4,0,4,0.287695,0.440432,0,"#3bec00"
174681621,gabygalindez,33,5,0,5,0.695496,0.596255,0.000487,"#3bec00"
175179487,Fernan_Molina,26,0,4,4,0.334481,0.380803,0,"#3e93ff"
175513035,rojasinostroza,10,3,1,4,0.247369,0.292882,0,"#00ed5d"
175563147,Maravillaaaa,36,0,4,4,0.158828,0.489046,0,"#00e8b2"
175806207,agaviriau,12,3,2,5,0.477232,0.313544,0.000487,"#ff77ff"
176278453,MARIAAGOMEZU,19,0,5,5,0.637378,0.686207,0.000487,"#5456a6"
176670324,ROGdelaH,12,0,7,7,0.416422,0.396474,0.001461,"#ff77ff"
176733810,annettestr,46,0,13,13,0.378384,0.506731,0.004384,"#ffb800"
176932593,UCBerkeley,15,13,0,13,0.487488,0.494479,0.004384,"#ff0d69"
177154434,byrone19,34,5,1,6,0.758726,0.610978,0.000974,"#ffb800"
177275765,fgv_emap,39,8,0,8,0.413802,0.420073,0.001948,"#00e8b2"
177368645,Barbarellatweet,37,0,4,4,0.498871,0.529572,0,"#fcae7e"
177567220,galarzaalex,0,2,12,14,0.402055,0.45934,0.004871,"#3bec00"
177916054,jrlopezbenito,35,7,4,11,0.516538,0.588906,0.00341,"#c42c63"
178038250,oscarenriquehr,0,1,5,6,0.303229,0.454355,0.000974,"#3e93ff"
178148164,carguero,19,0,4,4,0.357293,0.327436,0,"#00ed5d"
178468034,natcorbe,46,10,19,29,0.368433,0.517044,0.012177,"#3bec00"
179778442,airam_ainegue,17,3,1,4,0.337465,0.60639,0,"#3bec00"
180298000,RubenVerborgh,12,29,0,29,0.379577,0.459516,0.012177,"#ff77ff"
180342891,jmvva,46,6,8,14,0.432205,0.49822,0.004871,"#ffb800"
180489593,anamamoreno,46,4,0,4,0.426264,0.653369,0,"#ffb800"
180782707,bitiji,1,0,10,10,0.369687,0.490936,0.002923,"#825403"
180798348,laesel,0,0,4,4,0.503292,0.476264,0,"#3e93ff"
180810338,saritaal,48,9,2,11,0.453288,0.472278,0.00341,"#008ebb"
181246416,JFeNegro,50,6,2,8,0.599847,0.505525,0.001948,"#008bdd"
181275446,grillopez,46,5,1,6,0.392246,0.492189,0.000974,"#3bec00"
181284454,tomasgna,19,22,0,22,0.545593,1,0.008768,"#3e93ff"
181973595,TextualScholar,0,1,23,24,0.38248,0.489635,0.009742,"#3e93ff"
182055772,NUILOS,12,0,8,8,0.447676,0.392054,0.001948,"#ff77ff"
182136328,marc_sogues,48,0,4,4,0.423792,0.568698,0,"#ff0d69"
182493103,ai_rivera,10,3,5,8,0.347708,0.337632,0.001948,"#3e93ff"
182573469,lolaescreva,39,4,4,8,0.49387,0.02429,0.001948,"#00e8b2"
182928017,IIBI_UNAM_MX,26,11,6,17,0.305565,0.433204,0.006332,"#3e93ff"
182932778,Corpoeducacion,19,5,1,6,0.499633,0.422554,0.000974,"#00ed5d"
183099929,Utadeo_edu_co,19,15,0,15,0.449167,0.43005,0.005358,"#00ed5d"
183183245,telefonica_ed,1,8,1,9,0.198174,0.500591,0.002435,"#825403"
183420811,danillero,48,5,0,5,0.496675,0.612109,0.000487,"#008ebb"
183540750,Jberenike,46,0,5,5,0.381893,0.486598,0.000487,"#3e93ff"
183586438,Amroman1,46,49,14,63,0.343087,0.667259,0.028738,"#3bec00"
183706945,BibECOCFCH,39,0,7,7,0.412965,0.308754,0.001461,"#00e8b2"
183969483,Biblioteca_UNED,46,64,17,81,0.448705,0.542434,0.037506,"#ffb800"
183988375,Mario_Colleoni,50,7,4,11,0.555932,0.560419,0.00341,"#ffb800"
184186590,ALCASABAL,46,0,4,4,0.342996,0.580504,0,"#3bec00"
184290612,oropa9,0,0,6,6,0.473722,0.457913,0.000974,"#3e93ff"
184563620,kmapesy,0,0,10,10,0.387715,0.463728,0.002923,"#3e93ff"
184810137,DrBicentenario,46,4,0,4,0.318808,0.609621,0,"#3bec00"
184917701,popaylove,46,0,7,7,0.349884,0.531477,0.001461,"#ffb800"
185267188,cbchileag,0,8,0,8,0.330981,0.454937,0.001948,"#3e93ff"
185293144,andrews_cath,27,0,4,4,0.420814,0.356463,0,"#ff77ff"
185389270,do_paulo,39,7,10,17,0.42398,0.36332,0.006332,"#00e8b2"
185567052,LIBEReurope,46,8,0,8,0.363678,0.528992,0.001948,"#3bec00"
185895357,StephGarces,19,0,9,9,0.436883,0.463533,0.002435,"#00ed5d"
186149907,Wences91,15,0,5,5,0.519712,0.51345,0.000487,"#006032"
186223142,hernandolopera,46,7,35,42,0.355169,0.534546,0.018509,"#3bec00"
186378357,desemboltura,12,0,15,15,0.365677,0.446669,0.005358,"#ff77ff"
187873235,Merce_G,14,1,14,15,0.552529,0.349634,0.005358,"#b6cb00"
187966054,alejandromx_11,0,0,5,5,0.357748,0.330712,0.000487,"#3e93ff"
188405911,egiordanino,46,16,37,53,0.383581,0.545608,0.023867,"#3bec00"
188500621,ScholCommons,12,0,4,4,0.352277,0.426789,0,"#ff77ff"
188653902,raulolivan,48,12,0,12,0.524518,0.557581,0.003897,"#008ebb"
188672931,carlacolombati,46,1,13,14,0.35345,0.535201,0.004871,"#ffb800"
188725330,UniBarcelona,48,24,0,24,0.519022,0.546562,0.009742,"#008ebb"
188992557,FerreiraLuisi,54,0,5,5,0.602599,0.684692,0.000487,"#c6cc85"
189266930,t_applicada,15,1,3,4,0.510032,0.544013,0,"#006032"
189276553,manuelm_mx,0,12,10,22,0.324178,0.514409,0.008768,"#3e93ff"
189664003,roserbenavides,48,0,5,5,0.536586,0.518745,0.000487,"#ff0d69"
189928602,agsb_bilbao,17,2,3,5,0.43756,0.655495,0.000487,"#3bec00"
190202376,mpiEscobar,12,1,3,4,0.386555,0.483619,0,"#ff77ff"
190336857,devhrmx,1,10,6,16,0.195507,0.49515,0.005845,"#825403"
190783515,HD,46,11,0,11,0.402363,0.53799,0.00341,"#8ecfec"
190886946,profwernimont,12,0,13,13,0.302634,0.449435,0.004384,"#ff77ff"
190995776,joselupalacios,46,0,4,4,0.38843,0.537793,0,"#ffb800"
191143493,CSIC,48,47,0,47,0.448408,0.603577,0.020945,"#008ebb"
191470544,ffyh_unc,46,4,0,4,0.340213,0.631894,0,"#ffb800"
191479929,LoriteFonta,1,1,7,8,0.415496,0.542402,0.001948,"#3bec00"
192077546,revistaluthor,46,14,2,16,0.218228,0.578258,0.005845,"#3bec00"
192268644,ALoreli,15,2,12,14,0.48502,0.519269,0.004871,"#006032"
192411472,bibliotecasUNAM,26,0,6,6,0.313802,0.421689,0.000974,"#3e93ff"
192811471,I3Aunizar,48,1,3,4,0.35956,0.703347,0,"#008ebb"
192858272,BUSCUSC,48,7,11,18,0.391948,0.55238,0.006819,"#ffb800"
192981712,AgEInves,46,6,0,6,0.391405,0.552298,0.000974,"#fcae7e"
193066262,robertocuadros1,22,3,6,9,0.370392,0.59364,0.002435,"#8ecfec"
193206912,MontseOlive,15,0,4,4,0.498119,0.487198,0,"#006032"
193221975,CMontcusi,0,0,4,4,0.422992,0.505814,0,"#008ebb"
193533732,nayaroldan,0,6,2,8,0.329724,0.350494,0.001948,"#3e93ff"
194043970,elemontiel,48,6,8,14,0.464725,0.653394,0.004871,"#008ebb"
194047322,jor_gracia,48,35,5,40,0.458355,0.671609,0.017535,"#008ebb"
194297768,_lezti_,12,0,26,26,0.396676,0.469407,0.010716,"#ff77ff"
194715814,Alorenzo1957,21,1,6,7,0.562851,0.794611,0.001461,"#ffa64e"
194820145,un_bogota,19,6,0,6,0.394006,0.354741,0.000974,"#00ed5d"
195100950,articaonline,54,37,4,41,0.501392,0.52935,0.018022,"#c6cc85"
195150298,UNAMdigital,26,40,1,41,0.427631,0.425282,0.018022,"#3e93ff"
195359126,VicenteBenitezG,36,8,2,10,0.139394,0.45973,0.002923,"#6c241e"
195811909,HumanidadesTO,37,71,14,85,0.468961,0.577254,0.039454,"#fcae7e"
196015866,MCHedgehog_,0,17,15,32,0.320711,0.417021,0.013639,"#3e93ff"
196124212,alfredocorell,46,2,2,4,0.345571,0.550673,0,"#ffb800"
196147311,FerrarelliM,48,1,4,5,0.420505,0.6059,0.000487,"#008ebb"
196178283,ram6macedo,26,0,4,4,0.392838,0.404223,0,"#3e93ff"
196229662,mopoza,46,2,8,10,0.405042,0.51709,0.002923,"#ffb800"
196384173,INAHmx,0,16,4,20,0.367134,0.393945,0.007793,"#3e93ff"
197026804,granadaenlared,15,5,0,5,0.54272,0.487718,0.000487,"#ff0d69"
197199146,Lineamadrid,28,69,1,70,0.487861,0.189583,0.032148,"#8ecfec"
197601400,evemuseografia,50,4,0,4,0.48245,0.606863,0,"#008bdd"
197868423,jojokarlin,12,5,7,12,0.372669,0.383059,0.003897,"#3e93ff"
198442204,dactilosedicion,1,3,3,6,0.331619,0.568372,0.000974,"#825403"
198570024,luismiyou,48,0,6,6,0.487374,0.557335,0.000974,"#008ebb"
198795345,patrimrodilla,49,6,27,33,0.437078,0.510958,0.014126,"#ff0d69"
198803317,FundacionISD,48,15,6,21,0.35688,0.502992,0.008281,"#008ebb"
198887843,LaUASLP,12,11,3,14,0.369445,0.408126,0.004871,"#ff77ff"
198926150,CIIDET,31,11,1,12,0.458948,0.36831,0.003897,"#3e93ff"
199182471,cerlope,46,4,1,5,0.444324,0.54578,0.000487,"#ffb800"
200326766,MaritheOru,36,0,4,4,0.146428,0.490831,0,"#00e8b2"
200731864,laumonteroc,17,0,4,4,0.345108,0.554418,0,"#3bec00"
200770882,elemmental_com,54,12,2,14,0.41832,0.538803,0.004871,"#c6cc85"
201413739,Mangeles_HM,48,0,4,4,0.538951,0.528344,0,"#008ebb"
201935267,JAriza10,12,0,4,4,0.460988,0.433834,0,"#ff77ff"
202321002,rdu_unam,26,56,0,56,0.503049,0.397428,0.025329,"#3e93ff"
203703517,jagzarandona,46,2,2,4,0.254657,0.503001,0,"#ffb800"
204071829,yasir_HS,0,0,4,4,0.362526,0.445945,0,"#3e93ff"
204100902,PapelesDeMusica,48,10,3,13,0.335517,0.641799,0.004384,"#008ebb"
204232370,mrodriguezarn,48,1,12,13,0.473819,0.521225,0.004384,"#008ebb"
204670349,IPEditorial,1,7,4,11,0.385433,0.539794,0.00341,"#825403"
204739101,josepnieto,14,0,6,6,0.625074,0.216559,0.000974,"#b6cb00"
204946934,Cuatroochenta,15,2,2,4,0.60086,0.637378,0,"#006032"
205195655,maxplanckpress,39,7,0,7,0.421885,0.378302,0.001461,"#00e8b2"
205283098,brigitnr,48,5,0,5,0.605669,0.514167,0.000487,"#ff0d69"
205640203,TE_GranEmpresa,1,21,5,26,0.307712,0.576389,0.010716,"#825403"
206158727,AdelasherasL,21,6,0,6,0.558457,0.803862,0.000974,"#ffa64e"
206364045,cadenaroa,26,2,3,5,0.483498,0.448322,0.000487,"#3e93ff"
206375063,FLACSOARGENTINA,46,7,0,7,0.365337,0.459753,0.001461,"#3bec00"
206396279,jgabelas,48,6,12,18,0.44304,0.615594,0.006819,"#008ebb"
206702819,DrVilledlTorre,25,0,14,14,0.404411,0.505183,0.004871,"#ff0d69"
208038261,dogandel,15,0,4,4,0.528462,0.522446,0,"#006032"
208262079,Jgb_santos,39,1,3,4,0.408666,0.306507,0,"#00e8b2"
208291902,nellysgc,50,0,7,7,0.61354,0.414034,0.001461,"#008bdd"
208405755,UPVCampusGandia,31,14,2,16,0.508781,0.359443,0.005845,"#ff0d69"
208676931,RULibraries,39,6,0,6,0.339426,0.344391,0.000974,"#00e8b2"
208747620,inchocordero,15,2,2,4,0.457332,0.47288,0,"#006032"
209075024,osfa_11,48,0,4,4,0.43419,0.500228,0,"#008ebb"
209093808,marilocastrillo,46,0,7,7,0.445479,0.558734,0.001461,"#ffb800"
209130989,ESDi_Barcelona,14,34,33,67,0.569877,0.326973,0.030687,"#b6cb00"
209193163,betgerber,17,1,5,6,0.350247,0.561777,0.000974,"#3bec00"
209363727,gisisch,46,0,5,5,0.510288,0.670636,0.000487,"#00a04a"
209484168,scoopit,48,59,0,59,0.453364,0.600182,0.02679,"#008ebb"
210128497,cjosegarza,38,7,1,8,0.605719,0.112666,0.001948,"#3e93ff"
210660373,UNTREF,36,7,0,7,0.210306,0.355824,0.001461,"#00e8b2"
210996391,sociobservermex,12,0,4,4,0.535954,0.333326,0,"#ff77ff"
211299754,FRodriguezJimen,21,1,14,15,0.501209,0.647156,0.005358,"#ffa64e"
211373182,AyeDic,19,0,5,5,0.383516,0.384147,0.000487,"#00ed5d"
211763566,codice_informa,0,3,2,5,0.308416,0.502175,0.000487,"#3e93ff"
211830307,cienciacanaria,37,0,5,5,0.500586,0.658344,0.000487,"#ffb800"
211989452,naidenmen,12,0,4,4,0.368305,0.240518,0,"#ff77ff"
212179973,isidore___,0,3,3,6,0.385237,0.5493,0.000974,"#3e93ff"
212243918,Km_Sabogal,36,13,26,39,0.453677,0.403194,0.017048,"#6c241e"
212297066,_CLACSO,26,22,6,28,0.266237,0.501673,0.01169,"#3bec00"
212312757,iberisTICs,39,5,4,9,0.660683,0.460939,0.002435,"#00e8b2"
212569176,teacherinside,39,1,3,4,0.695573,0.506926,0,"#00e8b2"
212759893,puentevaldivia,19,5,4,9,0.391453,0.381307,0.002435,"#00ed5d"
213099694,elquellegatarde,15,19,9,28,0.465014,0.532836,0.01169,"#006032"
213474460,CreativiTIC,35,5,2,7,0.482713,0.575986,0.001461,"#c42c63"
214292881,fmorales1980,42,8,5,13,0.309666,0.217915,0.004384,"#005076"
214733756,IC_Manila,25,0,4,4,0.423289,0.61551,0,"#8ecfec"
214965900,CampusMDelibes,48,3,13,16,0.399929,0.560578,0.005845,"#008ebb"
215205937,mangela_celis,37,37,33,70,0.441984,0.550238,0.032148,"#fcae7e"
215793735,rivkagreen,48,1,9,10,0.427097,0.53702,0.002923,"#008ebb"
215968373,unavbiblioteca,15,2,15,17,0.451714,0.534578,0.006332,"#8ecfec"
216072658,stratesys,35,4,2,6,0.321899,0.748183,0.000974,"#c42c63"
216311007,javierales,22,3,2,5,0.369351,0.620483,0.000487,"#8ecfec"
216334777,MECpy,36,18,0,18,0.152272,0.512999,0.006819,"#00e8b2"
216427970,arquivista2,15,3,4,7,0.479308,0.465134,0.001461,"#ff0d69"
216526330,eduescar,0,0,7,7,0.296121,0.438303,0.001461,"#3e93ff"
216739115,elpaisinenglish,39,4,0,4,0.398169,0.416671,0,"#00e8b2"
217166221,Georgina_BC,14,1,12,13,0.58014,0.31873,0.004384,"#b6cb00"
217804739,Facebook,46,5,0,5,0.394639,0.530228,0.000487,"#ffb800"
217885674,iyepes0120,0,0,4,4,0.37648,0.416678,0,"#3e93ff"
217927035,kedelsg,1,1,6,7,0.447257,0.583854,0.001461,"#825403"
218330700,dabautistac,12,7,18,25,0.441323,0.460981,0.010229,"#ff77ff"
218480903,Areandina,46,5,0,5,0.369707,0.614999,0.000487,"#008ebb"
218830003,emchateau,0,0,8,8,0.373213,0.476636,0.001948,"#ffb800"
220180748,titinamonina,0,1,5,6,0.399195,0.383816,0.000974,"#3e93ff"
220271264,fnietomorales,26,39,3,42,0.299995,0.220528,0.018509,"#3e93ff"
220843345,Priscilamateini,39,0,10,10,0.361351,0.458827,0.002923,"#00e8b2"
220911015,sandroidefilos,0,14,53,67,0.397939,0.459688,0.030687,"#3e93ff"
221050142,FyL_UAM,49,28,4,32,0.54689,0.498871,0.013639,"#ffa64e"
221313572,enlight_ED,1,22,8,30,0.325161,0.528143,0.012664,"#825403"
221510878,anvcscalar,0,2,2,4,0.284134,0.378478,0,"#ff77ff"
221540591,diagonalesweb,46,4,0,4,0.317028,0.582902,0,"#3bec00"
222109723,untiporaro,12,0,13,13,0.391504,0.457311,0.004384,"#ff77ff"
222269705,Ibangarciadb,21,7,6,13,0.478597,0.601581,0.004384,"#ffa64e"
222937952,vgutierrezsanz,46,3,6,9,0.359563,0.547033,0.002435,"#3bec00"
222950058,caedare,12,0,6,6,0.393321,0.411222,0.000974,"#ff77ff"
223235151,Nana_Cutzin,26,1,14,15,0.358031,0.460396,0.005358,"#3e93ff"
223279139,ccdinarte2010,26,2,6,8,0.69651,0.562492,0.001948,"#3e93ff"
223472601,DisfrutemosBA,46,9,0,9,0.124111,0.674175,0.002435,"#3bec00"
223580411,MauricioTexcoco,17,1,3,4,0.088349,0.560294,0,"#825403"
223593253,GomezBalza,50,4,6,10,0.561334,0.429205,0.002923,"#008bdd"
223598917,german_sierra,0,0,4,4,0.343742,0.464194,0,"#3e93ff"
223834901,sallesto,46,31,13,44,0.383868,0.489493,0.019484,"#3bec00"
224289167,Beba_Perez,1,2,5,7,0.59921,0.601499,0.001461,"#ff12a3"
224331457,juvelas,0,7,2,9,0.36452,0.268204,0.002435,"#3e93ff"
224355972,jhinfinito,12,6,13,19,0.453685,0.442703,0.007306,"#00ed5d"
224392992,sofia_valenzuel,32,4,1,5,0.088273,0.392248,0.000487,"#3bec00"
224631899,figshare,0,3,1,4,0.431269,0.465765,0,"#3e93ff"
225001462,grafosfera,22,26,33,59,0.439861,0.487393,0.02679,"#ff0d69"
225066068,LinaCWills,19,5,6,11,0.451398,0.391847,0.00341,"#00ed5d"
225144089,elcolsan,0,19,11,30,0.352944,0.390528,0.012664,"#3e93ff"
225453405,Clarafatri,22,0,4,4,0.161713,0.559151,0,"#8ecfec"
226212235,amesassy,0,4,37,41,0.380444,0.47053,0.018022,"#3e93ff"
226713255,tatianaduplat,19,5,5,10,0.562003,0.404497,0.002923,"#00ed5d"
226790871,BPPiloto,46,3,1,4,0.194015,0.537533,0,"#3bec00"
227090031,MJesusCanizares,14,3,2,5,0.67166,0.186005,0.000487,"#b6cb00"
227264918,adgfad,48,8,4,12,0.491643,0.627394,0.003897,"#008ebb"
227358393,unil,25,8,0,8,0.403331,0.577024,0.001948,"#ff0d69"
227368346,IC_Bruselas,22,14,6,20,0.33726,0.692191,0.007793,"#8ecfec"
227539872,josegeeklml,19,18,27,45,0.377241,0.416025,0.019971,"#3e93ff"
228057112,Alexherregil,46,1,3,4,0.154001,0.531885,0,"#3bec00"
228317338,AndaluciaTECH,15,3,4,7,0.450911,0.512523,0.001461,"#ff0d69"
228402125,SunriseAtTheSky,49,1,9,10,0.37687,0.535434,0.002923,"#ffa64e"
228875500,lema2r,46,22,40,62,0.418678,0.517427,0.028251,"#ffb800"
229059335,GaleEMEA,39,5,0,5,0.34368,0.31879,0.000487,"#00e8b2"
229127266,MarcMaciaFarre,19,0,11,11,0.436817,0.526199,0.00341,"#00ed5d"
230823610,Aleph43,19,0,6,6,0.548129,0.562437,0.000974,"#5456a6"
231144760,ferranet2,49,14,7,21,0.454432,0.401285,0.008281,"#ff77ff"
231204463,latinategua,17,3,1,4,0.093416,0.608189,0,"#ffb800"
231261891,Ipsorai,0,6,6,12,0.319819,0.397342,0.003897,"#3e93ff"
231411941,ivan_hombre,48,0,4,4,0.511129,0.595718,0,"#008ebb"
231495872,EPLaRioja,25,3,1,4,0.403795,0.437683,0,"#ff0d69"
231577324,NetflixLAT,0,7,0,7,0.331236,0.499793,0.001461,"#3e93ff"
231787884,JAdelSazN,22,9,19,28,0.395495,0.551507,0.01169,"#8ecfec"
232270046,acasasm,15,0,4,4,0.454315,0.463835,0,"#ff0d69"
232312176,ratservidor,0,5,12,17,0.377949,0.429809,0.006332,"#3e93ff"
232629381,yolvistupac3,15,0,8,8,0.472772,0.552994,0.001948,"#006032"
232681569,caribouwireless,12,0,4,4,0.231595,0.431604,0,"#ff77ff"
232885702,SarahRafaGarcia,12,5,5,10,0.291397,0.405482,0.002923,"#ff77ff"
233107654,cantavest,46,1,29,30,0.369301,0.503526,0.012664,"#3bec00"
233204912,netievalage,0,0,4,4,0.342038,0.480962,0,"#ffb800"
233318916,_JuanAlvarez_,19,7,2,9,0.449044,0.415476,0.002435,"#00ed5d"
233443807,jadesdelgado,50,12,4,16,0.644331,0.415904,0.005845,"#008bdd"
233476466,Rev_Comunicar,0,13,2,15,0.412261,0.419398,0.005358,"#3e93ff"
233731854,cesar_moheno,12,2,11,13,0.397699,0.407026,0.004384,"#ff77ff"
234234865,elgabomx,0,0,5,5,0.378903,0.419736,0.000487,"#3e93ff"
234283437,alexandracanet,48,9,2,11,0.517476,0.520175,0.00341,"#ff0d69"
234911507,maymonides,15,0,6,6,0.45633,0.34453,0.000974,"#ff0d69"
235232731,aquinisima,46,0,5,5,0.419229,0.580538,0.000487,"#3bec00"
235261861,rstudio,39,4,0,4,0.330377,0.412382,0,"#00e8b2"
235269347,mocatcal,36,10,5,15,0.36189,0.328539,0.005358,"#ff77ff"
235531566,imaniwadud,12,0,4,4,0.362047,0.425052,0,"#ff77ff"
235788291,AAparicioDeN,19,0,5,5,0.388534,0.448095,0.000487,"#ff77ff"
236509959,Ladysupertramp,21,0,6,6,0.575761,0.788712,0.000974,"#ffa64e"
236580539,TooboringStay,46,0,4,4,0.393988,0.613754,0,"#3bec00"
236624354,FTelefonicaMX,1,6,0,6,0.256134,0.55585,0.000974,"#3bec00"
236763232,leconomic,14,5,0,5,0.591718,0.264132,0.000487,"#b6cb00"
237346881,nodocultura,15,2,2,4,0.370933,0.573804,0,"#ffa64e"
237901719,MurrFuga,0,3,3,6,0.410425,0.404879,0.000974,"#3e93ff"
238066344,IRCVM,48,3,3,6,0.425044,0.65024,0.000974,"#008ebb"
238253188,igalina,0,162,33,195,0.403086,0.459743,0.093035,"#3e93ff"
239046450,MELUS_Society,49,4,0,4,0.323363,0.440191,0,"#ff77ff"
239244269,llaullipoma,15,0,5,5,0.492129,0.288377,0.000487,"#006032"
239357978,infouex,46,12,0,12,0.494694,0.600136,0.003897,"#ffb800"
239846241,suarez_juanluis,19,25,9,34,0.457003,0.477308,0.014613,"#3e93ff"
240012302,elravignani,46,13,8,21,0.232139,0.527462,0.008281,"#3bec00"
240205118,lusiettados,15,1,5,6,0.517399,0.524195,0.000974,"#006032"
240405634,ilihutsy,12,0,4,4,0.349696,0.40925,0,"#ff77ff"
240631660,MyriamHT,15,0,7,7,0.498983,0.510308,0.001461,"#006032"
240918302,IkerP54,0,0,6,6,0.450126,0.392247,0.000974,"#3e93ff"
241116398,DaliaGuerreiro,39,60,59,119,0.432531,0.459621,0.056016,"#00e8b2"
241191056,UPFBarcelona,48,6,0,6,0.502281,0.584694,0.000974,"#008ebb"
241192205,CANAL44TV,17,4,1,5,0.383401,0.69116,0.000487,"#3bec00"
241496609,dvilasuero,48,3,2,5,0.489236,0.651971,0.000487,"#008ebb"
241873745,Mirroque,39,5,4,9,0.454485,0.454112,0.002435,"#00e8b2"
241984387,enriccanela,14,10,10,20,0.598365,0.286506,0.007793,"#b6cb00"
242343224,educaciongob,46,6,0,6,0.464128,0.478011,0.000974,"#006032"
242410169,lmrhody,12,4,9,13,0.341715,0.396478,0.004384,"#ff77ff"
242665621,FundacionMalaga,15,2,2,4,0.520312,0.463156,0,"#ff0d69"
242751849,entreotrasideas,39,2,2,4,0.370006,0.69575,0,"#fcae7e"
242821538,lectordebarthes,15,3,4,7,0.488811,0.527267,0.001461,"#006032"
243097480,saloensenyament,14,4,1,5,0.5489,0.393747,0.000487,"#b6cb00"
243372020,caanalri95,49,5,6,11,0.464732,0.452853,0.00341,"#3bec00"
243585004,JuanPastorBus,15,4,1,5,0.625331,0.558575,0.000487,"#006032"
243785339,PalomaCuenca,48,2,2,4,0.421862,0.765016,0,"#3e93ff"
243807141,Xabi207,27,0,4,4,0.936449,0.183343,0,"#00ed5d"
244102858,mdmartos,0,7,0,7,0.432318,0.526882,0.001461,"#ffb800"
244311817,infoling,22,17,0,17,0.369626,0.604923,0.006332,"#3bec00"
244459746,alizardx,46,0,6,6,0.332056,0.530647,0.000974,"#3bec00"
244688753,elisahergueta,48,2,3,5,0.407955,0.708021,0.000487,"#008ebb"
244925950,culturaula,50,0,7,7,0.714982,0.415432,0.001461,"#008bdd"
245012645,montsemurianor,0,0,6,6,0.430838,0.519706,0.000974,"#ffb800"
245079892,LUCIATELLODIAZ,25,11,2,13,0.271733,0.5355,0.004384,"#ff0d69"
245275687,jucagm,28,1,4,5,0.405666,0.589064,0.000487,"#006032"
245326439,anarpacheco,46,1,13,14,0.398624,0.566075,0.004871,"#ffb800"
245376824,Aon_Espana,46,2,2,4,0.423789,0.58933,0,"#ffb800"
245413049,CatedraAR,36,29,3,32,0.320655,0.493807,0.013639,"#6c241e"
245913450,CDCHTA,50,1,3,4,0.94602,0.383428,0,"#008bdd"
245917381,emiliocanod,49,6,3,9,0.421453,0.598047,0.002435,"#008ebb"
246406098,Desinformemonos,40,6,0,6,0.490371,0.193668,0.000974,"#3e93ff"
246412003,cfievalladolid,1,19,3,22,0.574407,0.420426,0.008768,"#ff12a3"
246629511,JaviCruche,15,4,1,5,0.46002,0.501863,0.000487,"#ff0d69"
246867643,FIUPM,15,0,13,13,0.479204,0.559815,0.004384,"#006032"
246966216,RedUNIRED,41,8,0,8,0.252737,0.161529,0.001948,"#ff77ff"
247064887,luisge7,19,0,4,4,0.336212,0.31332,0,"#ff77ff"
247370192,unstablearchive,0,25,13,38,0.379165,0.44467,0.016561,"#3e93ff"
247430796,isagranada,15,0,5,5,0.530631,0.527243,0.000487,"#006032"
247521457,barb_rivera,46,8,21,29,0.329236,0.484845,0.012177,"#3bec00"
248378892,andreusuleduesa,48,7,0,7,0.484737,0.570625,0.001461,"#008ebb"
248631775,aranchaserantes,54,43,43,86,0.478845,0.529496,0.039942,"#c6cc85"
248854474,MJGarciaFolgado,22,0,10,10,0.393484,0.5756,0.002923,"#8ecfec"
249007164,digital2011b,0,1,35,36,0.383613,0.499728,0.015587,"#3e93ff"
249020331,BWDarligUlv,0,1,16,17,0.409259,0.42587,0.006332,"#3e93ff"
249220120,balabinnovacion,17,0,8,8,0.345537,0.585119,0.001948,"#3bec00"
249475327,rgluisalfonso,46,1,19,20,0.422512,0.549246,0.007793,"#ffb800"
249748466,nova_fcsh,39,15,3,18,0.433153,0.444339,0.006819,"#00e8b2"
249973139,DaniVeiraF,54,0,5,5,0.485124,0.473409,0.000487,"#c6cc85"
250051868,gimenez_cong,14,5,1,6,0.643942,0.384441,0.000974,"#b6cb00"
250065028,anacuquerella,46,14,4,18,0.495705,0.512592,0.006819,"#ff0d69"
250215833,mono_pensante,48,2,4,6,0.553865,0.470363,0.000974,"#ff0d69"
250349674,alejandraRR_,15,3,3,6,0.47018,0.54855,0.000974,"#006032"
250387200,aga_mun,15,0,6,6,0.525276,0.560006,0.000974,"#006032"
250623441,arteupo,22,8,4,12,0.488371,0.561232,0.003897,"#8ecfec"
250809048,LopezVillaverde,21,1,6,7,0.544715,0.728431,0.001461,"#ffa64e"
251676365,Zifarestevez,15,0,4,4,0.456567,0.56347,0,"#ffa64e"
251699535,cibertecaria,46,2,3,5,0.301304,0.524772,0.000487,"#3bec00"
251855271,SOSCarabanchel,21,6,2,8,0.503988,0.666002,0.001948,"#ffa64e"
252449010,Dirugu,12,0,4,4,0.406142,0.437127,0,"#ff77ff"
252724327,AsociacionACAL,48,8,6,14,0.537267,0.546559,0.004871,"#ff0d69"
252848690,OlgaLuCortes,0,0,6,6,0.514652,0.425699,0.000974,"#00ed5d"
252912120,mdcs87,12,14,61,75,0.364729,0.400464,0.034584,"#ff77ff"
253144556,moniquitri,0,5,2,7,0.296694,0.430664,0.001461,"#3e93ff"
253276820,CamiloMurciaG,19,3,11,14,0.384131,0.427305,0.004871,"#3e93ff"
253541892,LiceusSL,46,18,5,23,0.390999,0.600324,0.009255,"#3bec00"
253683163,TeresaLPellisa,15,14,6,20,0.508911,0.548847,0.007793,"#ff0d69"
253865251,elikaortega,0,103,33,136,0.341626,0.464754,0.064296,"#3e93ff"
253955945,Silvyamiga,1,2,2,4,0.295549,0.554549,0,"#825403"
254152921,angelessoletic,46,13,14,27,0.316442,0.536575,0.011203,"#3bec00"
254268566,LimaChely,15,3,1,4,0.458598,0.506829,0,"#ffa64e"
254421887,maite_martin,12,2,6,8,0.373439,0.5432,0.001948,"#ffb800"
254553602,xtianolive,1,16,0,16,0.61961,0.397399,0.005845,"#ff12a3"
254793053,libropesia,25,20,48,68,0.404662,0.493832,0.031174,"#ff0d69"
255001254,DSHjournal,0,6,0,6,0.411168,0.439307,0.000974,"#00e8b2"
255493070,LHistorica,39,38,9,47,0.56327,0.586662,0.020945,"#ffb800"
255681367,ianmilligan1,12,45,4,49,0.370944,0.456913,0.021919,"#ff77ff"
255704774,mtermens,48,0,5,5,0.524758,0.532648,0.000487,"#008ebb"
255952257,FICYT,48,4,2,6,0.385781,0.535226,0.000974,"#ff0d69"
255964870,DigitalCSIC,48,8,1,9,0.430778,0.541338,0.002435,"#008ebb"
256128069,UDGVirtual_SUV,0,6,1,7,0.367237,0.463518,0.001461,"#3e93ff"
256173249,ula_tv,50,7,0,7,0.70326,0.4443,0.001461,"#008bdd"
256218292,Juanfra_87,21,7,7,14,0.552117,0.742201,0.004871,"#ffa64e"
256226223,angelsimon_,48,9,0,9,0.354137,0.631307,0.002435,"#ffb800"
256265100,Gosha_Sans,0,0,4,4,0.351394,0.476032,0,"#3e93ff"
256366872,TOLTECATLn,26,1,5,6,0.097044,0.381397,0.000974,"#3e93ff"
256577185,xrubiocampillo,48,3,5,8,0.441854,0.602591,0.001948,"#008ebb"
256592553,kepasarasola,46,3,1,4,0.379663,0.514818,0,"#ffb800"
256919155,ireandce,1,3,2,5,0.343195,0.501771,0.000487,"#00e8b2"
257038975,casahumanidades,26,44,19,63,0.321018,0.345098,0.028738,"#3e93ff"
257440915,fejaruiz,17,16,0,16,0.355084,0.582661,0.005845,"#3bec00"
257496780,Rusatahi,46,0,16,16,0.458537,0.568108,0.005845,"#ffb800"
257722705,PrensaComunitar,0,3,2,5,0.332502,0.430361,0.000487,"#3e93ff"
258099723,Luciikelly,39,0,4,4,0.508096,0.195479,0,"#00e8b2"
258409062,FJavier_Sanchez,17,9,6,15,0.171134,0.598849,0.005358,"#ffb800"
258549760,Oximoronico,39,2,3,5,0.393552,0.183643,0.000487,"#00e8b2"
258711424,nohmeza,0,1,4,5,0.330775,0.475403,0.000487,"#3e93ff"
258831565,SIBI_UFRJ,39,3,2,5,0.411392,0.193486,0.000487,"#00e8b2"
258975653,constanzanecu,46,0,4,4,0.500349,0.61108,0,"#3bec00"
259126602,luscus9,46,5,0,5,0.424443,0.501063,0.000487,"#ffb800"
259174992,USALTV,28,5,1,6,0.376447,0.629427,0.000974,"#8ecfec"
259293263,anacarrillop,21,3,1,4,0.501079,0.66314,0,"#006032"
259301275,FrueheNeuzeit,49,0,4,4,0.2992,0.450616,0,"#3bec00"
259664201,Carmelucky,1,1,5,6,0.288347,0.595136,0.000974,"#825403"
260139276,naodamores,28,3,2,5,0.386845,0.553177,0.000487,"#8ecfec"
260163642,PFolgueira,42,3,3,6,0.441449,0.394629,0.000974,"#ffb800"
260275207,esTUlankide,35,7,1,8,0.68809,0.599077,0.001948,"#008ebb"
260320481,simoneve2401,28,0,6,6,0.390187,0.530429,0.000974,"#8ecfec"
260327003,condedemaldoror,0,0,11,11,0.384063,0.469965,0.00341,"#3e93ff"
260445777,sastreh,15,0,5,5,0.497592,0.583913,0.000487,"#006032"
260682807,FondationMSH,19,5,1,6,0.60689,0.670614,0.000974,"#5456a6"
260967332,martincaeiro,25,2,2,4,0.424368,0.509959,0,"#ff0d69"
261488974,allenpg,12,0,4,4,0.358175,0.424128,0,"#ff77ff"
261650023,AzaharaTIC,15,0,10,10,0.476561,0.516508,0.002923,"#006032"
261786006,Albertoxvenegas,28,41,6,47,0.571347,0.56415,0.020945,"#00ed5d"
261813008,jmlucia,46,32,2,34,0.42794,0.49059,0.014613,"#ffb800"
261821671,judithvaci,54,0,5,5,0.587874,0.652744,0.000487,"#c6cc85"
261979829,noelhv,54,0,5,5,0.598711,0.685285,0.000487,"#c6cc85"
262029585,UritRamirez,31,2,15,17,0.384281,0.432622,0.006332,"#3e93ff"
262279998,BelNuria,46,0,31,31,0.41104,0.501816,0.013151,"#ffb800"
262332862,DHQuarterly,0,26,0,26,0.388971,0.483822,0.010716,"#ffb800"
262437564,ciberprofesor,15,0,5,5,0.483815,0.463303,0.000487,"#ff0d69"
263044687,oeg_upm,48,33,14,47,0.46312,0.615342,0.020945,"#008ebb"
263144590,todopatrimonio,15,1,5,6,0.503084,0.524613,0.000974,"#006032"
263223468,javi_valls,15,8,4,12,0.540337,0.537851,0.003897,"#006032"
263275439,jserravi,14,0,10,10,0.586577,0.298846,0.002923,"#b6cb00"
263781815,EAguadoL,0,0,6,6,0.357103,0.335393,0.000974,"#3e93ff"
264435668,rmairal,46,29,25,54,0.415094,0.570756,0.024355,"#ffb800"
265456496,luizacdsantos,39,3,6,9,0.439721,0.350338,0.002435,"#00e8b2"
266117937,Quetzal_mdz,0,3,16,19,0.325915,0.447256,0.007306,"#3e93ff"
266132067,fciencias,26,10,2,12,0.403169,0.203775,0.003897,"#3e93ff"
266508103,fliebc,15,0,7,7,0.514687,0.517029,0.001461,"#006032"
266544890,UA_Universidad,48,4,0,4,0.327029,0.567158,0,"#ff0d69"
266555165,UA_Universitat,48,6,0,6,0.169924,0.57114,0.000974,"#ff0d69"
267110606,InstCervantes,22,8,4,12,0.366168,0.61047,0.003897,"#8ecfec"
267128233,meollar,22,26,31,57,0.40261,0.530452,0.025816,"#8ecfec"
267190904,PatriRibas,46,0,5,5,0.419776,0.554036,0.000487,"#ffb800"
267289786,drotorrent,15,11,16,27,0.429149,0.606333,0.011203,"#008ebb"
267620219,SIJI_CSIC,48,5,0,5,0.482716,0.65439,0.000487,"#008ebb"
267725747,euskoikaskuntza,43,5,0,5,0.209893,0.594556,0.000487,"#ffb800"
267749341,UBUEstudiantes,36,5,4,9,0.513394,0.43059,0.002435,"#00e8b2"
267988806,virbrussa,46,41,30,71,0.37256,0.538457,0.032635,"#3bec00"
268192461,kingsdh,22,19,4,23,0.428275,0.481978,0.009255,"#ff0d69"
268441633,EstelaMarGar,21,4,2,6,0.546309,0.640591,0.000974,"#006032"
269483046,felixramartinez,19,0,9,9,0.413426,0.419772,0.002435,"#3e93ff"
269684186,esnogales,48,20,5,25,0.467866,0.542698,0.010229,"#ffb800"
270278439,elenaescocia,1,0,5,5,0.335524,0.577652,0.000487,"#825403"
270883549,UOCmadrid,15,2,4,6,0.479012,0.536909,0.000974,"#ff0d69"
271607930,AsoColHistoria,36,11,7,18,0.438981,0.421898,0.006819,"#00e8b2"
272036295,FccUab,0,4,0,4,0.427674,0.466223,0,"#ff0d69"
272060268,akakicrea,15,2,2,4,0.407131,0.514084,0,"#ff0d69"
272083590,VIAJAoMUERE,0,0,4,4,0.311816,0.363132,0,"#3e93ff"
272280643,MiriamPP,0,137,50,187,0.382207,0.455458,0.089138,"#3e93ff"
272372967,A1exBam,15,0,5,5,0.490619,0.48995,0.000487,"#006032"
272430851,elicomelles,46,1,6,7,0.404355,0.513938,0.001461,"#ffb800"
272724733,nestorlopezv,19,0,7,7,0.42534,0.496781,0.001461,"#00ed5d"
273079116,carlosinnmortal,28,0,8,8,0.405641,0.549613,0.001948,"#8ecfec"
273910434,ACUPcatalunya,14,9,2,11,0.520529,0.35317,0.00341,"#b6cb00"
274150133,labernardina,0,1,7,8,0.322826,0.396592,0.001948,"#3e93ff"
274592041,AndresPerruca,1,5,17,22,0.327708,0.540181,0.008768,"#825403"
274909232,aaconocimiento,22,8,1,9,0.365008,0.509168,0.002435,"#8ecfec"
274977720,JMROMANGARCIA,15,0,10,10,0.897371,0.73089,0.002923,"#006032"
275070598,UExternado,25,7,2,9,0.47836,0.707872,0.002435,"#ff0d69"
275092678,llopezocon,48,45,33,78,0.469861,0.55865,0.036045,"#008ebb"
275097363,UAHes,21,18,1,19,0.536115,0.433678,0.007306,"#ffa64e"
275248862,J__Ele,46,1,3,4,0.13548,0.553642,0,"#3bec00"
275583016,UDC_gal,0,36,5,41,0.440921,0.507313,0.018022,"#ff0d69"
275729315,alxprince,17,1,5,6,0.356824,0.638855,0.000974,"#3bec00"
275978734,biblionthekes,15,1,3,4,0.516441,0.614175,0,"#ff0d69"
276091520,tecmexico,17,5,0,5,0.349872,0.5695,0.000487,"#3bec00"
276117873,MartaSaus,0,1,9,10,0.41364,0.512112,0.002923,"#ff0d69"
277194894,LasTop100,46,3,3,6,0.39565,0.602852,0.000974,"#ffb800"
277547285,FILU_UV,0,4,6,10,0.317649,0.422316,0.002923,"#3e93ff"
277559821,albertinsfran,46,5,12,17,0.380783,0.537021,0.006332,"#3bec00"
278286014,librosunam,26,19,3,22,0.279458,0.349892,0.008768,"#3e93ff"
278364137,DIE_CINVESTAV,0,7,4,11,0.367552,0.474216,0.00341,"#3e93ff"
278482863,sepln,46,6,2,8,0.388758,0.512532,0.001948,"#ffb800"
278506592,MSCActions,39,4,0,4,0.400209,0.406592,0,"#00e8b2"
278538741,practicarte,15,1,6,7,0.398544,0.555526,0.001461,"#ff0d69"
278577296,mercedes_p_g,27,0,4,4,0.941417,0.189052,0,"#00ed5d"
278713500,MiguelUTP,46,1,26,27,0.381806,0.520281,0.011203,"#3bec00"
279160382,IIEc_UNAM,0,4,2,6,0.248826,0.209232,0.000974,"#3e93ff"
279295559,csagol,46,2,20,22,0.338989,0.538606,0.008768,"#3bec00"
279437739,anomru,22,7,4,11,0.246935,0.73979,0.00341,"#8ecfec"
280172465,WatcherBlog,15,3,4,7,0.71268,0.495516,0.001461,"#ff0d69"
280453134,anapanouoc,0,1,35,36,0.393003,0.515397,0.015587,"#3e93ff"
280495800,DelegaHCD,21,8,0,8,0.593176,0.795281,0.001948,"#ffa64e"
280561320,EASPsalud,48,14,1,15,0.301081,0.203681,0.005358,"#ff0d69"
280596656,ricardomontesg,0,0,4,4,0.395505,0.454171,0,"#3e93ff"
281606938,museocolonial,19,7,1,8,0.309179,0.452907,0.001948,"#00ed5d"
281629616,MIStaClara,19,8,2,10,0.245755,0.505494,0.002923,"#00ed5d"
281673591,elcolmich,0,5,0,5,0.34384,0.454377,0.000487,"#3e93ff"
281712996,nataliaeliro,50,0,5,5,0.647311,0.448955,0.000487,"#008bdd"
281832082,EMGrumbach,12,0,8,8,0.298872,0.425895,0.001948,"#ff77ff"
282026933,lurixea,22,0,8,8,0.424731,0.492877,0.001948,"#ff0d69"
282187886,martinvi2011,1,2,2,4,0.374264,0.587886,0,"#825403"
282391338,ariadna_acevedo,0,1,4,5,0.376667,0.510911,0.000487,"#3e93ff"
282668740,guadanc,46,2,5,7,0.433715,0.553694,0.001461,"#ffb800"
283555892,Dolors_guillen,48,3,1,4,0.677556,0.50282,0,"#8ecfec"
283577845,AbelFdz_CDMX,26,0,4,4,0.378793,0.491277,0,"#3e93ff"
283841656,gustavolsj,0,4,25,29,0.39098,0.429532,0.012177,"#3e93ff"
284053968,AntoniGarrell,14,41,110,151,0.569682,0.267225,0.071603,"#b6cb00"
284285718,ibpad,39,18,5,23,0.410157,0.348237,0.009255,"#00e8b2"
284479026,JornadasCONTD,17,5,0,5,0.405693,0.740617,0.000487,"#3bec00"
284642077,lluisanglada,48,28,17,45,0.478726,0.593191,0.019971,"#008ebb"
284734969,tatatrapita,19,78,73,151,0.413337,0.44448,0.071603,"#3e93ff"
284824460,davidchavarria_,12,0,17,17,0.380882,0.435718,0.006332,"#ff77ff"
284898293,lacajaderratas,0,1,4,5,0.306028,0.41864,0.000487,"#3e93ff"
285224733,JaredCarballo_,48,5,5,10,0.474478,0.694828,0.002923,"#008ebb"
285228314,Amauri_Lpz,35,6,5,11,0.294361,0.467823,0.00341,"#c42c63"
286102281,msaezfern,46,2,3,5,0.197456,0.520115,0.000487,"#ffb800"
286346766,RomulaizerPardo,46,2,2,4,0.3123,0.521824,0,"#3bec00"
286912807,AlejandroOtaola,5,0,4,4,0.35205,0.312993,0,"#ff9b8f"
287232930,omiromarti,0,0,4,4,0.381268,0.492539,0,"#3e93ff"
287285569,MiguelDlaCamara,15,0,5,5,0.533107,0.554624,0.000487,"#006032"
287659745,teknokultura,1,130,3,133,0.371149,0.443261,0.062835,"#825403"
287788048,ALFREDOFDEZ_C,35,1,3,4,0.238509,0.401201,0,"#c42c63"
289601740,DeGruyterOA,48,10,1,11,0.430271,0.561783,0.00341,"#008ebb"
289834442,mjguerrapalmero,48,1,11,12,0.681439,0.493028,0.003897,"#006032"
289978575,MoyaRiu,1,0,8,8,0.317721,0.556508,0.001948,"#825403"
290789353,cefeza55,0,0,4,4,0.331772,0.385923,0,"#3e93ff"
291387096,Marco_Cerdio,0,0,6,6,0.515535,0.482547,0.000974,"#3e93ff"
291652922,Patry_nf,39,0,4,4,0.43343,0.618651,0,"#ffb800"
291681176,AdhilacInfo,19,0,5,5,0.256237,0.356112,0.000487,"#00ed5d"
292178008,rojas_dan,0,0,5,5,0.388264,0.48017,0.000487,"#3e93ff"
293339594,KrisSummer1,0,0,6,6,0.387675,0.467552,0.000974,"#3e93ff"
293419650,bbaamalaga,15,5,0,5,0.431071,0.499328,0.000487,"#ff0d69"
293587457,Diana_Joa,36,0,8,8,0.439585,0.426655,0.001948,"#00e8b2"
294059282,carlosghh,1,8,10,18,0.426147,0.527769,0.006819,"#ff12a3"
294101019,ana_valdi,15,7,3,10,0.553339,0.537912,0.002923,"#006032"
294107159,Mar__Carrillo,46,4,0,4,0.284422,0.519318,0,"#3bec00"
294323086,alfredosabbagh,17,1,3,4,0.404857,0.715617,0,"#3bec00"
294731021,GrinUGR,15,53,11,64,0.482829,0.525675,0.029226,"#006032"
295556841,uam_estudiantes,49,4,2,6,0.500852,0.424879,0.000974,"#ffa64e"
296121328,ateneo_riojano,46,2,2,4,0.432944,0.64419,0,"#8ecfec"
296486159,observatorioedu,46,6,0,6,0.350908,0.549562,0.000974,"#ffb800"
296950170,jexlopez,48,3,12,15,0.479451,0.589636,0.005358,"#008ebb"
296967530,manuamezcua,15,12,4,16,0.578452,0.522613,0.005845,"#006032"
297286051,iila_org,39,4,0,4,0.350893,0.346144,0,"#00e8b2"
297336996,mari38jo,48,13,4,17,0.1209,0.56673,0.006332,"#008ebb"
297862021,GretaFranzini,0,0,15,15,0.398491,0.481272,0.005358,"#ffb800"
298641701,almu_hs,15,0,9,9,0.441473,0.556564,0.002435,"#ff0d69"
298758353,LourdesFeria,26,3,2,5,0.319421,0.459246,0.000487,"#3bec00"
299309800,pablogarguez,46,1,4,5,0.468068,0.62565,0.000487,"#ffb800"
299924386,4Hum,0,5,0,5,0.427031,0.486078,0.000487,"#ff0d69"
300276871,SolUgarteF,46,0,4,4,0.414688,0.596091,0,"#ffb800"
300407444,ORMurcia,28,7,0,7,0.515011,0.65975,0.001461,"#008ebb"
300486929,semevadlalengua,49,19,5,24,0.465445,0.570631,0.009742,"#ffa64e"
300890894,MLAnews,12,9,0,9,0.340755,0.415913,0.002435,"#ff77ff"
301010345,JosepLlados,48,5,2,7,0.469576,0.581804,0.001461,"#ff0d69"
301302495,masanti75,1,1,11,12,0.455096,0.53414,0.003897,"#ff12a3"
301539386,rodri_verano,48,3,1,4,0.696323,0.226759,0,"#008ebb"
301934830,ArmelaDi,46,0,5,5,0.436123,0.554264,0.000487,"#ffb800"
301945604,ACEcultura,1,25,6,31,0.447295,0.594807,0.013151,"#008ebb"
301987019,UBUinvestiga,36,5,2,7,0.561003,0.359935,0.001461,"#00e8b2"
302214601,MJesusRosado,48,7,3,10,0.34648,0.511822,0.002923,"#008ebb"
302228892,BibUtopia,46,11,12,23,0.334195,0.516292,0.009255,"#3bec00"
302240813,CarmenTenor,15,4,0,4,0.481715,0.518566,0,"#ff0d69"
302626348,LauraMorRom,49,0,4,4,0.419659,0.529417,0,"#ffa64e"
302841600,ISRIV,39,0,6,6,0.350563,0.527246,0.000974,"#fcae7e"
302936026,jalonsoregalado,19,0,6,6,0.368331,0.4474,0.000974,"#ff77ff"
303357513,jl_hoyas,15,0,4,4,0.509482,0.527956,0,"#006032"
303476998,tomascarralero,49,0,4,4,0.425522,0.540471,0,"#ff0d69"
303480108,escartxa,25,6,10,16,0.376408,0.546711,0.005845,"#8ecfec"
303635928,txtdgtl,0,8,21,29,0.41474,0.453918,0.012177,"#3e93ff"
303772119,IHRDigHist,12,1,3,4,0.404805,0.393262,0,"#ff77ff"
303949762,92Estrella,15,0,16,16,0.442417,0.52506,0.005845,"#006032"
303980445,educarportal,17,22,0,22,0.402094,0.747706,0.008768,"#3bec00"
304316780,CSICdivulga,48,8,6,14,0.454206,0.558694,0.004871,"#008ebb"
304328950,alejandravf2705,19,2,6,8,0.348024,0.310764,0.001948,"#00ed5d"
304338078,UABBarcelona,48,31,3,34,0.458206,0.521579,0.014613,"#ff0d69"
304342684,AmparoRubiales,22,13,1,14,0.628147,0.532205,0.004871,"#8ecfec"
305191432,lila_pinto,17,18,3,21,0.38182,0.546187,0.008281,"#3bec00"
305920342,LuaracdP,48,11,3,14,0.353358,0.569372,0.004871,"#ffb800"
306397976,ypr_67,37,0,4,4,0.456859,0.535765,0,"#fcae7e"
308487814,CVC_UAB,48,19,20,39,0.480546,0.56992,0.017048,"#ff0d69"
309319376,humanizart,48,0,6,6,0.426196,0.549839,0.000974,"#008ebb"
309549844,MeryCed,46,1,3,4,0.461881,0.611467,0,"#ffb800"
309572468,cued_,17,1,4,5,0.47912,0.541344,0.000487,"#008ebb"
309592277,JULMARZ,19,0,5,5,0.410793,0.476001,0.000487,"#00ed5d"
309813559,CaperucitaenM,15,0,11,11,0.404807,0.527628,0.00341,"#006032"
309879326,Delmartrad,46,4,2,6,0.449247,0.495337,0.000974,"#ffb800"
310143531,sadurnimarti,39,7,2,9,0.328248,0.468812,0.002435,"#00e8b2"
310156720,ariel_brito,46,30,35,65,0.437623,0.578865,0.029713,"#ffb800"
310221094,uramonllull,14,2,3,5,0.615941,0.285304,0.000487,"#b6cb00"
310639809,cerosetenta,19,6,3,9,0.418211,0.483846,0.002435,"#00ed5d"
311640613,man_cebral,0,33,23,56,0.336345,0.50346,0.025329,"#3e93ff"
311706618,mlazaroto,46,0,5,5,0.42674,0.726908,0.000487,"#ffb800"
311961582,cursosveranouc,48,3,3,6,0.484472,0.674308,0.000974,"#008ebb"
311970047,SEDLL,15,12,2,14,0.386481,0.662487,0.004871,"#006032"
311976920,AncientRomeLive,48,0,4,4,0.574324,0.52905,0,"#ff12a3"
311979693,astro_duque,46,8,0,8,0.460293,0.536617,0.001948,"#ffb800"
312005020,JortTo,12,0,12,12,0.44009,0.466851,0.003897,"#ff77ff"
313139818,OFPIUGR,15,0,4,4,0.53744,0.542526,0,"#006032"
313293865,gerarmontoya,39,1,3,4,0.633104,0.305886,0,"#00e8b2"
313297821,EdiComplutense,25,3,2,5,0.371266,0.530675,0.000487,"#ff0d69"
313550113,ralcarazm,48,6,9,15,0.475892,0.604147,0.005358,"#008ebb"
313743463,MGC_UC3M,21,11,11,22,0.48258,0.560848,0.008768,"#006032"
314520124,UexBiblioteca,46,8,6,14,0.381481,0.554817,0.004871,"#ff0d69"
314542612,CursosVeranoUCM,39,6,0,6,0.448277,0.520121,0.000974,"#00e8b2"
314687897,unsamoficial,36,13,3,16,0.154337,0.497862,0.005845,"#403538"
315146860,paco_segado,46,3,1,4,0.462157,0.574539,0,"#008ebb"
315215597,La_coronica,39,0,6,6,0.373956,0.55777,0.000974,"#fcae7e"
315454130,jm_zaragoza,21,0,10,10,0.510718,0.387016,0.002923,"#ffa64e"
315705688,geacron,48,0,5,5,0.490779,0.574887,0.000487,"#008ebb"
316362380,Usurpado56,21,0,4,4,0.589543,0.791731,0,"#ffa64e"
316554695,lolalortega,0,3,53,56,0.374941,0.465865,0.025329,"#3e93ff"
317003388,merilotta,22,0,7,7,0.426868,0.497732,0.001461,"#8ecfec"
317328512,f_ranciscolopes,0,0,11,11,0.357484,0.466235,0.00341,"#ffb800"
317388105,aIejandro_esva,0,0,5,5,0.357165,0.416013,0.000487,"#3e93ff"
317429351,DHInstitute,0,8,5,13,0.374852,0.404056,0.004384,"#00e8b2"
317555895,alzilei,0,11,4,15,0.383095,0.442381,0.005358,"#3e93ff"
317897447,vegawinslet,28,2,10,12,0.408825,0.532094,0.003897,"#8ecfec"
318464687,FurryLibrarian,48,7,44,51,0.458126,0.565226,0.022893,"#ffb800"
318562341,fmamanif,0,2,11,13,0.432601,0.469263,0.004384,"#ff0d69"
319104328,anamancera,22,6,0,6,0.371005,0.610062,0.000974,"#8ecfec"
319210602,ledismo,14,2,6,8,0.472669,0.393995,0.001948,"#3e93ff"
319749788,orbis_imagines,15,0,6,6,0.493491,0.481697,0.000974,"#ff0d69"
321296493,unipv,46,2,2,4,0.376188,0.57998,0,"#ffb800"
321449115,MauToscano,15,15,14,29,0.446579,0.518543,0.012177,"#006032"
322016721,ArquivoBrasil,39,37,6,43,0.449646,0.319398,0.018997,"#00e8b2"
322172045,CONICETDialoga,0,20,0,20,0.336066,0.509324,0.007793,"#3e93ff"
323267630,SilvieTarazona,25,6,2,8,0.372566,0.480734,0.001948,"#ff0d69"
323306871,fundacomunes,15,6,0,6,0.48221,0.405414,0.000974,"#006032"
323892543,JohnBrockman,17,6,0,6,0.330326,0.567223,0.000974,"#3bec00"
324043767,Biblioteca_UNCo,46,1,3,4,0.285198,0.533451,0,"#3bec00"
324855683,beisadlt,15,0,6,6,0.465964,0.546178,0.000974,"#ff0d69"
324870812,albabgar,46,3,3,6,0.369937,0.544,0.000974,"#ff0d69"
325623276,ICYT_UC3M,21,19,22,41,0.493262,0.587327,0.018022,"#006032"
326065259,CienciatkCSIC,48,0,5,5,0.479849,0.556198,0.000487,"#008ebb"
326219748,mySTILUS,49,2,3,5,0.455153,0.49905,0.000487,"#ffa64e"
326362906,RbkMej,0,0,4,4,0.38047,0.389792,0,"#3e93ff"
326736898,TheaPitman,12,0,15,15,0.383652,0.450007,0.005358,"#ff77ff"
326927622,PTomeM,48,0,15,15,0.414669,0.551513,0.005358,"#008ebb"
327040680,elenab_flores,46,1,7,8,0.405006,0.558281,0.001948,"#ffb800"
327166139,historiapesante,12,0,5,5,0.388941,0.417982,0.000487,"#ff77ff"
328659624,javessur,21,6,13,19,0.452295,0.529398,0.007306,"#8ecfec"
329246702,dhgermany,46,1,4,5,0.392002,0.471415,0.000487,"#ffb800"
329566868,BamadGalicia,21,4,0,4,0.609928,0.618827,0,"#ff0d69"
329712294,lilicastillo17,46,0,4,4,0.28511,0.483581,0,"#3bec00"
329844724,InstDeFilosofia,0,0,19,19,0.365012,0.463801,0.007306,"#3e93ff"
329876465,aaaArchiveros,21,4,3,7,0.483704,0.580353,0.001461,"#ffa64e"
329946948,innovatics_,46,7,0,7,0.32366,0.497148,0.001461,"#ffb800"
330264995,TizMancinelli,0,1,11,12,0.346154,0.467593,0.003897,"#3e93ff"
331059057,ArquivoRS,39,12,1,13,0.463817,0.279624,0.004384,"#00e8b2"
331064775,Red_HD,0,1005,307,1312,0.380939,0.455162,0.637116,"#3e93ff"
331195870,RicardoMPimenta,39,105,100,205,0.396064,0.435217,0.097905,"#00e8b2"
331701540,amasamune54,21,0,4,4,0.480235,0.714116,0,"#ffa64e"
331841381,SandraFerrerV,21,9,0,9,0.555075,0.76257,0.002435,"#ffa64e"
333375166,EmbaMexBra,26,1,3,4,0.36506,0.453875,0,"#3e93ff"
333977447,Mapy_Biblioteca,37,0,4,4,0.461721,0.584066,0,"#ffb800"
334283834,tuerkka,46,4,1,5,0.370941,0.534472,0.000487,"#3bec00"
334283874,martaep_mep,49,0,10,10,0.436821,0.534986,0.002923,"#8ecfec"
334589577,INTECCAUNED,46,2,2,4,0.442452,0.593982,0,"#ffb800"
334930037,ninadhora,39,10,1,11,0.36523,0.250617,0.00341,"#00e8b2"
335213654,sergio_isalu,37,0,7,7,0.488109,0.59472,0.001461,"#fcae7e"
335496078,GabrielTorresEs,17,0,6,6,0.437813,0.737349,0.000974,"#3bec00"
335917254,ConchiGonzalezD,1,0,6,6,0.536356,0.516615,0.000974,"#ff12a3"
336026818,hannusalmi,0,7,1,8,0.355404,0.425619,0.001948,"#3e93ff"
336321643,daiane_rossi,39,17,5,22,0.285516,0.379763,0.008768,"#00e8b2"
337679391,iriscara,54,0,5,5,0.607003,0.687736,0.000487,"#c6cc85"
337715207,Makova_,15,0,6,6,0.520924,0.528579,0.000974,"#006032"
338045293,martinez_xavi,27,0,4,4,0.907081,0.178441,0,"#00ed5d"
338315801,allhoff_joachim,39,2,7,9,0.309846,0.334449,0.002435,"#00e8b2"
339826785,derrumbe2,0,16,60,76,0.359743,0.470317,0.035071,"#3e93ff"
342455529,Demibol,12,0,12,12,0.428935,0.395759,0.003897,"#ff77ff"
342637843,J_MartinezRubio,36,11,1,12,0.570637,0.558307,0.003897,"#00e8b2"
342890405,dansar39,46,1,4,5,0.309406,0.552609,0.000487,"#3bec00"
343761999,the_real_OmarPB,12,0,4,4,0.40626,0.386493,0,"#ff77ff"
344428078,unfernandezmas,17,2,3,5,0.408849,0.595148,0.000487,"#3bec00"
345310708,tillgrallert,0,2,2,4,0.413612,0.440612,0,"#3e93ff"
346130719,AulaCIH,0,4,13,17,0.440375,0.539995,0.006332,"#008ebb"
347221031,EspidoFreire,25,16,5,21,0.335526,0.543748,0.008281,"#ff0d69"
347390540,Jilirio,27,0,4,4,0.925575,0.177485,0,"#00ed5d"
348593773,dalrmx,19,7,1,8,0.462679,0.349088,0.001948,"#ff0d69"
348708526,segalvez1,21,2,14,16,0.537221,0.762046,0.005845,"#ffa64e"
348740352,JuditdeDiego,37,22,16,38,0.416075,0.59144,0.016561,"#fcae7e"
348773946,_missamnesia,0,3,2,5,0.29929,0.342,0.000487,"#3e93ff"
349020396,Starchildsp,15,0,4,4,0.539334,0.51973,0,"#006032"
349815360,CarlosAburto71,0,2,3,5,0.365373,0.532379,0.000487,"#3e93ff"
350411337,RAEinforma,37,32,1,33,0.450142,0.679675,0.014126,"#fcae7e"
351566384,raymerichp,14,1,23,24,0.574165,0.306198,0.009742,"#b6cb00"
351699614,BNE_biblioteca,48,315,22,337,0.475962,0.601193,0.162202,"#ffb800"
351736562,cocoaranda90,0,1,3,4,0.453562,0.50408,0,"#ff0d69"
352053266,coursera,48,29,0,29,0.50908,0.512389,0.012177,"#ff0d69"
352132920,BNE_directora,48,29,7,36,0.475484,0.584646,0.015587,"#ffb800"
352525947,CarlesLindin,0,5,81,86,0.39401,0.485769,0.039942,"#3e93ff"
353056732,SerranaDS,54,0,4,4,0.622673,0.661542,0,"#c6cc85"
353332107,irenelasen,0,0,4,4,0.311024,0.496656,0,"#3e93ff"
354475622,aalvarezgallo,12,5,5,10,0.463889,0.424485,0.002923,"#ff77ff"
354544500,dhdebates,12,7,0,7,0.368719,0.442246,0.001461,"#ff77ff"
354914156,Wikimania2015,0,14,6,20,0.378182,0.444354,0.007793,"#3e93ff"
355642935,flopes_patri,46,5,19,24,0.408887,0.471537,0.009742,"#ff0d69"
355783841,crosscecilia,46,0,8,8,0.354998,0.538839,0.001948,"#3bec00"
356986327,ma_collado,37,9,2,11,0.491955,0.646504,0.00341,"#fcae7e"
357776399,Fatimunflis,46,0,8,8,0.435795,0.571065,0.001948,"#ffb800"
357868059,IsraelTrejoM,0,3,4,7,0.424578,0.387494,0.001461,"#3e93ff"
358181063,LuOulton,54,0,4,4,0.479865,0.481971,0,"#c6cc85"
358236690,CAEH_7,0,2,7,9,0.322704,0.496993,0.002435,"#3e93ff"
359637250,_ideashop,17,0,5,5,0.375118,0.625952,0.000487,"#3bec00"
360068680,huellasdelotro,49,1,3,4,0.480351,0.362517,0,"#3bec00"
360147131,vanjerono,19,4,0,4,0.2707,0.261218,0,"#3e93ff"
360874005,MinCulturaPe,15,6,0,6,0.474327,0.472719,0.000974,"#006032"
361193969,ACBJ_OK,46,8,6,14,0.343687,0.613256,0.004871,"#3bec00"
361536173,periodistagodoy,46,0,4,4,0.374425,0.53568,0,"#3bec00"
361897752,bibliotecaippur,39,4,7,11,0.414004,0.328888,0.00341,"#00e8b2"
362308860,anateresamr,0,2,16,18,0.373274,0.452374,0.006819,"#3e93ff"
362586529,Enclmdiario,37,12,3,15,0.481799,0.579007,0.005358,"#fcae7e"
363965303,GenilsonGeraldo,39,3,1,4,0.396145,0.379037,0,"#00e8b2"
365008415,acnzbell,0,0,6,6,0.387438,0.41348,0.000974,"#3e93ff"
365551675,cavalenzu,19,0,4,4,0.451424,0.529782,0,"#00ed5d"
365981778,UNED_Ponferrada,21,3,2,5,0.434954,0.680433,0.000487,"#ffa64e"
365996576,uc3mFacultadHCD,21,9,10,19,0.530053,0.65355,0.007306,"#ffa64e"
366536590,JorgedeTorres,49,0,5,5,0.423068,0.549685,0.000487,"#ff0d69"
366605732,bonetbea,21,1,5,6,0.530972,0.615624,0.000974,"#006032"
366661199,poblacion_csic,48,10,1,11,0.511554,0.360167,0.00341,"#ff0d69"
368199660,museuexili,15,1,3,4,0.534694,0.579642,0,"#006032"
368330887,ariruigo,48,8,2,10,0.459942,0.580731,0.002923,"#ffb800"
368367932,iandradega,21,5,8,13,0.498767,0.499677,0.004384,"#ffa64e"
368476077,LuisMartinLP,46,0,4,4,0.491324,0.592069,0,"#ffb800"
368927453,SdLUAB,0,4,0,4,0.425545,0.471359,0,"#ff0d69"
369000620,CristinaBorraj1,46,0,76,76,0.347416,0.563206,0.035071,"#3bec00"
369207326,EsRubenValle,46,6,0,6,0.305519,0.571487,0.000974,"#3bec00"
369346119,REA_rolde,25,3,2,5,0.242814,0.576224,0.000487,"#ff0d69"
369529173,ProfessMoravec,12,0,8,8,0.387684,0.494029,0.001948,"#ff77ff"
369689042,GrandjeanMartin,0,0,8,8,0.342238,0.469085,0.001948,"#ffb800"
369719204,NocionesComunes,15,6,0,6,0.484616,0.40138,0.000974,"#006032"
370072897,elmarcapaginas,1,8,3,11,0.3779,0.536325,0.00341,"#825403"
370765467,COMECSO,26,0,5,5,0.32462,0.326818,0.000487,"#3e93ff"
371399287,MelbaLCardenasB,19,4,3,7,0.365369,0.342247,0.001461,"#00ed5d"
371478431,cvilaz,21,0,4,4,0.414392,0.510026,0,"#006032"
371668722,BernatRuiz,48,4,4,8,0.503366,0.566194,0.001948,"#008ebb"
371732429,austrohungaro_,0,3,3,6,0.410054,0.497211,0.000974,"#3e93ff"
371863903,tlvictoria,46,2,4,6,0.352359,0.599245,0.000974,"#3bec00"
372384990,alebalestra59,46,0,4,4,0.304242,0.533339,0,"#3bec00"
372622120,jimenapc02,50,20,6,26,0.623675,0.414949,0.010716,"#008bdd"
372778265,BegonaPedrosa,35,1,3,4,0.614798,0.586225,0,"#008ebb"
372963607,BibliotecaJdeC,35,10,0,10,0.32114,0.486062,0.002923,"#c42c63"
373104489,ElvizRojas,19,6,4,10,0.346611,0.414559,0.002923,"#00ed5d"
373108431,LuisinaSilvaB,21,9,7,16,0.536662,0.380545,0.005845,"#ffa64e"
373311030,amparocozar,15,1,3,4,0.367058,0.63635,0,"#006032"
373539942,LatamUF,42,9,3,12,0.331586,0.212803,0.003897,"#005076"
373820283,Andrey4Mir,0,0,5,5,0.335654,0.494284,0.000487,"#ffb800"
374395365,dialnet,46,16,0,16,0.402028,0.548454,0.005845,"#3bec00"
374433827,ragerri,12,0,5,5,0.360841,0.496765,0.000487,"#ff77ff"
374630821,aroa2R,46,10,7,17,0.431113,0.508206,0.006332,"#ffb800"
374819960,fariastuitea,21,10,0,10,0.660608,0.350526,0.002923,"#ffa64e"
376277910,cmartalazo,15,2,6,8,0.42324,0.656968,0.001948,"#008ebb"
376660115,JosCarlosMorill,46,0,4,4,0.341646,0.582177,0,"#3bec00"
376750874,sedici,46,4,0,4,0.378024,0.552181,0,"#ffb800"
376810851,abogadoknowmads,15,0,8,8,0.565294,0.524812,0.001948,"#006032"
376879980,Mayterius,14,5,0,5,0.584836,0.326355,0.000487,"#b6cb00"
377033028,silviasarri,14,0,12,12,0.588233,0.287589,0.003897,"#b6cb00"
377238242,URJCcientifica,25,2,2,4,0.606023,0.605445,0,"#8ecfec"
377253521,BComplutense,39,1,4,5,0.435677,0.54289,0.000487,"#00e8b2"
377464987,HumanidadesUNAM,0,8,4,12,0.27558,0.268431,0.003897,"#3e93ff"
377609214,amolanor,19,7,8,15,0.581514,0.415622,0.005358,"#00ed5d"
377975776,hombreencamino,22,6,1,7,0.357881,0.602413,0.001461,"#8ecfec"
378033688,DeLetras_UCLM,37,5,2,7,0.418069,0.603726,0.001461,"#fcae7e"
378076547,TAMU_CoDHR,0,5,0,5,0.382104,0.425933,0.000487,"#3e93ff"
378492909,MariaPovedaV,48,8,11,19,0.457895,0.617715,0.007306,"#008ebb"
379753067,Eugefer_3,46,0,7,7,0.379101,0.576347,0.001461,"#3bec00"
379838669,lortizdezarate,21,1,3,4,0.612634,0.517863,0,"#ffa64e"
381070776,DavidBordonaba,46,5,6,11,0.363262,0.550616,0.00341,"#ffb800"
381276177,alial65,46,0,4,4,0.438016,0.549633,0,"#ffb800"
381416383,ACousillas,15,0,5,5,0.527483,0.540445,0.000487,"#ff0d69"
381631792,mujeresdel36,21,7,0,7,0.569649,0.762926,0.001461,"#ffa64e"
381743098,MargyMacLibrary,12,0,4,4,0.229715,0.43142,0,"#ff77ff"
382102378,bender_k,15,2,2,4,0.459773,0.458019,0,"#ff0d69"
382169591,marxismocritico,21,2,4,6,0.463283,0.721904,0.000974,"#ffa64e"
382704865,SPabloCalleja,48,0,7,7,0.479484,0.607011,0.001461,"#008ebb"
382969925,californiaedit,19,0,7,7,0.447357,0.453002,0.001461,"#ffb800"
383419347,mafornaciari,39,13,2,15,0.3391,0.37601,0.005358,"#00e8b2"
384201056,jgalgarra,46,2,5,7,0.407781,0.545874,0.001461,"#ffb800"
384212402,scqlab,46,3,4,7,0.329097,0.584794,0.001461,"#3bec00"
384550829,BibliotecaCEPAL,46,32,18,50,0.323409,0.474463,0.022406,"#3bec00"
384685845,LibreriaBonilla,0,16,0,16,0.365922,0.393567,0.005845,"#3e93ff"
384801683,BibliotecaUCLM,37,4,3,7,0.484231,0.595037,0.001461,"#fcae7e"
384899514,MarcelaTintilay,46,0,6,6,0.340618,0.486324,0.000974,"#3bec00"
384907052,Letyludigital,0,1,16,17,0.408877,0.456605,0.006332,"#3e93ff"
385235642,Lcruz_Foto,5,0,4,4,0.349325,0.316298,0,"#ff9b8f"
385323397,divulgaUNED,46,4,1,5,0.409618,0.588864,0.000487,"#ffb800"
385508199,jcknen,48,7,0,7,0.491631,0.608927,0.001461,"#008ebb"
385843469,UVa_es,46,32,0,32,0.421078,0.526727,0.013639,"#ffb800"
385931079,LaNauuv,15,11,1,12,0.475727,0.526144,0.003897,"#006032"
385995441,_IsabellaPaez_,0,0,8,8,0.393384,0.440015,0.001948,"#3e93ff"
386072880,librosjesus,19,0,6,6,0.479905,0.45232,0.000974,"#00ed5d"
386178032,Univ_Cultura,8,16,0,16,0.686847,0.313842,0.005845,"#3e93ff"
386674334,ADUBAArgentina,50,8,0,8,0.382781,0.660497,0.001948,"#3bec00"
386782091,jennymarcela03,1,0,4,4,0.425239,0.480572,0,"#00ed5d"
387023321,tanww116,0,0,5,5,0.360127,0.490185,0.000487,"#ffb800"
387050639,marfilcarmona,15,7,4,11,0.56577,0.469536,0.00341,"#006032"
388416822,Conacyt_MX,8,34,0,34,0.500727,0.294253,0.014613,"#3e93ff"
388592826,JMPereira61,36,5,8,13,0.443948,0.372102,0.004384,"#6c241e"
388729560,costamrv,39,16,8,24,0.436041,0.356253,0.009742,"#00e8b2"
389620129,Ceper_Uniandes,12,19,5,24,0.519587,0.357811,0.009742,"#ff77ff"
390414987,schuyleresprit,0,5,0,5,0.334502,0.472334,0.000487,"#3e93ff"
390839814,jormtz_,0,0,9,9,0.357886,0.428174,0.002435,"#3e93ff"
391362936,myfirstSN,39,2,2,4,0.486639,0.415066,0,"#00e8b2"
391938634,MCarmenSuarezF,48,0,5,5,0.488557,0.609564,0.000487,"#008ebb"
392357015,emulenews,48,3,3,6,0.593383,0.44841,0.000974,"#008ebb"
392633867,cosnautas,15,10,2,12,0.443182,0.517135,0.003897,"#ff0d69"
393049821,alex_bia,15,12,1,13,0.400052,0.486794,0.004384,"#ff77ff"
393323296,diegogarcir,15,2,7,9,0.415192,0.472849,0.002435,"#ff0d69"
393691474,Toda_la_UNAM,26,17,1,18,0.348033,0.26707,0.006819,"#3e93ff"
394158423,coblezc,0,0,4,4,0.338872,0.424982,0,"#3e93ff"
394417360,comunica_ucsj,36,5,1,6,0.226826,0.355956,0.000974,"#00e8b2"
394912313,BaltaFM,1,7,4,11,0.395734,0.612699,0.00341,"#008ebb"
395174441,La_UPM,15,4,0,4,0.493572,0.654316,0,"#006032"
395398776,isapovea,12,17,15,32,0.390783,0.472307,0.013639,"#3e93ff"
396241313,Caracteres_net,46,25,2,27,0.438403,0.561168,0.011203,"#8ecfec"
396318659,afwiman,0,4,0,4,0.371654,0.527535,0,"#3e93ff"
396497313,FJavier_Galan,15,7,2,9,0.682024,0.680045,0.002435,"#006032"
397560793,cosovschi,39,3,2,5,0.37211,0.323259,0.000487,"#00e8b2"
398154994,AnastasioGracia,21,1,7,8,0.545449,0.774223,0.001948,"#ffa64e"
398660322,cilengua,37,4,2,6,0.40169,0.632255,0.000974,"#fcae7e"
398801685,pabloalfaroh,46,2,3,5,0.456324,0.569998,0.000487,"#ffb800"
398865642,DidacPujol,0,0,6,6,0.45429,0.450345,0.000974,"#ff0d69"
399038996,rafapyp,0,7,6,13,0.447198,0.439783,0.004384,"#3e93ff"
399682118,ladyhalcon2012,48,5,8,13,0.339308,0.672237,0.004384,"#008ebb"
399710646,Victor_Gayol,12,234,84,318,0.400029,0.436303,0.152947,"#ff77ff"
399944230,cris_aranda_,46,1,9,10,0.42174,0.606836,0.002923,"#ffb800"
400024012,luiseborek,46,0,6,6,0.331757,0.506623,0.000974,"#3bec00"
400075975,robles_paco,21,2,2,4,0.545205,0.789942,0,"#ffa64e"
400241522,DatosUBA,17,44,51,95,0.352957,0.57344,0.044325,"#3bec00"
400886482,Marcela_etc,54,0,14,14,0.538942,0.512043,0.004871,"#c6cc85"
401292100,MorFlog,46,12,19,31,0.437974,0.542971,0.013151,"#ffb800"
402625250,dta_cthomas,49,2,2,4,0.32708,0.453833,0,"#3bec00"
402857468,AliciaFornes,48,11,12,23,0.487671,0.54908,0.009255,"#ff0d69"
404442001,emckiernan13,0,12,0,12,0.369481,0.398126,0.003897,"#3e93ff"
404698626,feyts_uva,48,0,4,4,0.220457,0.573382,0,"#008ebb"
404931257,FyL_UGR,15,6,5,11,0.438849,0.539574,0.00341,"#006032"
406235608,Hitrania,25,5,6,11,0.405606,0.583754,0.00341,"#8ecfec"
406843902,Idea_Red,46,0,4,4,0.398128,0.603101,0,"#8ecfec"
407179956,Francatripa,25,1,11,12,0.395008,0.546449,0.003897,"#ff0d69"
407266971,LeticiaGandara,46,0,4,4,0.451539,0.591834,0,"#ffb800"
407308942,verdewek,49,83,25,108,0.432141,0.517332,0.050658,"#ff0d69"
407390406,Cristian_g106,46,1,11,12,0.293713,0.499539,0.003897,"#3bec00"
407530024,LilianaGGR,15,0,4,4,0.52573,0.493314,0,"#006032"
408226607,rayenchil,12,18,10,28,0.309295,0.430187,0.01169,"#ff77ff"
408569953,marilepretel,1,4,2,6,0.393677,0.572507,0.000974,"#ff12a3"
409481206,LAB1100,39,6,5,11,0.427553,0.367261,0.00341,"#00e8b2"
410226975,FAAEColombia,48,4,4,8,0.524132,0.397312,0.001948,"#ff0d69"
410383419,ictandlaw,0,0,4,4,0.346292,0.384663,0,"#3e93ff"
411419084,rahul05ranjan,39,0,10,10,0.336832,0.407909,0.002923,"#3bec00"
412465213,davalonso2000,46,3,8,11,0.410425,0.605647,0.00341,"#ffb800"
413381942,Balduqueando20,28,0,5,5,0.478659,0.431901,0.000487,"#ffb800"
413643466,MinatoGzenx,0,0,5,5,0.350633,0.451986,0.000487,"#3e93ff"
413851087,ajenjomata,48,2,3,5,0.585666,0.569244,0.000487,"#ffb800"
414496177,stefaniagallini,19,167,113,280,0.420383,0.422386,0.134437,"#00ed5d"
414794428,rosasebastia,46,44,58,102,0.383096,0.565026,0.047735,"#ffb800"
414879584,villalvazoM131,12,0,4,4,0.302758,0.433485,0,"#3e93ff"
417294495,oarcinie,12,0,4,4,0.364899,0.42192,0,"#3e93ff"
417793312,sordip,0,6,12,18,0.395786,0.466032,0.006819,"#3e93ff"
418011068,bchgUAB,48,4,6,10,0.457953,0.525204,0.002923,"#ff0d69"
418062794,mafab25,12,0,5,5,0.36132,0.419953,0.000487,"#ff77ff"
419006281,IISUNAM,26,3,1,4,0.263996,0.326643,0,"#3e93ff"
419164852,clboyles,10,1,8,9,0.327085,0.481004,0.002435,"#ffb800"
420553080,GuadarramaRico,35,5,9,14,0.213844,0.358702,0.004871,"#c42c63"
420639740,ProlopeUab,48,37,10,47,0.44995,0.54272,0.020945,"#ff0d69"
421722996,XavierMarcet,14,11,10,21,0.59211,0.293513,0.008281,"#b6cb00"
422579729,JTlatelpa,46,1,4,5,0.381756,0.623212,0.000487,"#3bec00"
422721396,PelagiosNetwork,46,18,4,22,0.354952,0.476264,0.008768,"#3bec00"
422942161,MCallejaPuerta,48,33,0,33,0.578133,0.598137,0.014126,"#008ebb"
424102262,inefmadrid,15,4,0,4,0.518516,0.589134,0,"#006032"
424122771,HerriBizia,12,7,0,7,0.224434,0.154316,0.001461,"#ff77ff"
425287584,Unidad_Igualdad,21,3,8,11,0.564258,0.701507,0.00341,"#ffa64e"
426784922,lirondos,0,33,12,45,0.434786,0.522994,0.019971,"#ff0d69"
426968963,RobertoGomezIgl,15,2,7,9,0.587072,0.567167,0.002435,"#006032"
427118392,areckmann,10,0,4,4,0.241261,0.445646,0,"#3bec00"
427323266,glamwiki,0,1,3,4,0.341233,0.473106,0,"#3e93ff"
427811541,makingpolicy,48,2,2,4,0.298604,0.480425,0,"#ffb800"
428540085,JoaquinLiwski,36,4,0,4,0.501956,0.298817,0,"#00e8b2"
429038611,MECotera,12,31,0,31,0.296337,0.415862,0.013151,"#ff77ff"
430062589,datacultura,46,2,2,4,0.281111,0.601458,0,"#3bec00"
430842796,tophistoria,48,1,10,11,0.446208,0.601723,0.00341,"#008ebb"
432978550,GiselleGHipola,15,0,4,4,0.518879,0.510845,0,"#006032"
433696930,De_Paiz,28,13,9,22,0.361118,0.570854,0.008768,"#8ecfec"
433742667,pmarrai,39,4,8,12,0.472019,0.476436,0.003897,"#006032"
434345713,LeonorZozaya,37,23,23,46,0.448322,0.546367,0.020458,"#ffb800"
434481656,Stormende,8,0,4,4,0.623754,0.175765,0,"#3e93ff"
434751528,ernestoschrank,48,2,21,23,0.449038,0.561972,0.009255,"#008ebb"
434968866,eadh_org,0,143,24,167,0.353219,0.517025,0.079396,"#ffb800"
435948485,Vid_Santos,12,1,3,4,0.402979,0.488287,0,"#ff77ff"
435970422,DH_Oxford,0,14,2,16,0.400038,0.490774,0.005845,"#ffb800"
437195971,IDRH_KU,35,18,15,33,0.289668,0.444835,0.014126,"#c42c63"
437660451,martenduering,12,59,0,59,0.394139,0.44406,0.02679,"#ff77ff"
437837999,elenagbg,46,239,51,290,0.403349,0.549,0.139308,"#ffb800"
439243467,PostigoElena,39,6,10,16,0.41961,0.656272,0.005845,"#fcae7e"
441795572,AlumniUPO,22,3,3,6,0.300667,0.532812,0.000974,"#8ecfec"
441843136,Jorgepb96,37,0,4,4,0.471393,0.566941,0,"#fcae7e"
442725376,ainoa_castro,46,4,18,22,0.40831,0.56372,0.008768,"#ffb800"
442886822,diyclassics,12,1,20,21,0.374638,0.453286,0.008281,"#ff77ff"
443424403,CONICETLaPlata,46,4,0,4,0.373974,0.5782,0,"#3bec00"
443576117,BNE_museo,48,4,1,5,0.450436,0.617466,0.000487,"#ffb800"
443948284,montsefeu,12,9,3,12,0.328614,0.428123,0.003897,"#ff77ff"
445119000,gortazarbelvis,54,1,10,11,0.568745,0.632961,0.00341,"#c6cc85"
445207317,vicdurcas,0,1,3,4,0.446987,0.423637,0,"#3e93ff"
445516603,majothebear,54,0,4,4,0.639717,0.640589,0,"#c6cc85"
446468669,suricatem,19,1,3,4,0.540215,0.443356,0,"#00ed5d"
448091508,YosoySuku,0,9,7,16,0.379565,0.440484,0.005845,"#3e93ff"
448092052,JosepMLozano,14,5,0,5,0.577872,0.32445,0.000487,"#b6cb00"
448095929,_EstaLindaLaMar,17,11,28,39,0.471913,0.534494,0.017048,"#3bec00"
449190802,_athal,22,2,3,5,0.354296,0.552655,0.000487,"#8ecfec"
452910214,CIESEComillas,48,10,3,13,0.473585,0.6433,0.004384,"#008ebb"
455409829,MauricioHoyos4,19,0,7,7,0.418013,0.409871,0.001461,"#ff77ff"
455605329,DoloresRomero_,46,150,202,352,0.431036,0.524724,0.169508,"#ffb800"
456012667,cuaieedunam,0,12,9,21,0.409036,0.466643,0.008281,"#3e93ff"
456143365,AGNMex,46,6,1,7,0.268351,0.466446,0.001461,"#3bec00"
456751217,CEIColmex,26,6,4,10,0.333808,0.32044,0.002923,"#3e93ff"
457090748,auroraggf,26,4,4,8,0.366347,0.401301,0.001948,"#3e93ff"
457613501,Gabacer,0,6,5,11,0.454095,0.421247,0.00341,"#3e93ff"
459411454,colombiahoy,19,11,0,11,0.539396,0.384592,0.00341,"#00ed5d"
459498108,throughthe_veil,0,0,13,13,0.319339,0.450364,0.004384,"#ffb800"
460076508,Euroforum_ES,46,4,0,4,0.318903,0.570069,0,"#3bec00"
460255493,UZH_en,39,7,0,7,0.418463,0.374285,0.001461,"#00e8b2"
460797252,MarxArriaga,22,2,4,6,0.240868,0.477678,0.000974,"#8ecfec"
461301760,AdHoc22,15,0,9,9,0.460907,0.535591,0.002435,"#006032"
462845338,saloeslava,15,0,5,5,0.476611,0.540331,0.000487,"#8ecfec"
463280317,LuisMFdzC,46,2,3,5,0.291916,0.583666,0.000487,"#3bec00"
463612014,MorganRDZ,1,4,0,4,0.227521,0.453646,0,"#825403"
464762135,Mcotsar,12,1,3,4,0.415694,0.50345,0,"#ff77ff"
466903436,nataliasilvapra,48,13,15,28,0.446106,0.46602,0.01169,"#ff77ff"
467341825,UCM_fghis,46,15,3,18,0.439818,0.661121,0.006819,"#ffb800"
467373252,NOVAunl,39,7,3,10,0.431501,0.381539,0.002923,"#00e8b2"
467876886,Javier_Jover,48,0,6,6,0.420912,0.597728,0.000974,"#008ebb"
468076687,erinroseglass,0,0,4,4,0.336897,0.466269,0,"#3e93ff"
468201342,griso_unav,15,10,0,10,0.409439,0.551201,0.002923,"#8ecfec"
468415981,Ingenio_CsicUpv,48,0,4,4,0.469397,0.562327,0,"#008ebb"
469501029,sursiendo,0,23,3,26,0.311655,0.499572,0.010716,"#3e93ff"
471351155,AMIC_com,26,7,1,8,0.278183,0.58814,0.001948,"#3e93ff"
471926670,EspacioFTef,1,77,23,100,0.377545,0.56005,0.046761,"#825403"
472217141,ILCEedu,17,17,12,29,0.380012,0.554365,0.012177,"#3bec00"
472336787,cafelluvia,50,11,7,18,0.537855,0.513866,0.006819,"#008bdd"
472360175,mluisadiez,46,2,8,10,0.438324,0.554702,0.002923,"#ffb800"
472919559,cmatain,15,2,4,6,0.478815,0.50186,0.000974,"#8ecfec"
474168947,Danielmerino126,48,0,4,4,0.635695,0.32454,0,"#008ebb"
474775311,DDPNacho,1,0,4,4,0.293693,0.607497,0,"#825403"
474834196,IberoVervuert,1,1,3,4,0.406538,0.553106,0,"#ff0d69"
474887690,CSICCat,48,10,12,22,0.434157,0.605474,0.008768,"#008ebb"
475026877,a_gserrano,46,21,5,26,0.447436,0.567822,0.010716,"#ffb800"
475240029,ASELE_ELE,22,58,7,65,0.354893,0.65945,0.029713,"#8ecfec"
477728660,romanistik_de,0,2,7,9,0.397489,0.547321,0.002435,"#ffb800"
478510248,lamadrazacccugr,15,1,13,14,0.545264,0.575538,0.004871,"#006032"
478889932,cunygcdi,12,8,8,16,0.346607,0.37856,0.005845,"#ff77ff"
479212000,eleahlane,39,11,1,12,0.3627,0.398605,0.003897,"#00e8b2"
479720712,michatis,12,0,9,9,0.404838,0.418167,0.002435,"#ff77ff"
479784061,BibliotecasPUJ,36,21,9,30,0.481365,0.377297,0.012664,"#6c241e"
480557521,AkalEditor,19,20,3,23,0.610863,0.453516,0.009255,"#00ed5d"
481216292,JuanMEscribano,22,5,18,23,0.399301,0.727345,0.009255,"#8ecfec"
483039134,janmoreno_tgn,22,0,4,4,0.335341,0.658871,0,"#8ecfec"
483045008,carbadol,48,0,4,4,0.452275,0.643932,0,"#008ebb"
484634911,noktuae,0,0,7,7,0.377755,0.485801,0.001461,"#ffb800"
484756923,aliciacbu,15,11,28,39,0.406679,0.53265,0.017048,"#ff0d69"
484861681,ant_mrubio,22,0,6,6,0.377683,0.602483,0.000974,"#8ecfec"
485538735,ciencia_uc3m,21,3,2,5,0.565265,0.631037,0.000487,"#ffa64e"
485593296,susen23,0,0,4,4,0.319908,0.468344,0,"#3e93ff"
487552078,BlancaSanjuanbe,48,2,2,4,0.430951,0.577714,0,"#ff0d69"
487873280,NinfaOceanide,0,0,4,4,0.381949,0.415209,0,"#3e93ff"
488951611,OPR_71,46,29,33,62,0.412321,0.524518,0.028251,"#3bec00"
489404622,Ana_Lobo_,28,1,3,4,0.412454,0.621909,0,"#8ecfec"
489772333,patodiazGNU,54,9,4,13,0.556697,0.634223,0.004384,"#c6cc85"
491200214,culturasucm,46,15,10,25,0.440443,0.559654,0.010229,"#ffb800"
492184231,Patriciadcm,15,5,3,8,0.389862,0.579125,0.001948,"#008ebb"
492447179,UNIRResearch,25,14,1,15,0.372063,0.500351,0.005358,"#ff0d69"
492650091,HisAmbyPol,19,4,8,12,0.466056,0.44751,0.003897,"#00ed5d"
493117643,JoseIgnacioSama,19,0,6,6,0.507001,0.509513,0.000974,"#00ed5d"
494325431,pinvisibles,48,38,0,38,0.635201,0.510068,0.016561,"#006032"
494837827,accaminero,46,9,18,27,0.396116,0.561423,0.011203,"#ffb800"
495153224,data_fiend,0,0,4,4,0.334422,0.490701,0,"#ffb800"
495229857,soylaheredera,15,4,0,4,0.496188,0.456049,0,"#006032"
495473617,Juanmanuelmaci,48,10,3,13,0.123207,0.671642,0.004384,"#ffb800"
496931713,bgmps,48,0,5,5,0.487872,0.535059,0.000487,"#008ebb"
497987194,RamosRuizA,15,3,4,7,0.517296,0.516902,0.001461,"#006032"
498162955,mjcolmenero,12,34,5,39,0.399984,0.464539,0.017048,"#ff77ff"
499911925,anaiggo_archive,28,0,7,7,0.428076,0.583456,0.001461,"#3bec00"
501006489,ConeixHistoria,21,1,4,5,0.566573,0.781411,0.000487,"#ffa64e"
501636943,Leyre_Martin,22,31,34,65,0.37663,0.567533,0.029713,"#8ecfec"
502005651,TVMORFOSIS,17,5,4,9,0.401373,0.711246,0.002435,"#3bec00"
502005672,AmparoAlonsoB,49,10,4,14,0.440906,0.550032,0.004871,"#ff0d69"
505731430,OVTTpt,15,2,2,4,0.490207,0.51605,0,"#006032"
505738863,CasaLector,1,5,0,5,0.474795,0.53998,0.000487,"#ff12a3"
506069531,UNIR_Investiga,25,14,7,21,0.398123,0.516599,0.008281,"#ff0d69"
506428106,StellaStellae,15,16,5,21,0.539006,0.475153,0.008281,"#006032"
506903769,ehecdmx,36,1,11,12,0.226997,0.524858,0.003897,"#6c241e"
507482535,CCHS_CSIC,48,175,86,261,0.453235,0.543007,0.125183,"#008ebb"
507656919,auxbib,0,2,3,5,0.41965,0.517264,0.000487,"#3e93ff"
507687735,FicUdelar,54,22,2,24,0.589237,0.627832,0.009742,"#c6cc85"
508573682,rabasf,1,65,3,68,0.564774,0.627314,0.031174,"#ff12a3"
509121249,ErandenyOsorio,0,2,5,7,0.314197,0.413942,0.001461,"#3e93ff"
509707495,emiximemx,0,1,3,4,0.312906,0.407373,0,"#3e93ff"
510071832,UGRdivulga,15,1,4,5,0.516771,0.530026,0.000487,"#006032"
510335664,angela_demiguel,48,11,2,13,0.081749,0.568639,0.004384,"#008ebb"
510370731,AndrsSaumellLla,25,0,4,4,0.342575,0.528735,0,"#ff0d69"
510496086,Maestro_Montes,15,0,7,7,0.54179,0.532237,0.001461,"#006032"
510764402,gabcalarco,46,3,9,12,0.335349,0.531424,0.003897,"#3bec00"
512052479,juandavid2812,46,4,0,4,0.334583,0.476425,0,"#3bec00"
512312001,GeorgEckert,0,2,2,4,0.351654,0.483477,0,"#3e93ff"
513325480,duquebuitre,0,6,3,9,0.469176,0.480177,0.002435,"#3e93ff"
514185205,redtransfer_,15,0,4,4,0.562955,0.53612,0,"#006032"
514578189,SotoLoli,15,0,5,5,0.507704,0.488293,0.000487,"#006032"
515787374,AlyssaA_DHSI,39,2,2,4,0.340669,0.30213,0,"#00e8b2"
516158050,InfoTecarios,46,90,10,100,0.361639,0.559959,0.046761,"#3bec00"
516674922,RedesCursos,46,0,7,7,0.370347,0.635245,0.001461,"#3bec00"
516708506,CLIRnews,0,9,0,9,0.318315,0.440783,0.002435,"#3bec00"
517013007,Immerwarten,39,1,3,4,0.437963,0.690869,0,"#fcae7e"
517513481,Meri_SM,1,0,5,5,0.397122,0.537201,0.000487,"#ff12a3"
519809368,pilarmanchon,22,5,0,5,0.355955,0.548102,0.000487,"#8ecfec"
521353800,PedroPablo_AM,36,2,2,4,0.580866,0.288336,0,"#00e8b2"
523048819,Cienciagranada,15,0,5,5,0.533421,0.525461,0.000487,"#006032"
523402470,historicopuj,36,11,4,15,0.475359,0.420884,0.005358,"#00e8b2"
524749036,xaquinnunez,15,6,0,6,0.324405,0.590509,0.000974,"#ff0d69"
525338716,Anabelfemo,0,0,4,4,0.421575,0.488006,0,"#3e93ff"
525549634,FernandoUMA,15,26,47,73,0.465722,0.527906,0.033609,"#ff0d69"
529039861,PPhiloBiblon,46,26,7,33,0.433829,0.557224,0.014126,"#ffb800"
529267604,CarolinaSanchiz,25,6,2,8,0.332844,0.457005,0.001948,"#ff0d69"
531033226,fylunav,49,21,5,26,0.529264,0.477441,0.010716,"#8ecfec"
531146065,culthunting,37,5,1,6,0.519518,0.495867,0.000974,"#fcae7e"
531790026,AusinTxetxu,15,1,3,4,0.583473,0.519537,0,"#006032"
532155074,j_gred,12,0,4,4,0.415808,0.478365,0,"#ff77ff"
532449573,OpenGLAM,19,4,8,12,0.462071,0.482516,0.003897,"#00ed5d"
532990484,garcia_miren,48,0,7,7,0.466342,0.392187,0.001461,"#008ebb"
533125840,CEAndaluces,48,7,2,9,0.39528,0.375079,0.002435,"#ff0d69"
533163305,DHDInfo,0,4,8,12,0.352515,0.475733,0.003897,"#ffb800"
533198978,bibliotecacln,46,4,2,6,0.45286,0.47243,0.000974,"#ffb800"
533537289,humanavirtual,0,0,5,5,0.385213,0.405179,0.000487,"#3e93ff"
534159296,cvherranz,25,0,7,7,0.39481,0.587118,0.001461,"#8ecfec"
535591380,monicavinaras,1,3,3,6,0.347009,0.554249,0.000974,"#ff12a3"
535658941,eHumanista,0,5,0,5,0.40893,0.525097,0.000487,"#ff0d69"
535707261,eldiarioes,0,4,0,4,0.462091,0.527975,0,"#ff0d69"
537356333,rey_marisa,48,1,3,4,0.640418,0.438207,0,"#ff0d69"
537589531,carlosmoriyon,48,0,6,6,0.251637,0.553333,0.000974,"#008ebb"
538097725,GCDH,46,0,5,5,0.398751,0.543811,0.000487,"#ffb800"
539489098,puic_unam,26,5,0,5,0.330286,0.252591,0.000487,"#3e93ff"
540098505,isidroaguillo,46,25,41,66,0.434358,0.534789,0.0302,"#008ebb"
540830530,ebicet,39,9,6,15,0.403346,0.427577,0.005358,"#00e8b2"
541058739,DigitalBourne,48,1,3,4,0.619056,0.593818,0,"#006032"
541759325,ordendeltiempo,22,8,10,18,0.368586,0.585017,0.006819,"#8ecfec"
542031363,milagrostolon,37,16,1,17,0.48571,0.678126,0.006332,"#fcae7e"
543392682,mora_federico,36,0,6,6,0.118456,0.514615,0.000974,"#00e8b2"
543912932,conejibot,12,1,4,5,0.331194,0.339265,0.000487,"#ff77ff"
544643751,integracionbta,12,9,0,9,0.803987,0.366297,0.002435,"#ff77ff"
546454155,JennEBN,12,0,7,7,0.334642,0.50632,0.001461,"#ff77ff"
546930504,RebecaPardo,48,4,5,9,0.727109,0.687449,0.002435,"#66e087"
547804990,FranciaBetty,54,0,4,4,0.618577,0.664331,0,"#c6cc85"
548901829,judoley,5,11,6,17,0.35812,0.383587,0.006332,"#ff9b8f"
551026217,Claritaylasgeme,37,6,8,14,0.409425,0.578465,0.004871,"#ffb800"
551388767,casulunam,26,4,0,4,0.309026,0.267191,0,"#3e93ff"
551750335,jfcarabano,15,0,4,4,0.539418,0.534149,0,"#006032"
553129577,marisolfi,46,23,17,40,0.332612,0.494584,0.017535,"#3bec00"
553177626,adralvsan,0,47,61,108,0.396869,0.473819,0.050658,"#3e93ff"
553456318,IzquierdoLuisa,15,3,1,4,0.551273,0.665286,0,"#ffb800"
554734835,CarlosGimenezL,48,1,7,8,0.444051,0.505537,0.001948,"#008ebb"
554974165,SilviaVerdu,15,0,23,23,0.444342,0.517785,0.009255,"#ffb800"
555099241,ImpactoTIC,19,44,12,56,0.522451,0.43866,0.025329,"#00ed5d"
555300984,AsociacionALEPH,28,2,2,4,0.397166,0.622499,0,"#8ecfec"
555528318,CitepUBA,46,56,3,59,0.325028,0.533936,0.02679,"#3bec00"
556911179,AriadnaRazoS,0,5,4,9,0.267701,0.489893,0.002435,"#3e93ff"
557018040,CheluiMF,15,2,4,6,0.505692,0.522815,0.000974,"#006032"
557051869,ACICOMColombia,36,0,4,4,0.503059,0.429085,0,"#6c241e"
557703975,anavalverdem,46,7,2,9,0.479546,0.579165,0.002435,"#ffb800"
557818609,conectarlab,46,6,0,6,0.338903,0.602617,0.000974,"#3bec00"
559943660,alexrubiogr,49,0,5,5,0.453088,0.530133,0.000487,"#ffa64e"
560141114,mjlinguo,0,0,5,5,0.435315,0.397532,0.000487,"#3e93ff"
560305796,SoDesignHistory,0,4,0,4,0.389899,0.433344,0,"#3e93ff"
560917961,OTRI_UMU,28,3,3,6,0.678615,0.75715,0.000974,"#008ebb"
561174293,CarmenHerrero14,15,6,2,8,0.417852,0.617257,0.001948,"#ffa64e"
561251159,biblioUPM,15,5,29,34,0.483654,0.584783,0.014613,"#006032"
561254163,Ealvarezramos,46,1,4,5,0.429707,0.567303,0.000487,"#8ecfec"
561444419,profgabrielle,12,0,7,7,0.322973,0.449119,0.001461,"#ff77ff"
561850028,fiormont,0,129,76,205,0.421996,0.483691,0.097905,"#3e93ff"
562030778,Haciendapy,36,6,3,9,0.139018,0.493507,0.002435,"#00e8b2"
562288482,Mindependencia,19,8,1,9,0.36726,0.396856,0.002435,"#00ed5d"
563040909,JesusGMoran,0,0,7,7,0.470202,0.470925,0.001461,"#ff0d69"
563642405,DigitHumanities,46,5,0,5,0.401535,0.571121,0.000487,"#ffb800"
563646703,teamlabs,35,2,4,6,0.590812,0.55828,0.000974,"#008ebb"
564047156,susanaladra,49,15,2,17,0.405885,0.518671,0.006332,"#ff0d69"
564651869,PlanLecturaMed,46,12,0,12,0.071923,0.413606,0.003897,"#00ed5d"
564788462,ariasandgli,1,39,27,66,0.365342,0.545201,0.0302,"#ff12a3"
565789266,JuanaMarcoGo,1,0,4,4,0.541033,0.581652,0,"#ff12a3"
566414140,jimedylan,15,11,2,13,0.191731,0.44798,0.004384,"#006032"
567188286,IndexComu,15,15,1,16,0.472712,0.685427,0.005845,"#008ebb"
567256073,Cedric_80,17,1,3,4,0.346854,0.836583,0,"#3bec00"
567360618,edXOnline,15,6,0,6,0.470073,0.488688,0.000974,"#006032"
568474353,alanyliu,46,8,6,14,0.357985,0.492826,0.004871,"#3bec00"
568520439,GianellaDel,15,1,6,7,0.519773,0.65594,0.001461,"#006032"
570491094,VRI_UN,19,9,15,24,0.345299,0.40196,0.009742,"#00ed5d"
570715127,Comillas_biblio,48,1,3,4,0.390825,0.57386,0,"#008ebb"
570848073,ConchaTorresBeg,46,0,14,14,0.406416,0.539062,0.004871,"#ffb800"
571082904,SEECadiz,37,2,2,4,0.635664,0.583124,0,"#ffb800"
571430547,rebeccadactyl,15,2,13,15,0.864879,0.702174,0.005358,"#006032"
571974376,moradaamarilla,12,0,15,15,0.391177,0.358051,0.005358,"#ff77ff"
572136250,RAKarl,12,1,15,16,0.367972,0.389868,0.005845,"#ff77ff"
572880339,Paulogaticacote,0,0,5,5,0.529923,0.424632,0.000487,"#3e93ff"
574030246,filos_unam,0,83,4,87,0.377293,0.440046,0.040429,"#3e93ff"
574717652,PatrciaMMarcos,12,0,4,4,0.322702,0.392179,0,"#ff77ff"
575486484,aaron_canseco,0,0,5,5,0.391065,0.403952,0.000487,"#3e93ff"
575536185,marticabailo,54,0,5,5,0.58285,0.687735,0.000487,"#c6cc85"
576118859,LSanzMenendez,48,0,6,6,0.554224,0.55521,0.000974,"#008ebb"
576225644,UofEHumanities,0,7,0,7,0.370835,0.417536,0.001461,"#00e8b2"
576494759,UNEDTalavera,46,0,4,4,0.423149,0.536465,0,"#ffb800"
576924497,XavierFerras,14,17,26,43,0.584079,0.308816,0.018997,"#b6cb00"
577168570,manuuelagarciam,50,10,4,14,0.65983,0.442194,0.004871,"#008bdd"
577202279,aesla_twit,46,10,3,13,0.375221,0.561632,0.004384,"#ffb800"
578196803,jvalbuenarod,15,1,8,9,0.561681,0.572976,0.002435,"#006032"
578229694,investigausal,28,4,0,4,0.147629,0.540933,0,"#8ecfec"
578916336,Mhervas,48,4,1,5,0.758453,0.401797,0.000487,"#006032"
579210845,Toniovetpath,37,0,7,7,0.494167,0.646486,0.001461,"#ffb800"
579225973,JGarciaFronti,46,6,14,20,0.337083,0.519146,0.007793,"#3bec00"
579269375,helena_strecker,39,5,3,8,0.406223,0.280898,0.001948,"#00e8b2"
579936212,sintesisuaemex,35,8,9,17,0.22596,0.296463,0.006332,"#c42c63"
581109443,patosalazarv,19,4,7,11,0.554491,0.584744,0.00341,"#5456a6"
581416381,guidoweks,36,2,2,4,0.130665,0.463872,0,"#403538"
581867864,Ganimedes_Asoc,22,8,2,10,0.330129,0.63158,0.002923,"#008ebb"
582615674,fmapfre,39,10,0,10,0.42819,0.648122,0.002923,"#fcae7e"
584080217,FCriadoBoado,49,11,6,17,0.42619,0.482506,0.006332,"#ff0d69"
584112631,FEDUNArgentina,50,5,0,5,0.339243,0.721439,0.000487,"#3bec00"
585216750,Aviranetiano,22,0,4,4,0.491803,0.531774,0,"#ff0d69"
585824468,CarlesRocamora,27,0,4,4,0.930241,0.185768,0,"#00ed5d"
586714462,SeminarioSIELAE,0,23,0,23,0.396865,0.550748,0.009255,"#ff0d69"
587401635,AppCultura,48,3,2,5,0.567594,0.636145,0.000487,"#008ebb"
588197195,bid_dimad,48,5,0,5,0.45838,0.597169,0.000487,"#008ebb"
588402875,FDerechoUGR,15,6,3,9,0.537372,0.538163,0.002435,"#006032"
589277590,CulturaUniandes,12,4,0,4,0.361243,0.514747,0,"#00ed5d"
589990677,esDBpedia,48,0,6,6,0.457229,0.655035,0.000974,"#008ebb"
590181012,cipensoio_es,46,0,5,5,0.412833,0.507309,0.000487,"#ffb800"
590391131,JFCalderero,25,9,3,12,0.376419,0.55196,0.003897,"#ff0d69"
590754035,carriazojr,46,35,25,60,0.417761,0.571749,0.027277,"#8ecfec"
592731960,PabloLopezm34,1,0,10,10,0.43476,0.576721,0.002923,"#ff12a3"
593196309,IxaTaldea,12,1,4,5,0.404213,0.468222,0.000487,"#ff77ff"
593618061,Uni_WUE,48,5,0,5,0.435115,0.488651,0.000487,"#ffb800"
593769567,IxaGroup,12,1,5,6,0.401335,0.488294,0.000974,"#ff77ff"
594487193,_IPComunicacion,14,4,3,7,0.632232,0.311693,0.001461,"#b6cb00"
595114749,ClaudiaJuradoG,19,2,2,4,0.675067,0.645009,0,"#5456a6"
595588585,UOCartshum,15,52,14,66,0.452784,0.524901,0.0302,"#ff0d69"
595724234,Facsalud_UCEN,46,6,4,10,0.281514,0.489831,0.002923,"#3bec00"
596207368,paolomonella,0,14,12,26,0.399021,0.478588,0.010716,"#3e93ff"
597706344,asociacionruvid,48,5,9,14,0.463472,0.500174,0.004871,"#ff0d69"
597825672,jo_frankie,39,6,1,7,0.343678,0.36036,0.001461,"#00e8b2"
599133260,nottinauta,46,3,3,6,0.32939,0.49988,0.000974,"#3bec00"
599933777,PlataformC,48,5,0,5,0.67772,0.453246,0.000487,"#006032"
600561959,Crst_C,36,7,8,15,0.152516,0.473514,0.005358,"#403538"
600815587,t_barcelo,1,7,2,9,0.407228,0.510683,0.002435,"#ff12a3"
601006502,HacerCultural,19,5,0,5,0.485984,0.606017,0.000487,"#5456a6"
601519084,OrlandoDeavilaP,19,102,0,102,0.215384,0.181555,0.047735,"#ff77ff"
601569652,GarciaGarfaroma,1,3,5,8,0.351745,0.504102,0.001948,"#825403"
601657931,josorella,1,0,7,7,0.397336,0.540238,0.001461,"#ff12a3"
602254044,VoyantTools,12,19,2,21,0.357967,0.477397,0.008281,"#ff77ff"
602721353,BHumanitatsUAB,48,2,13,15,0.450053,0.558534,0.005358,"#ff0d69"
602962987,FylUex,46,12,0,12,0.443543,0.551669,0.003897,"#ffb800"
603097163,CIM_UNR,46,10,3,13,0.342141,0.590886,0.004384,"#3bec00"
603864949,derechoaleer,12,1,5,6,0.352582,0.417556,0.000974,"#ff77ff"
604668053,atomoverde_,19,7,2,9,0.397036,0.420839,0.002435,"#3e93ff"
606296247,ovidiuspictus,48,10,10,20,0.403451,0.569567,0.007793,"#ffb800"
606315649,arantzaozaeta,35,1,3,4,0.57998,0.560898,0,"#008ebb"
607170913,InvestigaUS,22,15,10,25,0.366553,0.599679,0.010229,"#8ecfec"
607574716,UCLA_DH,0,18,0,18,0.381845,0.469135,0.006819,"#3e93ff"
607602141,ProgHist,12,541,79,620,0.385695,0.437772,0.300049,"#ff77ff"
608082622,CanalUNED,46,7,0,7,0.459991,0.510396,0.001461,"#ffb800"
608500702,sauripez,46,2,5,7,0.420789,0.505128,0.001461,"#ffb800"
608754256,Carmencita_rps,50,8,8,16,0.588487,0.405955,0.005845,"#008bdd"
611551774,femcat,14,9,0,9,0.586124,0.27212,0.002435,"#b6cb00"
611647762,letibarrionuevo,21,5,2,7,0.418175,0.575803,0.001461,"#ffa64e"
611716756,amv5_com,22,0,5,5,0.392997,0.679281,0.000487,"#8ecfec"
612026965,juanita_nani,25,29,75,104,0.401774,0.504196,0.048709,"#ff0d69"
612794988,Macra5,0,0,7,7,0.390268,0.462352,0.001461,"#3e93ff"
612808132,santirguez91,48,0,6,6,0.484528,0.576223,0.000974,"#008ebb"
613717245,VocacionReactor,0,17,4,21,0.316877,0.353281,0.008281,"#3e93ff"
614034910,re_blen,19,7,1,8,0.615321,0.329931,0.001948,"#3e93ff"
614478936,HistoriayVideoj,28,11,0,11,0.589606,0.513916,0.00341,"#00ed5d"
614492046,nancyariasvilla,36,0,4,4,0.159944,0.492116,0,"#00e8b2"
616425142,JoserraMarcaida,48,8,7,15,0.409834,0.529993,0.005358,"#008ebb"
616462345,lauracrescendo,15,4,5,9,0.455544,0.526192,0.002435,"#ff0d69"
616509964,PerezPuenteL,12,5,13,18,0.341079,0.459764,0.006819,"#ff77ff"
616611494,abhumphreys,39,0,4,4,0.329628,0.30464,0,"#00e8b2"
617333434,Docutradus,28,9,3,12,0.378123,0.591286,0.003897,"#8ecfec"
618308774,BenjiPrise,0,0,4,4,0.334153,0.422367,0,"#3e93ff"
618464598,davidsoIorzano,37,0,4,4,0.422624,0.535886,0,"#fcae7e"
619290209,VillodreJulian,21,0,4,4,0.617613,0.511534,0,"#ffa64e"
621228652,ROMEUBA1,46,4,0,4,0.348368,0.559066,0,"#3bec00"
622906040,NubeDidactica,15,5,4,9,0.402426,0.584908,0.002435,"#ffb800"
622908793,DanielAlvesFCSH,39,103,126,229,0.431596,0.435622,0.109596,"#00e8b2"
623019847,DailyArtApp,19,2,2,4,0.446884,0.398523,0,"#3e93ff"
624839528,Lilimarlene5,37,0,4,4,0.504502,0.586273,0,"#ffb800"
626166984,negrita73bn,27,0,4,4,0.913331,0.18256,0,"#00ed5d"
626580677,sel_silvia,46,0,15,15,0.340546,0.573143,0.005358,"#3bec00"
627013647,Historia_UC,26,2,2,4,0.326292,0.223072,0,"#3e93ff"
627058977,Monic2102,15,0,4,4,0.400337,0.51414,0,"#006032"
627469515,rogeriomadeira2,39,0,6,6,0.478205,0.395218,0.000974,"#00e8b2"
627539634,DIIS_UZ,48,9,1,10,0.4517,0.684529,0.002923,"#008ebb"
628606004,bdh_uv,0,5,0,5,0.462616,0.48823,0.000487,"#3e93ff"
629192461,ContratiempoHis,21,7,0,7,0.557806,0.424813,0.001461,"#ffa64e"
631016900,UNIRRevista,25,6,4,10,0.348414,0.545494,0.002923,"#ff0d69"
631260803,CCDmx,1,14,4,18,0.402332,0.458761,0.006819,"#825403"
631335110,FloresCollazo,48,1,4,5,0.454404,0.582236,0.000487,"#008ebb"
632139519,jagv69,10,0,13,13,0.345828,0.457382,0.004384,"#3bec00"
632315069,Idhie_Iberopue,20,3,5,8,0.349889,0.251202,0.001948,"#f4c8cf"
632706787,antortl,48,2,2,4,0.555866,0.698878,0,"#008ebb"
632731274,mariaparrula,22,2,10,12,0.361022,0.602601,0.003897,"#8ecfec"
632957861,JornetNuria,48,0,14,14,0.459677,0.551083,0.004871,"#008ebb"
633961342,tmycarlos,0,2,29,31,0.416685,0.435813,0.013151,"#3e93ff"
634532948,Nuriettt,48,0,9,9,0.447039,0.503617,0.002435,"#008ebb"
636126399,ATUspain,15,6,19,25,0.499136,0.546365,0.010229,"#006032"
637266063,aladeva,15,0,5,5,0.491592,0.526857,0.000487,"#006032"
701709276,vocesenelfenix,46,6,0,6,0.3396,0.597365,0.000974,"#3bec00"
701804250,MorenoAmc,46,0,5,5,0.437559,0.61275,0.000487,"#ffb800"
701967595,medialabufrj,39,25,6,31,0.384513,0.237677,0.013151,"#00e8b2"
703068096,Sagarq_,12,0,6,6,0.445165,0.419249,0.000974,"#ff77ff"
705506810,corchadojm,28,5,1,6,0.209241,0.576075,0.000974,"#8ecfec"
712595004,ArchivoHUR,36,38,8,46,0.521352,0.40159,0.020458,"#00e8b2"
713185957,panatenaico,48,0,8,8,0.377383,0.511725,0.001948,"#008ebb"
713817882,u_henny,12,8,0,8,0.384223,0.478557,0.001948,"#ff77ff"
714418874,socialtic,0,4,4,8,0.373158,0.443868,0.001948,"#3e93ff"
716379432,Jesica_noticias,35,3,3,6,0.228036,0.347213,0.000974,"#c42c63"
718533691,netaz16,0,0,10,10,0.342068,0.388029,0.002923,"#3e93ff"
719745056,FdezMallo,36,1,3,4,0.308634,0.468793,0,"#6c241e"
720754110,FORCE11rescomm,10,11,2,13,0.353607,0.526613,0.004384,"#00ed5d"
721428048,UsinadelArte,46,4,0,4,0.370137,0.57909,0,"#3bec00"
723213948,fariasmlaura,22,0,6,6,0.529351,0.573143,0.000974,"#8ecfec"
724824990,Postmaquina,0,3,13,16,0.398614,0.491275,0.005845,"#3e93ff"
729816362,carlosmarcialt,1,0,5,5,0.498185,0.271716,0.000487,"#825403"
733092900,DARIAHeu,46,72,11,83,0.411037,0.490881,0.03848,"#ffb800"
734492658,AnaNieva4,15,0,6,6,0.433836,0.566692,0.000974,"#8ecfec"
738801518,rafaelmcortina,1,2,3,5,0.321731,0.564998,0.000487,"#825403"
741575300,loyolahistdept,39,10,0,10,0.25548,0.334935,0.002923,"#ff77ff"
741821887,FriidaMh3,35,0,4,4,0.258301,0.380509,0,"#c42c63"
743775992,UNAM_Historicas,0,41,4,45,0.341266,0.415988,0.019971,"#3e93ff"
743987773,JonathanHsy,12,0,4,4,0.349329,0.467883,0,"#ff77ff"
745770199,CEEColmex,26,4,2,6,0.351639,0.325512,0.000974,"#3e93ff"
749522000,DJWrisley,46,34,27,61,0.378785,0.466561,0.027764,"#3bec00"
758650820,natelsonsouz,39,0,4,4,0.43868,0.394905,0,"#00e8b2"
759561529,scannopolis,46,11,4,15,0.351847,0.500274,0.005358,"#3bec00"
760165981,IFLALAC,15,4,2,6,0.43959,0.482224,0.000974,"#ff0d69"
761159640,ceterio,12,9,6,15,0.304091,0.361485,0.005358,"#ff77ff"
769579399,clia_g,1,0,9,9,0.39688,0.598238,0.002435,"#006032"
769694005,DanielSalinas00,0,2,3,5,0.36493,0.474558,0.000487,"#00ed5d"
770114930,_anitapast,21,6,0,6,0.563239,0.798554,0.000974,"#ffa64e"
774426811,AndyAreynolds,0,1,3,4,0.333392,0.452317,0,"#3e93ff"
776322404,SC3UIS,30,4,5,9,0.536046,0.165901,0.002435,"#ff77ff"
780425474,FrancescPedroED,15,4,0,4,0.521298,0.467706,0,"#006032"
780799057,conchisirvent,46,0,9,9,0.432072,0.571755,0.002435,"#ffb800"
781605720,djherreram,36,6,1,7,0.277038,0.341785,0.001461,"#6c241e"
782666660,95_roni,21,3,10,13,0.58265,0.762506,0.004384,"#ffa64e"
785311214,dgraficoandina,19,0,4,4,0.561684,0.507156,0,"#5456a6"
785339821,LancsDigHum,10,10,14,24,0.378709,0.470198,0.009742,"#00ed5d"
785756804,CorreaMaLeticia,39,0,7,7,0.405191,0.314008,0.001461,"#00e8b2"
787702321,EstoriadEspanna,46,1,5,6,0.377082,0.5232,0.000974,"#3bec00"
787869678,JCCavallero,26,0,4,4,0.329461,0.38143,0,"#3e93ff"
789503900,antigua_roma,1,35,0,35,0.570225,0.426651,0.0151,"#ff12a3"
789908905,ZozayaMaria,48,7,9,16,0.431558,0.494863,0.005845,"#008ebb"
790412708,UCESVirtual,46,4,0,4,0.331194,0.521705,0,"#3bec00"
790439281,German05Ramirez,50,0,4,4,0.701445,0.408426,0,"#008bdd"
801916482,JEEGut,12,0,6,6,0.373961,0.415675,0.000974,"#ff77ff"
804125887,GrauCIC_UB,48,4,2,6,0.517108,0.661815,0.000974,"#ffb800"
806626152,aloba67,46,0,7,7,0.433833,0.576984,0.001461,"#ffb800"
807411919,fcsudelar,54,25,0,25,0.606103,0.662259,0.010229,"#c6cc85"
808943102,RedLGC,0,5,0,5,0.370093,0.442767,0.000487,"#3e93ff"
813078852,adrianacorreav,19,5,0,5,0.612331,0.385553,0.000487,"#00ed5d"
813222199,sergemont,12,7,1,8,0.460453,0.256093,0.001948,"#ff77ff"
813345582,IdaisOrozco1,50,0,5,5,0.64729,0.430244,0.000487,"#008bdd"
815119620,IGeociencias,48,4,1,5,0.462295,0.579799,0.000487,"#008ebb"
816258002,GarciaReidy,28,17,12,29,0.415368,0.530313,0.012177,"#ff0d69"
817406832,leticiatobalina,49,27,24,51,0.454677,0.476994,0.022893,"#3bec00"
819369228,ThiagoKrause2,39,10,0,10,0.420499,0.284849,0.002923,"#00e8b2"
819809576,24clm,46,10,1,11,0.423328,0.621542,0.00341,"#ffb800"
821814254,UofT,0,5,0,5,0.423121,0.463239,0.000487,"#ff0d69"
822207002,Mariaemiliacor7,46,2,3,5,0.331942,0.614741,0.000487,"#3bec00"
823443997,l_casal,49,2,2,4,0.221724,0.541088,0,"#c6cc85"
832651687,AntropologiaGC,48,0,5,5,0.459999,0.551566,0.000487,"#008ebb"
833414754,KChatlosh,12,5,13,18,0.351481,0.408561,0.006819,"#ff77ff"
833614171,UMETeduar,46,15,4,19,0.360795,0.532843,0.007306,"#3bec00"
833619990,psycoinnovacom,46,0,5,5,0.523444,0.537507,0.000487,"#8ecfec"
833777688,guida_ramos2,39,1,9,10,0.416031,0.389449,0.002923,"#ffb800"
834268088,ELEdeLeyre,15,0,8,8,0.434465,0.596276,0.001948,"#008ebb"
834831859,garciacontto,15,0,6,6,0.532818,0.550475,0.000974,"#006032"
835823304,AsociacionBETA,0,8,21,29,0.421732,0.501857,0.012177,"#ff0d69"
837728172,TinaCuore,22,0,11,11,0.489204,0.423185,0.00341,"#8ecfec"
840532310,thstraka,49,13,1,14,0.593678,0.404193,0.004871,"#3bec00"
843240109,UNIGISGirona,48,6,0,6,0.515565,0.539069,0.000974,"#008ebb"
845136698,LlanosTobarra,46,0,11,11,0.442191,0.569472,0.00341,"#ffb800"
847548169,shoggoth_roof,49,0,5,5,0.517928,0.569881,0.000487,"#ffa64e"
848138875,javi_cubillas,46,7,1,8,0.647812,0.764287,0.001948,"#3bec00"
854587268,MencheAstur,21,11,11,22,0.543882,0.774789,0.008768,"#ffa64e"
855308119,Buscameblog,21,6,32,38,0.559132,0.712982,0.016561,"#ffa64e"
855809316,Carl0sReyes,12,0,15,15,0.370501,0.408808,0.005358,"#ff77ff"
856787564,Domicialucida,48,0,10,10,0.418619,0.492254,0.002923,"#008ebb"
857648287,SilviaArano,46,0,8,8,0.414854,0.541293,0.001948,"#ffb800"
857836315,becasMEX,22,2,6,8,0.314558,0.540383,0.001948,"#8ecfec"
858089791,Frantiento,48,0,10,10,0.426583,0.551326,0.002923,"#008ebb"
859995816,GalloAlgebraico,0,0,15,15,0.373734,0.461232,0.005358,"#3e93ff"
861121453,42MadridFTef,1,7,3,10,0.322329,0.533326,0.002923,"#825403"
861148796,EulogioMR,46,1,5,6,0.427105,0.620708,0.000974,"#ffb800"
862729148,UOCeimt,36,5,2,7,0.558055,0.283055,0.001461,"#00e8b2"
863241644,Deob71,48,1,6,7,0.520598,0.639229,0.001461,"#008ebb"
863803430,rizzo_pubhist,12,0,4,4,0.309786,0.420159,0,"#ff77ff"
864460226,angallego_,22,6,6,12,0.256118,0.674606,0.003897,"#ff0d69"
867527137,Lidia_Bocanegra,15,61,38,99,0.481735,0.541781,0.046274,"#006032"
867699750,peinadormarta,15,4,4,8,0.473818,0.521318,0.001948,"#ff0d69"
868097696,lilysan86,0,20,21,41,0.41526,0.434967,0.018022,"#3e93ff"
868566271,BibliotecasUAQ,0,10,0,10,0.354781,0.417132,0.002923,"#3e93ff"
868601726,Myriam_ff,25,15,6,21,0.362772,0.525405,0.008281,"#ff0d69"
869972678,josemaenfermero,15,1,3,4,0.563579,0.510675,0,"#006032"
870548443,sombradoble,15,0,4,4,0.498666,0.537682,0,"#ff0d69"
873297379,Rocieco,28,9,6,15,0.403403,0.617071,0.005358,"#8ecfec"
876335550,memoriademadrid,28,79,2,81,0.490559,0.301732,0.037506,"#8ecfec"
876800750,Telefonica_Col,1,2,2,4,0.223841,0.578716,0,"#825403"
877755836,anna_kijas,0,2,3,5,0.269908,0.460811,0.000487,"#ffb800"
878092579,wscholger,0,1,3,4,0.340286,0.439267,0,"#3e93ff"
882346514,xicanohistorian,12,0,11,11,0.314758,0.426049,0.00341,"#ff77ff"
884928920,CarmenMSnchez,22,1,3,4,0.421153,0.511345,0,"#8ecfec"
885052908,TICE_UCLM,1,0,4,4,0.418372,0.554162,0,"#825403"
885806964,LinaZapataCasas,46,3,14,17,0.356665,0.495634,0.006332,"#3bec00"
887001133,HumAplicadas,39,3,1,4,0.407158,0.657358,0,"#ffb800"
887100348,Ruth13L,12,0,5,5,0.258664,0.405436,0.000487,"#ff77ff"
888914514,CaSEsbcn,48,3,1,4,0.490291,0.599841,0,"#008ebb"
889240064,jcyl,48,4,0,4,0.177346,0.564693,0,"#008ebb"
891007807,cruzmosu,10,6,1,7,0.321687,0.43969,0.001461,"#00ed5d"
891048242,m4bcn,48,4,8,12,0.510764,0.55104,0.003897,"#008ebb"
892852525,FILTRADCOMUV,15,3,3,6,0.563227,0.377786,0.000974,"#006032"
899489707,montse_rius,22,0,4,4,0.374058,0.583081,0,"#ff0d69"
899506260,CharlotteBRF,46,0,4,4,0.435287,0.534485,0,"#ffb800"
901407079,OndareBabesa,48,6,3,9,0.505697,0.669486,0.002435,"#008ebb"
903460076,Lirita_D,0,0,5,5,0.39592,0.496491,0.000487,"#ff0d69"
903628440,latermicamlg,15,8,1,9,0.475859,0.545503,0.002435,"#ff0d69"
904240039,GuadalupChvez,12,0,9,9,0.39678,0.416243,0.002435,"#ff77ff"
910902972,Julinarito,28,0,6,6,0.407429,0.583558,0.000974,"#8ecfec"
913447502,NewLeftReview,15,6,0,6,0.485389,0.405899,0.000974,"#006032"
915750098,Cerlalc,1,6,1,7,0.412219,0.693564,0.001461,"#008ebb"
917010000,sk_serge,39,13,7,20,0.381604,0.216439,0.007793,"#00e8b2"
917687792,emilioleton,46,0,45,45,0.447715,0.557622,0.019971,"#ffb800"
919853820,EContraonce,46,0,4,4,0.335141,0.556795,0,"#3bec00"
920050484,DHandLib,0,12,3,15,0.318615,0.408397,0.005358,"#3e93ff"
920401824,jcaacostamacia,12,0,13,13,0.400206,0.441387,0.004384,"#ff77ff"
923083543,juanrasmt,50,9,5,14,0.632923,0.451172,0.004871,"#008bdd"
923407154,AniKullock,46,0,5,5,0.297303,0.535839,0.000487,"#3bec00"
926072288,AMacharowski,15,0,4,4,0.531145,0.498547,0,"#006032"
929826847,jeduardogonz,0,18,46,64,0.375936,0.477112,0.029226,"#3e93ff"
929832451,EnvejecerCSIC,48,2,4,6,0.499042,0.463527,0.000974,"#ff0d69"
929859709,CSocialesPUJ,36,6,6,12,0.464,0.392822,0.003897,"#6c241e"
932747438,ps_tadler,49,0,4,4,0.307327,0.510642,0,"#3bec00"
933035688,ledithvet2012,0,0,4,4,0.319384,0.408237,0,"#3e93ff"
935150407,donbelfiore,46,0,5,5,0.380607,0.631921,0.000487,"#8ecfec"
936961322,walshbr,12,34,26,60,0.361861,0.445128,0.027277,"#ff77ff"
937463240,HDigitais,0,25,2,27,0.420635,0.458327,0.011203,"#3e93ff"
937669512,velmolan,48,3,5,8,0.575034,0.630689,0.001948,"#ffb800"
939265982,PatrimonioMscal,22,2,2,4,0.48956,0.790748,0,"#8ecfec"
939505560,valle_arroyo,37,0,18,18,0.475901,0.592585,0.006819,"#fcae7e"
940592857,guadalupeecheg1,15,1,5,6,0.466556,0.475092,0.000974,"#006032"
941514565,AgoraAbierta,28,1,6,7,0.509264,0.591719,0.001461,"#8ecfec"
943646011,UTEoficial,36,4,1,5,0.475033,0.80213,0.000487,"#008ebb"
946659818,revistaHCSM,39,17,12,29,0.434725,0.324338,0.012177,"#00e8b2"
946965716,professorcaz,0,14,2,16,0.314329,0.436341,0.005845,"#3bec00"
948243710,HxxxKxxx,15,0,6,6,0.487113,0.471045,0.000974,"#ff0d69"
951363271,PedroBtz,48,6,3,9,0.233602,0.737244,0.002435,"#008ebb"
951578352,IELTFCSHUNL,39,8,6,14,0.426303,0.427271,0.004871,"#00e8b2"
951767720,IncipitCSIC,49,40,13,53,0.415658,0.521416,0.023867,"#ff0d69"
953595966,moisomedrano,19,0,6,6,0.448862,0.455692,0.000974,"#00ed5d"
954437468,elmemorioso06,19,0,4,4,0.434982,0.430889,0,"#00ed5d"
956321100,PaolaBe2,0,0,21,21,0.414375,0.494827,0.008281,"#ff0d69"
957509173,JMFradeRue,46,107,62,169,0.3897,0.527526,0.08037,"#ffb800"
957892608,javisanz_pub,48,0,4,4,0.503225,0.596779,0,"#ffb800"
958218955,ligaincom,1,3,2,5,0.334338,0.530978,0.000487,"#8ecfec"
958324482,fadu_udelar,54,4,5,9,0.595803,0.67414,0.002435,"#c6cc85"
960752922,Exprespol,21,9,3,12,0.571829,0.775092,0.003897,"#ffa64e"
961205156,CienciasUAndes,36,3,1,4,0.564372,0.335206,0,"#00e8b2"
963318692,Mich_Crosashe,26,0,4,4,0.401603,0.373255,0,"#3e93ff"
965099960,mariela_fargas,19,0,8,8,0.467368,0.513672,0.001948,"#008ebb"
965996816,PCDig,15,5,14,19,0.452169,0.513677,0.007306,"#ff0d69"
966137557,miriadax,1,3,1,4,0.267131,0.580379,0,"#825403"
966422798,Fabio_Ciotti,0,5,13,18,0.406162,0.494166,0.006819,"#3e93ff"
968383999,rebiun,48,12,2,14,0.444251,0.618642,0.004871,"#3e93ff"
968987166,CarmenMdlR,1,7,7,14,0.357534,0.577534,0.004871,"#825403"
970578068,IsaSolisA,46,1,5,6,0.429303,0.594713,0.000974,"#ffb800"
970731607,hdpaulspence,46,106,149,255,0.413955,0.516454,0.12226,"#ffb800"
972028076,ManelMarquezB,21,5,1,6,0.574876,0.652896,0.000974,"#ffa64e"
978765787,lacomunapresxs,21,1,5,6,0.577134,0.696134,0.000974,"#ffa64e"
978869258,SEECGalicia,37,5,3,8,0.702165,0.556531,0.001948,"#ffb800"
981602611,dhawards,12,40,2,42,0.382204,0.478809,0.018509,"#ff77ff"
986178732,IC_Milan,22,22,2,24,0.362138,0.647,0.009742,"#8ecfec"
986525696,BibliotecaUCH,15,2,7,9,0.550027,0.436779,0.002435,"#006032"
987323496,marianacmalta,46,6,1,7,0.389524,0.552802,0.001461,"#ffb800"
989366766,BibliotecaPeru,15,10,0,10,0.535719,0.534917,0.002923,"#ff0d69"
990057500,filosdie,5,0,4,4,0.357256,0.313744,0,"#ff9b8f"
990571825,maateusreboucas,39,3,3,6,0.381001,0.378638,0.000974,"#00e8b2"
991082047,Carmina_Banana,48,19,0,19,0.409117,0.543027,0.007306,"#008ebb"
992977134,PlatInvestUCM,46,16,21,37,0.38833,0.56338,0.016074,"#ffb800"
993013477,cgironella2005,54,0,6,6,0.612451,0.669345,0.000974,"#c6cc85"
993170330,Transmediaz,15,2,3,5,0.560516,0.528426,0.000487,"#006032"
993463788,caprichodegaudi,48,2,2,4,0.521531,0.735328,0,"#008ebb"
994087574,MGG_2012,27,0,4,4,0.926717,0.190809,0,"#00ed5d"
995660179,Genealogistapro,48,1,3,4,0.489106,0.493947,0,"#008ebb"
997507184,AChasAguion,0,0,5,5,0.444254,0.477977,0.000487,"#ff0d69"
1003655713,FilosofiaUab,48,4,1,5,0.511917,0.451339,0.000487,"#ff0d69"
1006066214,abaraibar_griso,15,4,0,4,0.463475,0.550326,0,"#006032"
1006310448,MariaSaavedraI,1,0,5,5,0.476652,0.578565,0.000487,"#ff12a3"
1006439485,FyL_UVa,46,2,2,4,0.395003,0.591432,0,"#ffb800"
1007311039,ufbaempauta,39,5,0,5,0.428531,0.348272,0.000487,"#00e8b2"
1007833548,Germnhernndez16,0,0,7,7,0.406048,0.381524,0.001461,"#3e93ff"
1008786625,teliarte,15,0,4,4,0.504055,0.508144,0,"#ff0d69"
1016210628,InesLoustalet,46,3,7,10,0.441398,0.468532,0.002923,"#ffb800"
1016379564,ComunicolocosOK,1,5,1,6,0.361028,0.5552,0.000974,"#825403"
1017429942,DOAJplus,0,22,0,22,0.353745,0.473113,0.008768,"#3bec00"
1017461527,PFDorado,46,41,53,94,0.458181,0.460792,0.043838,"#ffb800"
1017749293,arteceha,15,16,3,19,0.381271,0.581317,0.007306,"#ff0d69"
1022299404,LancasterHistor,10,6,4,10,0.376574,0.444506,0.002923,"#00ed5d"
1024022088,GUNi_net,14,5,0,5,0.572161,0.320812,0.000487,"#b6cb00"
1027226198,GlobalOutlookDH,0,19,29,48,0.380759,0.464569,0.021432,"#3e93ff"
1031606828,NoraCBenedict,0,2,12,14,0.375986,0.471686,0.004871,"#3e93ff"
1046013672,monjardin4,1,0,6,6,0.539242,0.487684,0.000974,"#ff12a3"
1046186232,RLaconica,12,0,6,6,0.425846,0.352518,0.000974,"#ff77ff"
1051649960,Fabriciosx,1,0,4,4,0.387577,0.40379,0,"#825403"
1054595136,GBA_8,39,0,9,9,0.421759,0.563671,0.002435,"#ffb800"
1055028001,onavcia,15,0,6,6,0.523408,0.551681,0.000974,"#006032"
1056717649,OpenRefine,12,5,3,8,0.342023,0.492539,0.001948,"#ff77ff"
1057923606,Vicent_Spain,15,0,10,10,0.469824,0.503967,0.002923,"#006032"
1059125119,Jeares25,12,0,4,4,0.366374,0.5115,0,"#ff77ff"
1059501980,catmuno,12,3,3,6,0.401477,0.413364,0.000974,"#ff77ff"
1061250102,angcastineira,14,5,0,5,0.589381,0.316893,0.000487,"#b6cb00"
1061340487,CulturaMural,0,3,2,5,0.297456,0.421325,0.000487,"#00ed5d"
1063107253,fcallejah,0,0,6,6,0.471394,0.515939,0.000974,"#ff0d69"
1063443012,emmanuelrog,15,6,0,6,0.492399,0.402872,0.000974,"#006032"
1067149758,CitlaliRDaz,35,0,4,4,0.27814,0.398577,0,"#c42c63"
1067580330,kgeographer,15,21,0,21,0.463176,0.48299,0.008281,"#006032"
1070798593,coddii_org,48,8,1,9,0.55126,0.498368,0.002435,"#ff0d69"
1071738924,GzRobertoj,48,14,15,29,0.476114,0.573609,0.012177,"#008ebb"
1071925273,steelyeyedman,0,2,4,6,0.341109,0.514422,0.000974,"#3e93ff"
1075106924,RNBPColombia,19,3,8,11,0.47908,0.409116,0.00341,"#00ed5d"
1076441989,JosepMVilalta,14,19,2,21,0.537546,0.347129,0.008281,"#b6cb00"
1083109112,criticmarkup,46,4,0,4,0.390132,0.509741,0,"#ffb800"
1084969592,_IsraelR_,0,19,62,81,0.375693,0.461093,0.037506,"#3e93ff"
1086325934,UHertshistory,12,4,4,8,0.373105,0.395832,0.001948,"#ff77ff"
1088868666,rgomezusal,28,19,8,27,0.398942,0.594876,0.011203,"#8ecfec"
1095670098,openlibhums,46,3,5,8,0.352445,0.494924,0.001948,"#3bec00"
1098193076,MdscaUma,15,11,13,24,0.495345,0.521104,0.009742,"#ff0d69"
1098578059,csyhUASLP,12,3,3,6,0.358008,0.399831,0.000974,"#ff77ff"
1107405570,rbaenamolina,49,0,4,4,0.550601,0.484962,0,"#8ecfec"
1115049577,LingRomUVa,46,3,4,7,0.344739,0.505709,0.001461,"#ffb800"
1117505534,casadevelazquez,49,21,4,25,0.484931,0.479376,0.010229,"#3bec00"
1117790442,patrick_sahle,46,4,0,4,0.327861,0.554534,0,"#3bec00"
1119269594,c_llamas_saiz,49,0,16,16,0.45774,0.515934,0.005845,"#ffa64e"
1125796202,ale_ulla,25,90,44,134,0.372729,0.509432,0.063322,"#ff0d69"
1131275857,CCP_org,12,0,4,4,0.262388,0.411016,0,"#ff77ff"
1131460195,UNIRalumni,25,3,3,6,0.313264,0.577229,0.000974,"#ff0d69"
1135342201,nosolosig,48,6,3,9,0.420051,0.594477,0.002435,"#008ebb"
1139113136,univpaulvalery,19,11,4,15,0.625869,0.650821,0.005358,"#5456a6"
1139244198,marcialpons,48,5,6,11,0.43436,0.586438,0.00341,"#008ebb"
1139547961,FFilologiaUS,22,61,29,90,0.367303,0.580119,0.04189,"#8ecfec"
1139983052,SaSoeurJuliette,46,5,13,18,0.395591,0.516359,0.006819,"#ffb800"
1140887592,lpnunez,48,5,17,22,0.412305,0.519969,0.008768,"#008ebb"
1142871446,AneliseHShrout,12,2,6,8,0.298687,0.439581,0.001948,"#ff77ff"
1147073311,amado_mila,19,0,4,4,0.489972,0.383776,0,"#00ed5d"
1150636140,jpmoragu,22,2,7,9,0.356452,0.572864,0.002435,"#8ecfec"
1151069941,IRHT_CNRS,0,5,0,5,0.450011,0.513054,0.000487,"#ff0d69"
1152031118,CALED12,17,5,2,7,0.382036,0.540335,0.001461,"#3e93ff"
1153622263,Huma_Num,46,19,6,25,0.377542,0.570774,0.010229,"#3bec00"
1154916386,nimlothdecuba,46,5,12,17,0.28688,0.428157,0.006332,"#3bec00"
1169539512,edullobil,48,3,3,6,0.425605,0.661743,0.000974,"#8ecfec"
1169835889,Beizana,28,0,5,5,0.394367,0.689672,0.000487,"#8ecfec"
1170364291,IMRyTv_Morelos,0,5,2,7,0.332723,0.367846,0.001461,"#3e93ff"
1170404948,ADHOrg,0,209,54,263,0.357524,0.472903,0.126157,"#ffb800"
1172871680,bibliotequesUAB,48,6,0,6,0.504029,0.543253,0.000974,"#ff0d69"
1175382716,HagaselaluzRE,48,3,5,8,0.526984,0.939453,0.001948,"#008ebb"
1176099517,SEEC_nacional,37,4,8,12,0.602882,0.504871,0.003897,"#ffb800"
1190315210,GPSalmeron,46,5,2,7,0.405364,0.579661,0.001461,"#3bec00"
1192052760,ffreff,39,1,10,11,0.3311,0.404906,0.00341,"#3bec00"
1192958954,HelderJMendes,39,2,3,5,0.476706,0.426788,0.000487,"#00e8b2"
1198269571,Letrasqueescrib,46,13,149,162,0.413097,0.538,0.076961,"#ffb800"
1198790294,alopezh2,0,0,5,5,0.44263,0.502078,0.000487,"#3e93ff"
1203301975,largocaballerof,21,1,13,14,0.559261,0.725515,0.004871,"#ffa64e"
1203827234,LletresUAB,0,12,4,16,0.440194,0.515791,0.005845,"#ff0d69"
1205470920,SeminarioHD,0,54,21,75,0.389217,0.462084,0.034584,"#3e93ff"
1210473931,nycdh,39,5,0,5,0.376427,0.370757,0.000487,"#00e8b2"
1217118984,leofn3,39,55,97,152,0.417296,0.365999,0.07209,"#00e8b2"
1219912194,antumeneses,46,0,7,7,0.378092,0.5658,0.001461,"#3bec00"
1222308966,CLARINERIC,46,27,0,27,0.386492,0.505453,0.011203,"#ffb800"
1222588086,FHCE_Udelar,54,56,13,69,0.570445,0.635801,0.031661,"#c6cc85"
1227185100,iatext,37,34,22,56,0.454442,0.556059,0.025329,"#ffb800"
1227942865,ProsumidorSoc,15,14,41,55,0.464109,0.51848,0.024842,"#006032"
1229540822,espanolURV,22,1,3,4,0.313532,0.689689,0,"#8ecfec"
1229689958,MArchivstica,37,3,6,9,0.453851,0.45871,0.002435,"#fcae7e"
1240858034,alba_ambros,15,14,11,25,0.408444,0.537621,0.010229,"#006032"
1242342626,artecompacto,50,0,4,4,0.650532,0.431528,0,"#008bdd"
1243783518,belikesoftware,0,4,0,4,0.35987,0.529896,0,"#3e93ff"
1244112038,estelasolis14,46,2,2,4,0.33389,0.582861,0,"#3bec00"
1247619824,DamonCrockett,0,0,5,5,0.360658,0.492482,0.000487,"#ffb800"
1248577753,jpinod02,15,33,71,104,0.457437,0.488377,0.048709,"#ff0d69"
1249074060,Montistyle,48,0,6,6,0.455323,0.516052,0.000974,"#ffb800"
1251549229,javierjg333,25,53,39,92,0.374735,0.520257,0.042864,"#ff0d69"
1254437756,eadanm,36,3,16,19,0.560892,0.306336,0.007306,"#00e8b2"
1259306508,AJoffres,46,3,16,19,0.371652,0.518252,0.007306,"#3bec00"
1259395213,HumanitatsUPF,48,4,3,7,0.499598,0.597647,0.001461,"#008ebb"
1266612385,agbenito,39,5,3,8,0.685613,0.466223,0.001948,"#00e8b2"
1266896785,PeriodismoULL,48,6,1,7,0.490287,0.660679,0.001461,"#008ebb"
1272573150,ImpressoesRbds,39,17,0,17,0.408826,0.273686,0.006332,"#00e8b2"
1277200513,nvallejog,19,9,18,27,0.610171,0.714603,0.011203,"#5456a6"
1278128527,recheverria15,17,2,2,4,0.341294,0.538053,0,"#3e93ff"
1278418008,JM_Morata,46,4,0,4,0.463486,0.571783,0,"#ffb800"
1278630271,YosoyelAfo,19,1,6,7,0.282444,0.369901,0.001461,"#00ed5d"
1282969902,TEEMConference,49,6,4,10,0.421954,0.495952,0.002923,"#ff0d69"
1283589494,UOCinfocom,15,0,4,4,0.456134,0.554175,0,"#ff0d69"
1286532732,TROVADORDIGITAL,19,1,3,4,0.644309,0.528309,0,"#00ed5d"
1286665722,PsgMx,46,0,4,4,0.446986,0.573656,0,"#ffb800"
1286800148,AlvaroCuellarDH,25,39,19,58,0.392459,0.563033,0.026303,"#ff0d69"
1288551986,CarmenEspejoC,0,1,17,18,0.466422,0.523441,0.006819,"#ff0d69"
1298715679,Bibtntcsic,48,72,77,149,0.431953,0.538306,0.070628,"#008ebb"
1300033016,pepicapdevila,15,0,6,6,0.455804,0.502828,0.000974,"#ff0d69"
1305495408,scabrerahanna,12,0,9,9,0.350132,0.452301,0.002435,"#ff77ff"
1308969534,dtracy2,0,0,4,4,0.345359,0.43526,0,"#3e93ff"
1314364669,simone_fari,15,0,4,4,0.510487,0.507474,0,"#ff0d69"
1314459104,RafaMayoGarcia,46,0,4,4,0.31685,0.500085,0,"#3bec00"
1316404598,iambrandao,46,0,4,4,0.316732,0.504044,0,"#3bec00"
1319164070,CCuruguay,54,19,7,26,0.512917,0.618709,0.010716,"#c6cc85"
1319230088,clarasil44,46,2,3,5,0.401424,0.651509,0.000487,"#ffb800"
1321865468,fundacion1mayo,21,7,0,7,0.564888,0.759877,0.001461,"#ffa64e"
1322280522,espacioRH,15,1,4,5,0.520713,0.545895,0.000487,"#006032"
1322976715,eduard_arriaga,0,11,24,35,0.385474,0.446985,0.0151,"#3e93ff"
1324383199,PremiosCLAP,48,3,2,5,0.448828,0.620872,0.000487,"#008ebb"
1325449124,ErnestoConta,46,0,4,4,0.331351,0.558921,0,"#3bec00"
1325514038,idaesoficial,36,32,1,33,0.195713,0.462815,0.014126,"#403538"
1326770444,ClausenZ,26,0,4,4,0.328058,0.378174,0,"#3e93ff"
1331233394,MartinezLab,49,1,14,15,0.453271,0.511128,0.005358,"#ff0d69"
1337800226,lgentoatahona,46,1,4,5,0.477016,0.520639,0.000487,"#ffb800"
1338243680,ursulacamba,12,12,0,12,0.370241,0.237411,0.003897,"#3e93ff"
1340721872,DeMareDani,46,4,17,21,0.376297,0.530048,0.008281,"#3bec00"
1341462944,paoloigna1,15,0,6,6,0.547465,0.509497,0.000974,"#ff0d69"
1341697015,bibrepublica,1,4,2,6,0.370846,0.732469,0.000974,"#825403"
1344804456,ecmsilva,19,0,4,4,0.42229,0.432353,0,"#00ed5d"
1345328142,GemaWebsoc,46,1,28,29,0.442478,0.514863,0.012177,"#3e93ff"
1346503532,EnginyeriaUAB,48,5,3,8,0.452017,0.493349,0.001948,"#ff0d69"
1348481329,cgruiz1,22,0,4,4,0.360158,0.596672,0,"#8ecfec"
1348828734,cojoidea,15,1,8,9,0.433372,0.503794,0.002435,"#ff0d69"
1355203866,true_mxp,0,0,5,5,0.362875,0.506112,0.000487,"#3e93ff"
1355363725,Reciaria,46,3,85,88,0.365416,0.55385,0.040916,"#3bec00"
1356382472,aragar2013,28,0,5,5,0.412385,0.603229,0.000487,"#8ecfec"
1357953271,DFEspanyola,0,3,9,12,0.397096,0.561236,0.003897,"#ff0d69"
1367325420,fidosigueaqui,48,0,7,7,0.455036,0.471738,0.001461,"#008ebb"
1371593546,AJIHLE1,22,2,11,13,0.392472,0.578061,0.004384,"#8ecfec"
1378967467,CamDigHum,0,9,5,14,0.389659,0.488661,0.004871,"#3e93ff"
1381786129,AEDOM_IAML,48,5,6,11,0.198172,0.589016,0.00341,"#ff0d69"
1382216684,juliocvizcarra,15,0,4,4,0.421254,0.554515,0,"#006032"
1382327035,Andresk0224,0,2,3,5,0.474586,0.516353,0.000487,"#3e93ff"
1382448254,rtorres_javier,37,0,10,10,0.485283,0.625648,0.002923,"#fcae7e"
1386426673,antonioortizma2,21,6,6,12,0.573361,0.793523,0.003897,"#ffa64e"
1387915232,Elijah_Meeks,15,19,0,19,0.471989,0.485471,0.007306,"#006032"
1393041685,pzalamea,12,50,21,71,0.477207,0.365301,0.032635,"#ff77ff"
1393781958,KafSofit,0,0,4,4,0.298451,0.421564,0,"#3e93ff"
1403186119,CCISIC,15,0,10,10,0.466038,0.508852,0.002923,"#006032"
1404531452,jorgecarrion21,50,17,2,19,0.656876,0.607588,0.007306,"#ffb800"
1405262366,HistoriaMujeres,21,5,0,5,0.557014,0.768757,0.000487,"#ffa64e"
1407376640,UCAM_Investiga,48,11,2,13,0.459518,0.477621,0.004384,"#ff0d69"
1409619716,EDITORIALUS,22,5,1,6,0.334951,0.653508,0.000974,"#8ecfec"
1410036919,CEI_E3,48,4,1,5,0.567868,0.472039,0.000487,"#ff0d69"
1413886358,onGranadaTC,15,0,4,4,0.54684,0.535639,0,"#006032"
1416737262,soccerbrarian,12,0,9,9,0.23663,0.398304,0.002435,"#00e8b2"
1417666956,humdigital,46,69,187,256,0.414188,0.529939,0.122747,"#ffb800"
1417891736,RocioDiazBravo,15,2,4,6,0.370288,0.543583,0.000974,"#3bec00"
1421172834,UWuttke,46,0,4,4,0.31463,0.48445,0,"#3bec00"
1425598472,BiblioUNEDTalav,46,1,4,5,0.401283,0.532687,0.000487,"#ffb800"
1425730074,usalcampuspilar,36,0,5,5,0.297698,0.560041,0.000487,"#00e8b2"
1427070265,AleJuarezA,26,0,5,5,0.335167,0.371633,0.000487,"#3e93ff"
1427460212,ANECAinfo,15,5,0,5,0.60663,0.563788,0.000487,"#ffb800"
1430632962,historiaceu,1,7,4,11,0.432094,0.547414,0.00341,"#ff12a3"
1431800994,gonzlaur,35,5,7,12,0.368888,0.427097,0.003897,"#c42c63"
1432795423,Laura_arreaza,19,0,5,5,0.430674,0.412588,0.000487,"#00ed5d"
1434359630,gimenadelr,46,568,345,913,0.352378,0.507695,0.442767,"#3bec00"
1435358221,DominiqueVinck,25,8,0,8,0.424329,0.661411,0.001948,"#ff0d69"
1442258528,Claire_Taylor_M,19,1,3,4,0.325954,0.342287,0,"#00ed5d"
1443790717,INNOVASalamanca,46,5,4,9,0.407514,0.578971,0.002435,"#ffb800"
1449354402,mtorayam,19,0,5,5,0.451763,0.499291,0.000487,"#00ed5d"
1449389725,eatm_escola,14,1,3,4,0.611385,0.316009,0,"#b6cb00"
1451522498,Silvinacasab,46,8,3,11,0.642161,0.75968,0.00341,"#00a04a"
1461763134,cristina_azorin,48,6,15,21,0.515169,0.525214,0.008281,"#ff0d69"
1462609603,RojasCastroA,12,116,0,116,0.386677,0.488058,0.054554,"#ff77ff"
1463170988,ccii_pucp,46,11,7,18,0.366139,0.493909,0.006819,"#3bec00"
1463347147,paoferreiray,10,0,4,4,0.234159,0.440385,0,"#3bec00"
1465608511,SanzBrb,12,0,4,4,0.394106,0.400307,0,"#ff77ff"
1466978593,MuseoAlmeria,1,41,5,46,0.599909,0.638077,0.020458,"#ff12a3"
1467763650,metahistoriacom,1,3,4,7,0.503665,0.541503,0.001461,"#ff12a3"
1468235288,TiberioUned,46,0,5,5,0.449587,0.586397,0.000487,"#ffb800"
1470808525,chrisferock,0,0,4,4,0.32893,0.453075,0,"#3e93ff"
1473434310,Amo_elCafe,0,47,30,77,0.367667,0.409371,0.035558,"#3e93ff"
1483166647,Thesaurarius,48,87,10,97,0.351138,0.564672,0.0453,"#008ebb"
1488375698,HDHispanicas,0,458,151,609,0.422841,0.497557,0.294691,"#ff0d69"
1493184920,daltonr8,54,0,4,4,0.619238,0.659198,0,"#c6cc85"
1495222837,rubendecu,46,0,4,4,0.437108,0.596726,0,"#ffb800"
1497712388,CuadernodeLuis,49,0,6,6,0.449987,0.674384,0.000974,"#ff0d69"
1511334488,psicoudelar,54,14,4,18,0.607593,0.657851,0.006819,"#c6cc85"
1513437702,Tracy_Jentzsch,39,1,31,32,0.343065,0.337,0.013639,"#00e8b2"
1513789068,UniversidadCEU,35,5,0,5,0.340132,0.748486,0.000487,"#c42c63"
1514921120,anamandujano_,12,1,3,4,0.371396,0.41295,0,"#ff77ff"
1516955634,clionauta_ap,19,75,35,110,0.44699,0.490382,0.051632,"#00ed5d"
1523270480,lsmntr,48,4,0,4,0.460364,0.562858,0,"#008ebb"
1525149109,CarmenMamelita,46,0,5,5,0.450019,0.577109,0.000487,"#ffb800"
1526219378,gtmorals,12,0,8,8,0.271015,0.403542,0.001948,"#ff77ff"
1527367620,PlataformaCTI,14,5,0,5,0.584539,0.266544,0.000487,"#b6cb00"
1529994234,LAURASolete123,48,8,4,12,0.408962,0.60546,0.003897,"#ffb800"
1534703461,profenuria,46,0,5,5,0.350647,0.599501,0.000487,"#ffb800"
1536665708,barbalhofernand,39,5,10,15,0.403294,0.342255,0.005358,"#00e8b2"
1541399594,jagueda1,15,0,5,5,0.474287,0.531349,0.000487,"#006032"
1543164858,cyanolimnas,46,0,6,6,0.380662,0.602888,0.000974,"#ffb800"
1543540196,FerlaLuis,39,3,3,6,0.384476,0.397999,0.000974,"#3bec00"
1545314329,BarcelonaLab,48,0,4,4,0.400523,0.540493,0,"#008ebb"
1546308840,VeremundoC,0,0,5,5,0.251156,0.32374,0.000487,"#00ed5d"
1546541138,BC_UNSAM,48,2,4,6,0.363505,0.61851,0.000974,"#3bec00"
1547855347,CiteFactor,0,28,0,28,0.381349,0.473943,0.01169,"#3e93ff"
1548791382,UOCbiblioteca,15,33,26,59,0.470761,0.539172,0.02679,"#ff0d69"
1549209552,jacomyma,39,6,0,6,0.3773,0.292251,0.000974,"#00e8b2"
1549435944,glletic,35,1,4,5,0.305104,0.450338,0.000487,"#c42c63"
1549476308,ameliamunozb,46,2,21,23,0.413666,0.512413,0.009255,"#ffb800"
1550686328,celTatis,46,1,5,6,0.404429,0.55264,0.000974,"#3bec00"
1563291032,edirom,48,5,2,7,0.762013,0.404253,0.001461,"#006032"
1565465358,Proyecto_Bieses,46,53,20,73,0.465846,0.554542,0.033609,"#ffb800"
1566185168,UniandesDerecho,12,5,3,8,0.510759,0.32529,0.001948,"#ff77ff"
1569493393,biblioantonia,46,4,1,5,0.393072,0.524867,0.000487,"#3bec00"
1575397346,Rochi_Saiyajin,0,0,40,40,0.464516,0.52409,0.017535,"#ffb800"
1578442585,artismusa,15,9,31,40,0.42932,0.507948,0.017535,"#ffb800"
1581292279,carvajalregidor,12,1,3,4,0.308393,0.427433,0,"#ff77ff"
1582564051,bibliotecaUAL,28,10,3,13,0.423719,0.65259,0.004384,"#006032"
1586869063,mariafdezruiz,15,9,2,11,0.235758,0.44942,0.00341,"#ff0d69"
1587053922,npenasueiro,0,32,107,139,0.42453,0.509924,0.065757,"#ff0d69"
1588154118,LetrasUma,15,41,16,57,0.501788,0.504878,0.025816,"#ff0d69"
1593961730,comunidad_istec,46,6,11,17,0.339017,0.534595,0.006332,"#3bec00"
1594520179,libraryleaks,0,1,4,5,0.364241,0.520145,0.000487,"#3e93ff"
1595679444,NaturgyFnd,14,2,3,5,0.591801,0.269355,0.000487,"#b6cb00"
1598324696,DH_FBK,0,1,12,13,0.401779,0.468611,0.004384,"#ffb800"
1602355802,jorv1121,46,14,3,17,0.346293,0.623628,0.006332,"#3bec00"
1612763167,AnimaLectura,46,8,15,23,0.447589,0.53763,0.009255,"#ffb800"
1615512858,ViejasLectoras,19,0,5,5,0.451548,0.391723,0.000487,"#00ed5d"
1621344962,ArtLibJournal,0,0,4,4,0.338063,0.411972,0,"#3e93ff"
1621374198,KathyHartWeimer,12,0,6,6,0.348259,0.442334,0.000974,"#ff77ff"
1622519646,UniValencia,15,9,0,9,0.484956,0.515426,0.002435,"#ff0d69"
1624241750,su_silvina,46,4,0,4,0.325195,0.575057,0,"#3bec00"
1629790608,Masterup_UCA,15,2,3,5,0.464724,0.585018,0.000487,"#ffb800"
1636590253,tim_cook,46,4,0,4,0.330992,0.642283,0,"#3bec00"
1637434778,MakDigHist,46,0,4,4,0.368841,0.522212,0,"#ffb800"
1638695353,JosueRM320,26,0,4,4,0.31689,0.362311,0,"#3e93ff"
1638948078,NoheMillan,54,0,4,4,0.577837,0.590825,0,"#c6cc85"
1639352005,IBICTbr,39,25,2,27,0.41864,0.321477,0.011203,"#00e8b2"
1639947949,pat_inteligente,46,3,1,4,0.340834,0.56014,0,"#3bec00"
1641252577,UNLModLang,12,4,3,7,0.312881,0.452503,0.001461,"#ff77ff"
1641532076,traductoresHD,0,1,6,7,0.374265,0.547265,0.001461,"#ff0d69"
1646623290,R_RodrigoRoy,0,0,5,5,0.395699,0.477213,0.000487,"#3e93ff"
1647100686,terricolesbtv,14,8,0,8,0.54881,0.272154,0.001948,"#b6cb00"
1652416692,framospalencia,22,2,3,5,0.352159,0.557127,0.000487,"#8ecfec"
1658740566,UMETbiblioteca,46,10,18,28,0.375182,0.538222,0.01169,"#3bec00"
1661175252,4srdiego,46,9,6,15,0.362367,0.505328,0.005358,"#3bec00"
1670475145,scielomexico,0,16,28,44,0.380989,0.426909,0.019484,"#3e93ff"
1671411253,inesolza,49,0,7,7,0.516022,0.487471,0.001461,"#8ecfec"
1684181748,GeoHum_SIG,54,7,14,21,0.417373,0.473335,0.008281,"#ffb800"
1684793785,gumartinezz,17,1,3,4,0.34533,0.624299,0,"#3bec00"
1687213934,elplancnet,54,0,5,5,0.416329,0.507773,0.000487,"#3bec00"
1688883667,yale_dhwg,46,0,8,8,0.39071,0.505052,0.001948,"#ffb800"
1699608505,AngevinKandy,48,1,3,4,0.464205,0.564188,0,"#008ebb"
1700982726,isumaepg,12,0,8,8,0.394655,0.410781,0.001948,"#ff77ff"
1704935276,BigData_Machine,46,13,3,16,0.36486,0.563906,0.005845,"#3bec00"
1705539680,BibliotecasRBJ,46,4,76,80,0.363332,0.559705,0.037019,"#3bec00"
1706801244,melchorsm,0,5,3,8,0.432264,0.448567,0.001948,"#3e93ff"
1707052416,ICS_unav,46,4,5,9,0.524604,0.566211,0.002435,"#ffb800"
1707338683,Ce_AQUA,21,0,5,5,0.568574,0.693186,0.000487,"#ffa64e"
1707822566,Teachlr,50,4,2,6,0.671075,0.363037,0.000974,"#008bdd"
1710581694,DE_TIC_A,26,0,4,4,0.327845,0.382743,0,"#3e93ff"
1712010084,am_cuaresma,22,13,26,39,0.407296,0.524387,0.017048,"#8ecfec"
1721874307,AA_1mayo,21,6,6,12,0.577647,0.793226,0.003897,"#ffa64e"
1724553624,XLSalvador,1,0,16,16,0.450834,0.538402,0.005845,"#825403"
1728486997,PrensaUNIR,25,13,5,18,0.351924,0.573512,0.006819,"#ff0d69"
1728604734,didpatri,48,4,2,6,0.455972,0.676839,0.000974,"#008ebb"
1737960920,CiberlawyerA,15,0,4,4,0.477991,0.551631,0,"#006032"
1830717019,beurruti,15,13,4,17,0.523317,0.533876,0.006332,"#006032"
1851393025,HangoutON,15,4,5,9,0.452999,0.49362,0.002435,"#006032"
1854809810,virsedamarta,48,10,2,12,0.439934,0.506167,0.003897,"#008ebb"
1855362589,randaelka,46,1,3,4,0.45177,0.424216,0,"#ffb800"
1858327705,inguniandes,12,6,2,8,0.511039,0.380059,0.001948,"#ff77ff"
1858744802,FranMMarBla,12,1,11,12,0.414574,0.461074,0.003897,"#ff77ff"
1869654667,yoko_nh,46,26,7,33,0.349528,0.508487,0.014126,"#3bec00"
1871217757,7rondo,21,6,0,6,0.568844,0.795873,0.000974,"#ffa64e"
1871931842,AnaPlanet1,49,1,6,7,0.466059,0.499997,0.001461,"#ffa64e"
1875141326,ccss_usal,48,5,0,5,0.467229,0.595322,0.000487,"#008ebb"
1878886411,DARIAHde,46,10,0,10,0.416279,0.512546,0.002923,"#ffb800"
1881687991,PeruMira,46,3,2,5,0.366697,0.574291,0.000487,"#ffb800"
1886602513,HectorVillarri,0,0,6,6,0.358814,0.41184,0.000974,"#3e93ff"
1887639126,ceciroz,1,0,7,7,0.427894,0.52939,0.001461,"#825403"
1892212711,c_fulanito_West,12,0,4,4,0.415959,0.384374,0,"#ff77ff"
1894132141,EthnoArchaeon,48,4,0,4,0.348215,0.590396,0,"#3bec00"
1896407568,okfnedu,46,4,5,9,0.406082,0.553861,0.002435,"#3bec00"
1896609324,CapelGonzalez,14,4,16,20,0.567461,0.292352,0.007793,"#b6cb00"
1901655595,CCeHum,46,1,3,4,0.336775,0.538329,0,"#3bec00"
1907614836,estocastica,39,0,4,4,0.425574,0.15183,0,"#00e8b2"
1909126262,aldomanucio,49,7,17,24,0.466525,0.405901,0.009742,"#ff0d69"
1909584397,trishaoconnor88,49,8,12,20,0.307096,0.470111,0.007793,"#3bec00"
1912438093,Cariver2Carla,0,0,6,6,0.372792,0.465504,0.000974,"#3e93ff"
1924190935,globitohuracan,46,4,0,4,0.304013,0.595379,0,"#3bec00"
1926147684,ICFS_UAM,49,4,2,6,0.384517,0.636442,0.000974,"#ffa64e"
1932513894,dolofleitas,46,1,3,4,0.349722,0.576381,0,"#3bec00"
1934268980,fepem1,17,2,3,5,0.024897,0.569735,0.000487,"#825403"
1934941458,France_Colombia,19,6,5,11,0.593029,0.610997,0.00341,"#5456a6"
1936654669,RBatell,46,1,4,5,0.297796,0.658371,0.000487,"#3bec00"
1938952987,JaumeRamonE,28,3,5,8,0.395107,0.570884,0.001948,"#8ecfec"
1943340522,nodegoat,39,7,1,8,0.416903,0.373275,0.001948,"#00e8b2"
1944877693,AliciaOcaso1,0,0,4,4,0.343257,0.429399,0,"#3e93ff"
1949404088,sisbiuba,48,4,0,4,0.35882,0.590651,0,"#008ebb"
1952238739,tribunadetoledo,37,17,1,18,0.453938,0.612993,0.006819,"#fcae7e"
1952470740,FIGRIExternado,25,8,3,11,0.409631,0.713586,0.00341,"#ff0d69"
1953269040,danielmnds34,39,2,2,4,0.427287,0.39728,0,"#00e8b2"
1953607634,mariacostaIP,1,4,1,5,0.397952,0.534795,0.000487,"#825403"
1956837272,bib_mais,46,0,8,8,0.387529,0.588374,0.001948,"#3bec00"
1962476652,DadunUnav,15,8,9,17,0.427757,0.597515,0.006332,"#8ecfec"
1962999248,tULEctura_ULE,21,5,3,8,0.400228,0.681536,0.001948,"#ffa64e"
1966455439,atc_ugr,48,1,3,4,0.57999,0.487143,0,"#ff0d69"
1967492844,acamachoruiz,15,0,4,4,0.531153,0.543885,0,"#006032"
1968828768,HealeyParera,12,9,19,28,0.351255,0.395056,0.01169,"#ff77ff"
1973024648,Nnadialba,46,0,5,5,0.432896,0.42059,0.000487,"#ffb800"
1977823740,currmon,22,0,9,9,0.447439,0.524092,0.002435,"#ff0d69"
1979083904,ICArchiv,0,5,0,5,0.386152,0.518515,0.000487,"#ff77ff"
2155104415,MemoriaUniandes,36,18,5,23,0.458053,0.394783,0.009255,"#00e8b2"
2155612308,ariciula,46,0,17,17,0.389842,0.5009,0.006332,"#ffb800"
2159060402,rutgersdh,39,6,0,6,0.351014,0.342986,0.000974,"#00e8b2"
2161181208,aamansofl,46,8,6,14,0.464674,0.56093,0.004871,"#ffb800"
2163086088,ANdeChile,32,1,7,8,0.423953,0.31107,0.001948,"#00ed5d"
2165315462,siers2,46,2,13,15,0.430243,0.54555,0.005358,"#ffb800"
2168094626,N_Perreaux,48,0,5,5,0.389526,0.588996,0.000487,"#008ebb"
2168288684,AHDig,39,33,5,38,0.422088,0.467407,0.016561,"#00e8b2"
2168931679,ActaAcademica,46,16,12,28,0.362091,0.537699,0.01169,"#3bec00"
2171922163,ccnn1_CFIEVA,1,0,5,5,0.641527,0.429262,0.000487,"#ff12a3"
2174894173,continuum_ele,17,0,5,5,0.429284,0.654255,0.000487,"#3bec00"
2176531326,UNEDAbierta,46,1,3,4,0.424086,0.601746,0,"#ffb800"
2176552094,isanavarrofc,15,1,7,8,0.526422,0.554081,0.001948,"#006032"
2178904442,LkjonesSOC,12,0,4,4,0.37586,0.404394,0,"#ff77ff"
2180423107,mmespino20,42,0,5,5,0.319741,0.195615,0.000487,"#005076"
2183948778,seecmadrid,37,1,4,5,0.586621,0.538645,0.000487,"#ffb800"
2184660524,dgestudiantes,46,4,2,6,0.416936,0.521673,0.000974,"#ffb800"
2184765414,TRICLab,15,8,2,10,0.435221,0.603995,0.002923,"#008ebb"
2188794080,FMAPFREHistoria,19,7,1,8,0.494344,0.507235,0.001948,"#3e93ff"
2188868180,BiblioColmex,26,225,34,259,0.338402,0.396189,0.124208,"#3e93ff"
2190381132,ALAArchivos,39,3,2,5,0.509451,0.394573,0.000487,"#00e8b2"
2190876324,SocialCultura,15,0,8,8,0.515965,0.477549,0.001948,"#006032"
2191227130,ricardhuerta,15,5,0,5,0.519932,0.551815,0.000487,"#006032"
2192093752,MadeleineSaint,12,0,5,5,0.341302,0.435442,0.000487,"#ff77ff"
2196019344,UAB_Coursera,48,20,8,28,0.531143,0.517256,0.01169,"#ff0d69"
2196574902,ParrillaAmador,46,0,4,4,0.448236,0.610522,0,"#ffb800"
2197086420,IvanAgudeloZ,19,11,1,12,0.612571,0.922149,0.003897,"#5456a6"
2200403064,adeniho,26,1,8,9,0.38291,0.502038,0.002435,"#3e93ff"
2205518958,LNCleon,21,6,0,6,0.439419,0.621358,0.000974,"#ffa64e"
2207175750,LibraryGamerES,48,0,7,7,0.493809,0.502809,0.001461,"#008ebb"
2208142365,unipymemadrid,15,4,1,5,0.591449,0.717361,0.000487,"#ff0d69"
2210832192,mpilarpuig,28,0,7,7,0.399413,0.570794,0.001461,"#8ecfec"
2213161453,LuzGomezGar,49,0,4,4,0.537261,0.470463,0,"#ffa64e"
2213996546,u_0043,48,4,0,4,0.699609,0.229773,0,"#008ebb"
2215659596,irenefreyre74,22,0,4,4,0.414223,0.586839,0,"#8ecfec"
2219216983,FlogCorr,46,0,4,4,0.322072,0.579492,0,"#8ecfec"
2222945773,mortuuminurbe,48,0,7,7,0.480859,0.392514,0.001461,"#ffb800"
2224965637,RonaldDuran_CM,15,2,3,5,0.360594,0.540344,0.000487,"#ffa64e"
2226890449,AcademicaUBA,46,7,4,11,0.277824,0.539658,0.00341,"#3bec00"
2227010643,anatlazaro,0,0,6,6,0.398699,0.499706,0.000974,"#3e93ff"
2228914730,AP_APAlmeria,15,3,10,13,0.896237,0.728242,0.004384,"#006032"
2231373823,GranadaCiencias,15,0,8,8,0.551937,0.526843,0.001948,"#006032"
2234398223,Logiamillennium,15,0,9,9,0.469059,0.530649,0.002435,"#006032"
2238132050,ReartedixUma,15,11,6,17,0.495739,0.528222,0.006332,"#ff0d69"
2238250229,Llumjuan,48,1,3,4,0.498914,0.583713,0,"#008ebb"
2239713997,carlosacreativo,22,0,11,11,0.379422,0.555063,0.00341,"#8ecfec"
2242127486,lucantamutto,46,30,19,49,0.362905,0.51984,0.021919,"#3bec00"
2243556684,BCNInnovacio,48,0,4,4,0.534216,0.448476,0,"#ff0d69"
2243785820,CSerranot2,46,4,0,4,0.323821,0.57519,0,"#3bec00"
2245983919,enortasuna,15,4,7,11,0.471842,0.466818,0.00341,"#006032"
2246332859,upf_occ,15,2,2,4,0.480697,0.491202,0,"#006032"
2247791346,DrLuisG_IU,0,0,11,11,0.427169,0.545955,0.00341,"#3e93ff"
2248027368,BlackDigitalHum,39,6,0,6,0.329118,0.341913,0.000974,"#00e8b2"
2248525465,CulturalGranada,15,0,5,5,0.529609,0.505383,0.000487,"#006032"
2249296076,14AbrilCosta,21,2,5,7,0.570041,0.790713,0.001461,"#ffa64e"
2249376488,joseleivaaldea,15,0,8,8,0.473832,0.5305,0.001948,"#ff0d69"
2250564248,mmmortiz,25,4,1,5,0.334182,0.54028,0.000487,"#ff0d69"
2252590692,DoFaRadio,48,0,9,9,0.357202,0.69357,0.002435,"#008ebb"
2259618787,EducacionXX1,46,0,5,5,0.391722,0.525832,0.000487,"#ffb800"
2260355683,mymieres,46,0,4,4,0.435792,0.472044,0,"#ffb800"
2266466816,JuanJosePonsIzq,49,48,9,57,0.563684,0.445061,0.025816,"#8ecfec"
2272120220,PapirosPerdidos,50,0,5,5,0.551739,0.509329,0.000487,"#008bdd"
2278485025,LicLinaReyes,26,2,4,6,0.310988,0.453207,0.000974,"#3e93ff"
2280612877,quincocesa,46,0,4,4,0.418104,0.508637,0,"#ffb800"
2280762302,twitty_clair,48,0,4,4,0.826757,0.748639,0,"#66e087"
2282412624,UniRomaTre,48,3,3,6,0.447204,0.606411,0.000974,"#008ebb"
2285625770,ICCMU,48,0,4,4,0.469265,0.617362,0,"#ffb800"
2286341286,jjcampos14,27,0,4,4,0.937023,0.180043,0,"#00ed5d"
2286768204,UPRMHumanidades,39,12,1,13,0.403969,0.345267,0.004384,"#00e8b2"
2287169136,demijardin,48,0,12,12,0.502949,0.538011,0.003897,"#008ebb"
2289835369,lamusadecima,46,49,53,102,0.404567,0.527419,0.047735,"#ffb800"
2291367079,flamand_laura,26,8,21,29,0.347277,0.394233,0.012177,"#3e93ff"
2291689898,HistoriaObrera,21,7,0,7,0.556318,0.755124,0.001461,"#ffa64e"
2292454884,arturjoyeux,12,0,4,4,0.405606,0.404525,0,"#ff77ff"
2294113730,usvirtualempleo,22,3,1,4,0.376849,0.625426,0,"#8ecfec"
2294164837,UniversidadeUSC,49,41,8,49,0.377307,0.541989,0.021919,"#ff0d69"
2294245189,BibliotecaUPSA,15,3,2,5,0.386566,0.563492,0.000487,"#006032"
2296142553,sandraceliah,39,4,3,7,0.68075,0.471895,0.001461,"#00e8b2"
2301533310,ResidInvestig,48,6,2,8,0.418593,0.660148,0.001948,"#008ebb"
2303412468,Eduardo280714,15,0,7,7,0.495209,0.502315,0.001461,"#006032"
2317014671,ruhm_online,0,2,2,4,0.580373,0.573011,0,"#ffb800"
2317329480,CRH_ehess,39,4,4,8,0.44964,0.479636,0.001948,"#3bec00"
2325436118,AnesCreativo,15,0,5,5,0.525143,0.509108,0.000487,"#006032"
2325798829,EstacionCKWEB,19,3,3,6,0.70655,0.400813,0.000974,"#00ed5d"
2325856560,tysmagazine,48,4,0,4,0.503695,0.606879,0,"#008ebb"
2327392447,beatriz39746205,0,0,4,4,0.353145,0.425597,0,"#3e93ff"
2327697072,Transmedia_UGR,15,28,9,37,0.479176,0.551616,0.016074,"#006032"
2329062542,jramonvallejo,48,2,8,10,0.46994,0.542862,0.002923,"#008ebb"
2330108059,abigranca,48,1,3,4,0.445246,0.60662,0,"#ffb800"
2337307843,stttff,12,0,11,11,0.356429,0.469101,0.00341,"#ff77ff"
2338340012,JamesStaig,46,0,7,7,0.322902,0.469997,0.001461,"#3bec00"
2340735822,CSICGalicia,49,21,3,24,0.437286,0.55952,0.009742,"#ff0d69"
2345035488,FrederikeNBR,12,0,4,4,0.351682,0.422304,0,"#ff77ff"
2347683313,AlarconYlia,50,0,4,4,0.696558,0.403092,0,"#008bdd"
2350875075,d1egoAr,1,1,3,4,0.442838,0.635992,0,"#825403"
2351408825,josev2046,22,2,14,16,0.398172,0.529167,0.005845,"#8ecfec"
2352978770,AugmentClass,35,4,2,6,0.573184,0.624652,0.000974,"#c42c63"
2354591678,OTRIUGR,15,5,6,11,0.515065,0.508773,0.00341,"#006032"
2355218522,CEHColmex,26,22,7,29,0.282105,0.326716,0.012177,"#3e93ff"
2361372560,achdotorg,0,27,3,30,0.334708,0.445651,0.012664,"#ffb800"
2362796750,OTeAULPGC,37,0,5,5,0.4887,0.660289,0.000487,"#ffb800"
2364377184,lgmerchant,12,19,13,32,0.308115,0.419476,0.013639,"#ff77ff"
2368265731,Elotroyomebusca,50,3,10,13,0.622634,0.464,0.004384,"#008bdd"
2369274090,LabARTblog,15,1,9,10,0.510584,0.591683,0.002923,"#ff0d69"
2374425787,iArtHis_Lab,15,10,0,10,0.48473,0.498999,0.002923,"#ff0d69"
2374479512,iArtHislab,15,59,59,118,0.432741,0.493265,0.055528,"#ff0d69"
2375316660,ce_had,15,3,6,9,0.488097,0.504412,0.002435,"#ff0d69"
2375696683,linhduned,46,701,290,991,0.4104,0.541611,0.48076,"#ffb800"
2377428560,mayantatoo,26,0,5,5,0.454063,0.389097,0.000487,"#3e93ff"
2378423046,ECOmooc,46,15,0,15,0.403878,0.619559,0.005358,"#ffb800"
2381472966,Claudishka,0,7,43,50,0.411541,0.461893,0.022406,"#3e93ff"
2384084136,USLDH,12,6,0,6,0.402508,0.434509,0.000974,"#ff77ff"
2384192587,PepeMolt,37,0,17,17,0.426022,0.544949,0.006332,"#ffb800"
2384977358,commercetrain,46,0,9,9,0.435927,0.525349,0.002435,"#ffb800"
2387433554,BiblioKino,0,0,6,6,0.341689,0.419568,0.000974,"#3e93ff"
2389597301,loreleidem,46,7,18,25,0.347574,0.570686,0.010229,"#3bec00"
2391123854,MElenaEsteban,25,2,2,4,0.34935,0.521747,0,"#ff0d69"
2396037342,ETHEjournal,15,0,8,8,0.503841,0.499121,0.001948,"#ff0d69"
2397620451,alipuchesanchez,46,6,8,14,0.402456,0.623357,0.004871,"#8ecfec"
2398401368,aprender3c,46,55,28,83,0.384057,0.549477,0.03848,"#3bec00"
2400055094,Javiertecteos,19,3,2,5,0.393067,0.713608,0.000487,"#ff77ff"
2400596910,jlperezca,1,0,4,4,0.403806,0.527304,0,"#825403"
2402129642,JdelafueG,26,0,6,6,0.334737,0.325322,0.000974,"#3e93ff"
2410867260,SchoolOfMaaa,39,6,2,8,0.750644,0.25412,0.001948,"#00e8b2"
2410936039,culturamalaga,15,7,1,8,0.531245,0.554376,0.001948,"#ff0d69"
2413458755,ProfeFoulis,35,3,9,12,0.34192,0.454638,0.003897,"#c42c63"
2416383542,sercast99,0,3,9,12,0.375539,0.466092,0.003897,"#3e93ff"
2419710651,ArcadiNavarro,14,9,0,9,0.578466,0.274809,0.002435,"#b6cb00"
2420597785,politicspartids,21,4,0,4,0.578678,0.744591,0,"#ffa64e"
2422171706,aahdArg,46,464,80,544,0.371691,0.504461,0.26303,"#3bec00"
2424468703,SeHablaArte,50,3,2,5,0.573413,0.387062,0.000487,"#008bdd"
2425419566,archivosugt,21,3,6,9,0.553705,0.749008,0.002435,"#ffa64e"
2427366498,AIUCD,0,5,27,32,0.341766,0.48975,0.013639,"#3e93ff"
2427646370,MANArqueologico,37,24,0,24,0.465088,0.614948,0.009742,"#ffb800"
2428174303,Medieval_Gus,46,14,4,18,0.322069,0.519233,0.006819,"#3bec00"
2430772189,kbellamy_,10,1,4,5,0.422802,0.471691,0.000487,"#00ed5d"
2432554452,MariaEsquirozMa,46,0,13,13,0.421735,0.514677,0.004384,"#ffb800"
2436790365,DianaDipare,19,0,13,13,0.444845,0.42323,0.004384,"#00ed5d"
2437409532,RUCDH,0,5,0,5,0.358064,0.468401,0.000487,"#3e93ff"
2438417263,ClasiHispanicos,46,16,8,24,0.402039,0.549376,0.009742,"#8ecfec"
2439015110,ProvAtlantic,12,0,10,10,0.371078,0.437902,0.002923,"#ff77ff"
2439711755,emocionycambio,46,0,6,6,0.43758,0.574391,0.000974,"#ffb800"
2439777349,GH_Catalina,19,10,3,13,0.412387,0.425081,0.004384,"#3e93ff"
2439790826,HugPalouMiquel,46,0,16,16,0.382913,0.532657,0.005845,"#ffb800"
2439926662,susanadv17,28,0,4,4,0.495736,0.308414,0,"#8ecfec"
2439975073,hralperta,0,45,32,77,0.343407,0.424376,0.035558,"#ff77ff"
2441599722,OttaviaAllgood,48,11,3,14,0.500693,0.625412,0.004871,"#ffb800"
2443877420,jamcmadrid,48,3,1,4,0.209736,0.73836,0,"#008ebb"
2451892380,ccomUBA,17,1,5,6,0.363309,0.611934,0.000974,"#3bec00"
2451995562,ABGRAoficial,46,12,6,18,0.337752,0.564869,0.006819,"#3bec00"
2453304763,issac_davila,12,0,4,4,0.421849,0.341575,0,"#ff77ff"
2453359591,mujerconciencia,21,5,0,5,0.542213,0.771371,0.000487,"#ffa64e"
2455171654,bhumuc,46,5,5,10,0.37038,0.513775,0.002923,"#ffb800"
2458387772,UNIR_Mexico,0,5,0,5,0.374843,0.488917,0.000487,"#3e93ff"
2464423958,plataformanove,39,35,9,44,0.469946,0.434724,0.019484,"#00e8b2"
2464883898,fasticongress,21,4,0,4,0.585411,0.636177,0,"#006032"
2478798626,magdaturska,46,7,12,19,0.320971,0.50922,0.007306,"#3bec00"
2483909162,RoaVargasBecerr,19,0,13,13,0.367066,0.371763,0.004384,"#ff77ff"
2485768122,El_Moreno__,15,1,9,10,0.507738,0.382022,0.002923,"#006032"
2494163485,DtoLenguaUNED,46,17,13,30,0.437274,0.587373,0.012664,"#8ecfec"
2496201115,BibCampusSoria,48,0,5,5,0.561078,0.516007,0.000487,"#008ebb"
2497934976,BUS_Antiguo,28,0,5,5,0.422437,0.544259,0.000487,"#8ecfec"
2501142379,jafgaqt,25,0,4,4,0.322176,0.548103,0,"#ff0d69"
2502256902,MediosTec21_Vva,48,6,4,10,0.405113,0.533807,0.002923,"#ff0d69"
2504482741,GPellissa,46,0,10,10,0.365927,0.537482,0.002923,"#ffb800"
2507298325,redredial,0,8,5,13,0.409818,0.506879,0.004384,"#3e93ff"
2512620972,ARPACEC_UNED,46,5,8,13,0.402589,0.559862,0.004384,"#ffb800"
2515301341,MiPLEytu,0,0,6,6,0.447181,0.474282,0.000974,"#3e93ff"
2520668425,LogosNat,0,0,7,7,0.40733,0.462503,0.001461,"#ffb800"
2525308170,ExploraMaule,46,2,4,6,0.151182,0.347445,0.000974,"#3bec00"
2526751470,gabioshka,39,4,4,8,0.427309,0.40038,0.001948,"#00e8b2"
2529674432,Paula_C_Vega,46,7,11,18,0.331196,0.511987,0.006819,"#3bec00"
2531015160,TillyShepard,12,2,2,4,0.301008,0.413018,0,"#ff77ff"
2534687467,bibliotecaule,21,0,6,6,0.440047,0.597078,0.000974,"#ffa64e"
2537749436,negrojosema,46,0,6,6,0.334796,0.535621,0.000974,"#3bec00"
2539249513,dgtrapaga,0,2,3,5,0.416414,0.45931,0.000487,"#3e93ff"
2539640557,BeingDigitalBD,39,2,2,4,0.47749,0.418049,0,"#00e8b2"
2539810990,SoyAlexArredo,19,0,4,4,0.438555,0.428115,0,"#00ed5d"
2541807602,UFMposgrado,15,3,3,6,0.547051,0.549337,0.000974,"#006032"
2541847868,ehp14,28,0,4,4,0.379286,0.637989,0,"#8ecfec"
2541879043,TvUAQ,0,3,3,6,0.361213,0.462158,0.000974,"#3e93ff"
2543214114,ideinfo,49,6,0,6,0.31323,0.429027,0.000974,"#3bec00"
2543312586,HumanisticaDH,0,12,3,15,0.388599,0.460908,0.005358,"#ffb800"
2543573486,ArScielo,46,3,7,10,0.336886,0.548404,0.002923,"#3bec00"
2545642496,DARIAHie,0,8,1,9,0.397778,0.555184,0.002435,"#ffb800"
2546494410,girartepoder,48,4,0,4,0.532809,0.584337,0,"#ff0d69"
2549302783,Gelassenheit67,0,2,7,9,0.359159,0.439683,0.002435,"#3e93ff"
2549407680,jannikstroetgen,46,3,4,7,0.416075,0.504478,0.001461,"#ffb800"
2552167188,GianlucaMis,19,0,4,4,0.424948,0.437582,0,"#00ed5d"
2555166319,cl379,48,3,8,11,0.448869,0.590977,0.00341,"#008ebb"
2563383121,BNUruguay,54,4,0,4,0.574699,0.658811,0,"#c6cc85"
2563427430,ULA_Venezuela,50,6,1,7,0.556317,0.466781,0.001461,"#008bdd"
2563711675,mcgilldigihum,0,6,10,16,0.37488,0.424245,0.005845,"#3e93ff"
2564826572,CLARIN_ES_LAB,46,9,39,48,0.431251,0.506239,0.021432,"#ffb800"
2570466438,piensateclado,15,0,5,5,0.556676,0.537283,0.000487,"#006032"
2572950912,StellaMassa2,28,0,5,5,0.665317,0.574483,0.000487,"#00ed5d"
2573347506,redaltexto,0,1,5,6,0.292525,0.314342,0.000974,"#3e93ff"
2578718656,ajapitonisa,19,0,4,4,0.430757,0.400086,0,"#00ed5d"
2579129798,PMovimiento,26,5,3,8,0.32268,0.360935,0.001948,"#3e93ff"
2579789336,Andres_Mage,17,0,5,5,0.359282,0.626259,0.000487,"#3bec00"
2580477667,aolaizola1,46,6,15,21,0.3867,0.521679,0.008281,"#3bec00"
2584085789,celiaricoperez,46,9,14,23,0.493065,0.521455,0.009255,"#ffb800"
2585939353,AbiertaEDU,48,4,5,9,0.478348,0.496398,0.002435,"#3e93ff"
2587166667,carlosdiazred,28,2,2,4,0.385759,0.623504,0,"#8ecfec"
2588640793,BuenrostrJavier,5,0,4,4,0.361914,0.318908,0,"#ff9b8f"
2589447139,FilologiaUCM,46,34,14,48,0.456952,0.539618,0.021432,"#ffb800"
2596061704,ArsenioDacosta,48,11,21,32,0.442054,0.564798,0.013639,"#008ebb"
2607681390,arte_lab,22,1,6,7,0.35555,0.556308,0.001461,"#8ecfec"
2608171524,MaciejEder,25,3,4,7,0.36332,0.515741,0.001461,"#ff0d69"
2609484936,ArtyHum,46,58,59,117,0.401392,0.522381,0.055041,"#ffb800"
2612642079,fundacionciev,46,3,4,7,0.359925,0.560468,0.001461,"#8ecfec"
2613185593,RecerCaixa,48,0,5,5,0.522494,0.593862,0.000487,"#ff0d69"
2613829772,ArchivosEst,21,85,13,98,0.500654,0.575303,0.045787,"#ffa64e"
2613832962,UNEDprehistoria,46,3,3,6,0.482222,0.513629,0.000974,"#ffb800"
2616883074,UdL_info,0,9,0,9,0.416412,0.499332,0.002435,"#ff0d69"
2645648308,alextheknitter,0,0,12,12,0.394061,0.471428,0.003897,"#3e93ff"
2646023662,lomarcos8,54,0,5,5,0.612339,0.687461,0.000487,"#c6cc85"
2646122101,MGomAlb,15,0,7,7,0.461177,0.517803,0.001461,"#006032"
2650976759,ColMex,0,6,0,6,0.329561,0.441393,0.000974,"#3e93ff"
2656446570,AH_PCE,21,11,0,11,0.55362,0.765235,0.00341,"#ffa64e"
2656882268,fcshrossio,39,28,14,42,0.423814,0.418281,0.018509,"#00e8b2"
2660112860,SEOMagnetism,15,0,4,4,0.322796,0.624348,0,"#ff0d69"
2673181909,USPCEUHumYCom,1,8,11,19,0.410546,0.556994,0.007306,"#ff12a3"
2679127730,mlmforero,48,5,7,12,0.471132,0.561826,0.003897,"#008ebb"
2688070376,fundacaofhc,39,4,0,4,0.421687,0.330222,0,"#00e8b2"
2692094678,peggybockwinkel,46,0,12,12,0.398679,0.504344,0.003897,"#3bec00"
2692496635,corepatrimoni,15,6,2,8,0.432251,0.581793,0.001948,"#ff0d69"
2698670421,oaperezh,0,0,10,10,0.432269,0.478397,0.002923,"#3e93ff"
2702084341,sujetosUY,54,4,3,7,0.471653,0.622548,0.001461,"#c6cc85"
2704310310,acastrosalgado,49,4,3,7,0.4207,0.403371,0.001461,"#3bec00"
2710562852,corrientefil919,0,3,2,5,0.583104,0.429651,0.000487,"#00ed5d"
2712448951,CONICETCenpat,50,7,0,7,0.130079,0.688148,0.001461,"#3bec00"
2713180697,LaradominguezMe,36,1,3,4,0.439791,0.464263,0,"#00e8b2"
2715099920,PoluxArq,49,5,7,12,0.464652,0.410645,0.003897,"#3bec00"
2718765609,phosterii,46,0,8,8,0.38508,0.534083,0.001948,"#ffb800"
2719788874,sutersan69,46,7,0,7,0.326205,0.576019,0.001461,"#3bec00"
2733023213,molano_mario,19,3,3,6,0.483596,0.377651,0.000974,"#00ed5d"
2741973764,EdukaTICS,46,0,8,8,0.414607,0.566302,0.001948,"#ffb800"
2743700423,garciabarace,48,6,3,9,0.37985,0.56075,0.002435,"#008ebb"
2747621768,nellstra,12,29,9,38,0.257379,0.359871,0.016561,"#ff77ff"
2749803914,RedxlaEducacion,8,53,0,53,0.854706,0.346992,0.023867,"#3e93ff"
2751082377,ManelTrenchs,50,2,3,5,0.610675,0.469595,0.000487,"#008bdd"
2753191789,4bdonsanch,0,0,4,4,0.361259,0.374244,0,"#3e93ff"
2761950271,mpf421,37,5,0,5,0.587991,0.633756,0.000487,"#ffb800"
2772101085,LetrasMara,39,0,6,6,0.446217,0.469304,0.000974,"#00e8b2"
2775361834,Sole_SM1,22,0,5,5,0.330287,0.63836,0.000487,"#8ecfec"
2778799206,iruskieta_m,46,19,24,43,0.399863,0.499421,0.018997,"#ffb800"
2781359551,Marta51970,48,1,7,8,0.418889,0.561581,0.001948,"#008ebb"
2789520523,mrodrivelasco,1,0,10,10,0.439239,0.574673,0.002923,"#ff12a3"
2789673272,BiblioHack,12,2,5,7,0.37329,0.517693,0.001461,"#ff77ff"
2790551606,trameproject,46,1,24,25,0.395856,0.503389,0.010229,"#ffb800"
2791510020,Instituto25M,15,6,0,6,0.491303,0.399004,0.000974,"#006032"
2792182600,juliomtzcava,15,6,0,6,0.491299,0.407789,0.000974,"#006032"
2792368833,TimoTransicion,21,6,0,6,0.53699,0.709137,0.000974,"#ffa64e"
2795190696,GoliardosUN,12,7,1,8,0.333074,0.343318,0.001948,"#ff77ff"
2795294176,fmasoares2,39,2,3,5,0.440272,0.437185,0.000487,"#00e8b2"
2798791320,jbosgil,48,0,4,4,0.442774,0.649914,0,"#008ebb"
2800686884,LuisUdaquiola,54,0,4,4,0.609909,0.66696,0,"#c6cc85"
2800719783,WeekendArchaeo,12,0,4,4,0.409159,0.386099,0,"#ff77ff"
2801764013,euromemories,21,2,15,17,0.543566,0.704241,0.006332,"#ffa64e"
2801825917,RuCantor,0,1,5,6,0.340858,0.438763,0.000974,"#3e93ff"
2802778752,UnescomUJ,36,9,4,13,0.440709,0.432541,0.004384,"#6c241e"
2805730836,UdeLaHabana,17,8,6,14,0.638473,0.607349,0.004871,"#6c241e"
2809191225,Elisabeth_FM,46,0,4,4,0.445905,0.567457,0,"#ffb800"
2810923151,Atreides_P,39,2,2,4,0.418948,0.31667,0,"#00e8b2"
2811842481,NASWells,46,0,5,5,0.388241,0.527369,0.000487,"#ffb800"
2814838689,cysoc_ual,46,1,3,4,0.401222,0.58551,0,"#3bec00"
2815623109,CCUSalmona,19,9,0,9,0.662017,0.676762,0.002435,"#5456a6"
2823218818,CongressoHDPT,39,7,6,13,0.446693,0.483721,0.004384,"#00e8b2"
2823488469,Irenedeluque77,21,0,6,6,0.577923,0.803738,0.000974,"#ffa64e"
2826162619,CEDID_UAB,21,4,11,15,0.547314,0.759094,0.005358,"#ffa64e"
2827111214,majovenromero,25,0,4,4,0.390663,0.595339,0,"#8ecfec"
2827395683,ArtnodesUOC,15,86,32,118,0.436247,0.477647,0.055528,"#ff0d69"
2828007681,gloriaserranos,15,0,6,6,0.539352,0.556778,0.000974,"#006032"
2828117077,vanstriendaniel,12,26,0,26,0.362314,0.459123,0.010716,"#ff77ff"
2828420725,depredadortk,35,1,5,6,0.248692,0.452848,0.000974,"#c42c63"
2828541606,CCPPySOCUCM,48,5,0,5,0.881023,0.782934,0.000487,"#66e087"
2828967669,ortogalenico,31,0,5,5,0.50434,0.410693,0.000487,"#ff0d69"
2829656422,SaberULA,50,11,2,13,0.64578,0.387231,0.004384,"#008bdd"
2830381969,_swordswoman_,21,0,4,4,0.535407,0.744149,0,"#ffa64e"
2832120712,layla_jreis,46,5,25,30,0.416564,0.51598,0.012664,"#ffb800"
2832366634,MasterLitTIC,15,0,4,4,0.542063,0.54066,0,"#006032"
2832562473,ihc_fcsh,39,62,62,124,0.435028,0.416309,0.058451,"#00e8b2"
2833735906,nerpmp,35,0,10,10,0.663715,0.643802,0.002923,"#008ebb"
2835967198,icufop,15,1,3,4,0.433591,0.508796,0,"#006032"
2836415896,Noelia_LSouto,28,0,4,4,0.42961,0.484863,0,"#8ecfec"
2837353354,iNorman55,15,3,4,7,0.571369,0.533536,0.001461,"#006032"
2838773181,silviaclaudiam1,46,0,4,4,0.327255,0.550938,0,"#3bec00"
2841106119,mdsf55,12,8,0,8,0.36523,0.500643,0.001948,"#ff77ff"
2841915940,ChmdDigital,17,25,11,36,0.386741,0.538659,0.015587,"#3bec00"
2844738463,humanasunal,19,10,5,15,0.411727,0.372012,0.005358,"#00ed5d"
2844946777,BurriezaMateos,48,1,10,11,0.471319,0.507397,0.00341,"#ffb800"
2845607121,imcoterof,1,0,4,4,0.632348,0.431893,0,"#ff12a3"
2845699134,Digital_Fellows,12,8,10,18,0.381498,0.369339,0.006819,"#ff77ff"
2847904055,IsaGribomont,19,3,1,4,0.342444,0.365367,0,"#00ed5d"
2848438769,rubeninsky11,0,0,4,4,0.275061,0.381234,0,"#3e93ff"
2849040833,JournalSLT,22,37,7,44,0.358494,0.654903,0.019484,"#8ecfec"
2849224400,MedievalLitura,0,0,4,4,0.335577,0.41671,0,"#3e93ff"
2857319315,MedialabUGR,15,271,66,337,0.506139,0.527064,0.162202,"#006032"
2858507985,BiblioBodoni,28,12,5,17,0.412518,0.513279,0.006332,"#8ecfec"
2860134261,Ines_R_G,15,2,2,4,0.553125,0.379814,0,"#006032"
2860469503,OmarRinconTV,19,17,3,20,0.422324,0.413487,0.007793,"#3e93ff"
2863217422,EloisaVaq,48,1,3,4,0.464365,0.59841,0,"#008ebb"
2865328068,cboteromarino,12,20,3,23,0.48969,0.346771,0.009255,"#ff77ff"
2867900419,JMBarrueco,15,7,0,7,0.5073,0.51909,0.001461,"#ff0d69"
2869692951,LASACONGRESS,36,24,11,35,0.346574,0.404587,0.0151,"#ff77ff"
2871167445,tripsandflips_,0,1,3,4,0.347041,0.404759,0,"#3e93ff"
2873503431,Traficantes_Ed,15,5,11,16,0.512875,0.384057,0.005845,"#006032"
2873992843,UN_InTIColombia,19,2,3,5,0.380562,0.532549,0.000487,"#00ed5d"
2874418891,IMFAHE,46,3,1,4,0.187481,0.47674,0,"#ffb800"
2877853552,J_Cshdsur,15,7,5,12,0.449434,0.508495,0.003897,"#ff0d69"
2877951449,ejo_pt,1,2,2,4,0.588797,0.410279,0,"#825403"
2881373775,LudwigGuru,15,33,6,39,0.513377,0.531513,0.017048,"#006032"
2882912390,ahsoubervielle,12,1,3,4,0.410605,0.408115,0,"#ff77ff"
2885828620,AntonioRRos,48,2,3,5,0.325537,0.484447,0.000487,"#008ebb"
2889397025,RevistaCirce,0,15,4,19,0.412424,0.466074,0.007306,"#3e93ff"
2889417706,perezfuilleratn,15,0,4,4,0.552967,0.538198,0,"#006032"
2890465774,coLenguando,46,7,4,11,0.35369,0.620773,0.00341,"#ffb800"
2890597829,masteressevilla,22,5,0,5,0.27027,0.535775,0.000487,"#8ecfec"
2891039514,cesta_stanford,12,6,2,8,0.347284,0.423435,0.001948,"#ff77ff"
2891161305,Anarquismoenpdf,21,1,3,4,0.529629,0.791291,0,"#ffa64e"
2892368649,jeniffermendo20,12,0,9,9,0.406839,0.421662,0.002435,"#ff77ff"
2893228318,carlosrising1,37,0,4,4,0.468061,0.586558,0,"#ffb800"
2893560599,filosunam,0,12,0,12,0.34405,0.419788,0.003897,"#3e93ff"
2897285536,ga_brieell_,39,2,9,11,0.41166,0.324304,0.00341,"#00e8b2"
2898300309,carlosandradas,46,5,0,5,0.432181,0.566436,0.000487,"#ffb800"
2899500747,cruze_andrea,26,0,4,4,0.401688,0.388604,0,"#3e93ff"
2901945254,Aleks_Kaye,39,1,3,4,0.38663,0.372698,0,"#00e8b2"
2902951037,Fdez_Ortiz_UO,48,3,3,6,0.542283,0.495535,0.000974,"#ff0d69"
2903895297,revistaBiD,48,12,4,16,0.436256,0.613007,0.005845,"#008ebb"
2906555842,_ray_SA,0,0,5,5,0.338411,0.460536,0.000487,"#3e93ff"
2909386191,AHLiST_Congress,0,15,27,42,0.398442,0.508014,0.018509,"#ffb800"
2916015406,cewebbr,39,3,2,5,0.365763,0.24829,0.000487,"#00e8b2"
2917551316,HyCmar,37,4,0,4,0.463282,0.634465,0,"#ffb800"
2919386884,Iberarchivos,21,0,4,4,0.570753,0.529328,0,"#ffa64e"
2919398071,dhumanities_rr,46,14,0,14,0.401411,0.540388,0.004871,"#ffb800"
2920518059,rutassierra,22,1,4,5,0.454193,0.493083,0.000487,"#8ecfec"
2926552889,desbanda1937,21,4,0,4,0.572092,0.801121,0,"#ffa64e"
2926739242,museorusomalaga,15,11,2,13,0.521886,0.492771,0.004384,"#ff0d69"
2933692635,dtdewar,12,23,0,23,0.367004,0.451546,0.009255,"#ff77ff"
2935982637,EcoMovistar,47,2,2,4,0.171012,0.437333,0,"#7e8b76"
2938341550,_emapic,54,15,10,25,0.460605,0.485933,0.010229,"#c6cc85"
2941204386,questionpro_es,46,4,0,4,0.338421,0.676587,0,"#3bec00"
2943721114,3186Ricardo,48,6,0,6,0.476891,0.641633,0.000974,"#ffb800"
2950404406,ortizcastroq,12,0,6,6,0.421638,0.418154,0.000974,"#ff77ff"
2957474806,pruedar,22,73,17,90,0.481294,0.545905,0.04189,"#ff0d69"
2970440088,TinkeringHuman,0,2,2,4,0.329953,0.43176,0,"#3e93ff"
2971415799,clara_paolini,48,5,1,6,0.485357,0.621028,0.000974,"#ffb800"
2971623556,uned_alzira_val,46,3,18,21,0.407709,0.545255,0.008281,"#ffb800"
2976762437,fundacionFESCOL,19,2,3,5,0.476647,0.460527,0.000487,"#ff0d69"
2977375450,blillehaugen,0,4,12,16,0.358265,0.449392,0.005845,"#3e93ff"
2977527809,wmnobrasil,39,3,3,6,0.355249,0.308144,0.000974,"#00e8b2"
2979537347,asantiagofaria,39,2,8,10,0.441953,0.418588,0.002923,"#00e8b2"
2982670852,CulturacySL,15,2,3,5,0.484808,0.509835,0.000487,"#ff0d69"
2982873873,czapatacar,19,0,7,7,0.460308,0.398908,0.001461,"#3e93ff"
2984491582,juliocvaras,0,0,6,6,0.443951,0.564365,0.000974,"#ff0d69"
2985886996,FCEA_UdelaR,54,14,0,14,0.605499,0.666327,0.004871,"#c6cc85"
2987583095,ericweiskott,46,4,0,4,0.351729,0.553816,0,"#3bec00"
2988981655,martinmendezglz,27,0,5,5,0.874984,0.192741,0.000487,"#00ed5d"
2993664074,WafaIsfahany,39,0,4,4,0.334592,0.301472,0,"#00e8b2"
2994336675,MshBretagne,46,1,5,6,0.382793,0.497717,0.000974,"#ffb800"
2994582401,criiasupr,0,8,1,9,0.30487,0.473488,0.002435,"#3e93ff"
2995751375,DigiHUBBRomania,46,0,4,4,0.375274,0.502979,0,"#ffb800"
2995868723,anacalvorevilla,1,4,16,20,0.424668,0.56424,0.007793,"#ff12a3"
3000274797,CulturArk,21,0,6,6,0.399054,0.565622,0.000974,"#3e93ff"
3003645287,diaz_durana,48,6,3,9,0.452695,0.577704,0.002435,"#008ebb"
3004324330,Ed_Uniandes,0,9,2,11,0.425254,0.445784,0.00341,"#3e93ff"
3009572552,buhoalcatraz,0,0,6,6,0.403217,0.455246,0.000974,"#3e93ff"
3011188258,_Nantu_,21,7,4,11,0.567153,0.425677,0.00341,"#ffa64e"
3012634431,archivoFPI,21,11,2,13,0.568246,0.741906,0.004384,"#ffa64e"
3014603495,HistoriaRep,19,6,5,11,0.440859,0.400805,0.00341,"#00ed5d"
3014612084,EducaDisruptiva,17,9,0,9,0.376209,0.643562,0.002435,"#3bec00"
3015799709,estudiosindiano,28,4,0,4,0.35708,0.519667,0,"#8ecfec"
3017762346,LuciaGR9,12,0,5,5,0.368969,0.413437,0.000487,"#ff77ff"
3017765687,pcarcedo22,46,4,29,33,0.428,0.523942,0.014126,"#ffb800"
3021322161,mrloizaga,1,0,4,4,0.445359,0.502209,0,"#ff12a3"
3024920679,AlbertoEsVa,46,0,8,8,0.47496,0.467824,0.001948,"#ffb800"
3026312742,trasegantes,15,12,7,19,0.459823,0.507234,0.007306,"#ff0d69"
3028996889,juanpro62,48,0,4,4,0.499513,0.57891,0,"#008ebb"
3029027662,sbibliotecario,46,4,1,5,0.314988,0.577643,0.000487,"#3bec00"
3029537081,profesoraneon,17,3,3,6,0.445433,0.434371,0.000974,"#3bec00"
3030060712,ESUDH,46,5,3,8,0.329627,0.529689,0.001948,"#3bec00"
3033117561,jrbsjrbs,54,5,1,6,0.548809,0.604714,0.000974,"#008ebb"
3035004182,eLaboraHD,0,59,33,92,0.392446,0.461688,0.042864,"#3e93ff"
3035264968,humcommons,48,9,1,10,0.404935,0.542983,0.002923,"#ffb800"
3037264229,autores_uy,54,25,7,32,0.54895,0.609791,0.013639,"#c6cc85"
3043120698,EurResearch,21,2,4,6,0.364102,0.554528,0.000974,"#ffb800"
3044530548,ibotezan,48,0,4,4,0.477915,0.61177,0,"#008ebb"
3054866471,JAlexRoL,48,0,7,7,0.483461,0.474682,0.001461,"#008ebb"
3056200605,elepacas,22,0,4,4,0.363649,0.535851,0,"#8ecfec"
3056492325,par_virtual,1,5,3,8,0.514493,0.490758,0.001948,"#ff12a3"
3058558104,dialogomedieval,46,14,10,24,0.373441,0.548261,0.009742,"#ffb800"
3060444101,SantchiWeb,19,0,4,4,0.41211,0.411885,0,"#3e93ff"
3060861718,RicardoDalFarra,39,3,1,4,0.30895,0.468028,0,"#3bec00"
3061690441,GuateSchNetwork,12,3,3,6,0.325814,0.323816,0.000974,"#3e93ff"
3062545421,PabloSuarezGar,46,0,5,5,0.390355,0.588104,0.000487,"#ffb800"
3067638777,Malagacc,15,0,4,4,0.521602,0.529192,0,"#ff0d69"
3067706337,ConsejoSocUVa,48,4,3,7,0.168268,0.561746,0.001461,"#008ebb"
3068624261,TuSocialMedia,15,67,19,86,0.470756,0.522724,0.039942,"#006032"
3071274351,migueldobrich,21,11,4,15,0.642923,0.354198,0.005358,"#ffa64e"
3076083269,torres_rechy,0,1,6,7,0.332444,0.50304,0.001461,"#3e93ff"
3079906967,mmoliveras,14,0,5,5,0.614712,0.236923,0.000487,"#b6cb00"
3080916232,davidcrangel,46,1,8,9,0.390319,0.567992,0.002435,"#ffb800"
3081269231,Pliegodigitaluc,22,25,20,45,0.436007,0.516236,0.019971,"#ff0d69"
3086474291,bibliotecaUGR,15,7,3,10,0.568493,0.419409,0.002923,"#006032"
3089186002,DiarioCyLMundo,48,2,2,4,0.199331,0.563016,0,"#008ebb"
3089332090,frontespo,15,7,3,10,0.514984,0.568755,0.002923,"#006032"
3090935074,Referencia_2,15,5,0,5,0.598753,0.715056,0.000487,"#ff0d69"
3092363416,BBFaktoria,35,5,0,5,0.690393,0.627635,0.000487,"#008ebb"
3102549544,requejo_alonso,48,1,4,5,0.402912,0.574152,0.000487,"#008ebb"
3115223501,sofialomart,15,12,49,61,0.463064,0.51936,0.027764,"#ff0d69"
3118233023,emili0calder0n,19,6,4,10,0.46435,0.405584,0.002923,"#3e93ff"
3122283251,bezdiario,15,11,2,13,0.537575,0.610273,0.004384,"#006032"
3128714193,JFI_UR,21,2,7,9,0.428097,0.572554,0.002435,"#006032"
3129768538,Tele13_Radio,32,13,2,15,0.157508,0.277221,0.005358,"#00ed5d"
3131067772,babel_imago,50,3,1,4,0.662184,0.515832,0,"#008bdd"
3143096086,UGRinvestiga,15,11,5,16,0.48597,0.533976,0.005845,"#006032"
3151634639,lasinsombrero,15,0,7,7,0.511862,0.531892,0.001461,"#006032"
3152005939,EzerMay,12,0,7,7,0.49995,0.363003,0.001461,"#ff77ff"
3153574948,claraimcanton,46,98,21,119,0.375797,0.5074,0.056016,"#ffb800"
3158210782,dobcast,21,1,4,5,0.631284,0.351535,0.000487,"#ffa64e"
3167046794,corderodaniel7,12,0,7,7,0.416013,0.481416,0.001461,"#3e93ff"
3170472916,nicogorellana,15,0,5,5,0.531643,0.531283,0.000487,"#006032"
3170717075,veronica_IamVR,25,4,2,6,0.333627,0.561167,0.000974,"#ff0d69"
3175561288,gregoriorohe,37,12,21,33,0.478203,0.568849,0.014126,"#ffb800"
3192299411,FulviaReyes,0,0,4,4,0.428153,0.470345,0,"#3e93ff"
3193853016,roma_vaga,26,0,4,4,0.31258,0.368074,0,"#3e93ff"
3194863402,digimaps,49,0,4,4,0.487744,0.439697,0,"#3bec00"
3195485187,UnivRoma3,0,14,0,14,0.443421,0.480028,0.004871,"#3e93ff"
3209949862,AprilHathcock,46,9,4,13,0.363937,0.502331,0.004384,"#3bec00"
3214518333,Editorial_UdeC,19,10,11,21,0.599992,0.585919,0.008281,"#5456a6"
3214673157,teresasantama19,25,9,0,9,0.415106,0.484439,0.002435,"#ff0d69"
3217750588,closacon,46,0,6,6,0.450773,0.566896,0.000974,"#ffb800"
3221290599,IberianBooks,25,1,8,9,0.411193,0.546537,0.002435,"#ff0d69"
3221369231,cveladelfa,46,4,2,6,0.365935,0.575327,0.000974,"#ffb800"
3221374863,Lara_Anes,15,8,7,15,0.492347,0.540156,0.005358,"#006032"
3221730864,SamuraiGlam,0,1,3,4,0.358446,0.420392,0,"#3e93ff"
3223966961,magnet_es,46,9,0,9,0.425914,0.62088,0.002435,"#ffb800"
3225703616,rfchimal,0,3,24,27,0.379743,0.450168,0.011203,"#3e93ff"
3238845820,SaletaSouto,15,0,5,5,0.404281,0.557183,0.000487,"#ff0d69"
3239297787,EspanolAmerica,22,38,18,56,0.354181,0.567995,0.025329,"#8ecfec"
3239538556,CBuenafuentes,22,0,6,6,0.334583,0.61679,0.000974,"#ff0d69"
3240194903,CiberiaProject,46,4,3,7,0.429518,0.558067,0.001461,"#ffb800"
3240478252,iiif_io,39,8,0,8,0.362589,0.366303,0.001948,"#00e8b2"
3241416917,NSG148,46,0,7,7,0.316594,0.642673,0.001461,"#3bec00"
3246397575,s_biagetti,48,0,4,4,0.521511,0.625985,0,"#008ebb"
3248867849,elbarroquista,15,2,3,5,0.461889,0.551441,0.000487,"#ff0d69"
3257383873,Emilfz6r,46,0,4,4,0.427293,0.592296,0,"#ffb800"
3260593633,LibsDH,0,0,4,4,0.323341,0.429084,0,"#3e93ff"
3262774291,ViazcanV,26,0,7,7,0.337862,0.433797,0.001461,"#3e93ff"
3263495716,aimeretmourir,48,0,9,9,0.274915,0.438802,0.002435,"#3e93ff"
3278787810,IieducaMid,26,10,5,15,0.412913,0.496612,0.005358,"#3bec00"
3280014502,hou2zi0,12,0,9,9,0.408566,0.485338,0.002435,"#ff77ff"
3286913882,R_interruptus,26,1,3,4,0.338065,0.353282,0,"#3e93ff"
3287093124,pulido_amalia,26,8,3,11,0.306713,0.333877,0.00341,"#3e93ff"
3290201727,fundacionceibal,15,3,1,4,0.559866,0.479049,0,"#006032"
3297006959,edyestudioslite,0,6,5,11,0.444885,0.48284,0.00341,"#ff0d69"
3297224112,FPsicologiaUAB,0,4,0,4,0.434681,0.469021,0,"#ff0d69"
3299157081,AMST_UNC,12,0,5,5,0.260191,0.408154,0.000487,"#ff77ff"
3300459346,Parthenos_EU,49,4,1,5,0.435797,0.627808,0.000487,"#008ebb"
3300842100,HistoriaFFyL,0,2,8,10,0.377699,0.420053,0.002923,"#3e93ff"
3301761341,arobles1980,46,4,11,15,0.434218,0.557146,0.005358,"#ffb800"
3301768225,CaliopeSrbhp,28,1,3,4,0.3226,0.542999,0,"#8ecfec"
3305040863,BibliosDigital,39,5,6,11,0.425436,0.531994,0.00341,"#00e8b2"
3305455523,ugtactivabcn,21,3,3,6,0.553905,0.783914,0.000974,"#ffa64e"
3307584629,MitzyQuinto,36,6,1,7,0.450464,0.339924,0.001461,"#00e8b2"
3313961901,Fcakeller,48,10,0,10,0.518088,0.557074,0.002923,"#008ebb"
3315618027,CIALCUNAM,12,18,0,18,0.387032,0.306872,0.006819,"#ff77ff"
3318757372,PalmeiroRicardo,1,0,8,8,0.405483,0.501849,0.001948,"#825403"
3319485920,VicioNez,12,0,5,5,0.41936,0.365813,0.000487,"#ff77ff"
3327394725,jivan_rodri,37,0,9,9,0.459178,0.589022,0.002435,"#ffb800"
3331795989,aurosgart,48,0,5,5,0.568886,0.614659,0.000487,"#008ebb"
3341067341,Nova_Ciencia,15,11,0,11,0.429059,0.520422,0.00341,"#006032"
3341654205,Xose_rm,14,0,19,19,0.50834,0.416767,0.007306,"#b6cb00"
3342588845,jmlegorburu,1,0,7,7,0.390146,0.55787,0.001461,"#ff12a3"
3356052532,BigDataTweetBot,48,0,5,5,0.520094,0.513805,0.000487,"#ff0d69"
3363722367,rebracweb,39,0,7,7,0.409965,0.420641,0.001461,"#00e8b2"
3365598592,JornadasdeDoc,21,11,11,22,0.495343,0.608327,0.008768,"#006032"
3366253096,dfarranz,1,7,5,12,0.429398,0.546601,0.003897,"#825403"
3369086680,susanahdezr,39,3,3,6,0.402978,0.589645,0.000974,"#fcae7e"
3371648573,Neogranadina_es,12,102,16,118,0.421935,0.393701,0.055528,"#ff77ff"
3373689513,DataBeersMLG,15,5,6,11,0.479988,0.53333,0.00341,"#ff0d69"
3376793387,p3palazzo,39,0,9,9,0.411377,0.416116,0.002435,"#00e8b2"
3377452318,bigdata_uned,46,0,9,9,0.401651,0.528012,0.002435,"#ffb800"
3378848170,LorenaLpzMdz,15,1,3,4,0.531925,0.470267,0,"#006032"
3379046265,PedagogyAmLitSt,12,0,5,5,0.328895,0.414608,0.000487,"#ff77ff"
3382715824,investigarCUC,26,0,4,4,0.294503,0.372459,0,"#3e93ff"
3383146937,gunde_bravo,21,2,5,7,0.483387,0.630562,0.001461,"#ffb800"
3384804742,ohara_j,39,0,5,5,0.430232,0.368818,0.000487,"#00e8b2"
3388784469,lingwars,49,25,11,36,0.367793,0.54451,0.015587,"#ffa64e"
3388805573,dh2016krakow,1,20,0,20,0.375691,0.561814,0.007793,"#ffb800"
3389486200,FundacionBBVA,48,207,24,231,0.510539,0.480929,0.11057,"#ff0d69"
3395795027,SDocumentalista,48,7,12,19,0.469237,0.577286,0.007306,"#008ebb"
3398901891,Exhibitium1,15,45,88,133,0.430583,0.530481,0.062835,"#ff0d69"
3431005967,caicyt,46,85,49,134,0.33464,0.541005,0.063322,"#3bec00"
3432611499,MujeresTech,46,3,3,6,0.475487,0.641891,0.000974,"#ffb800"
3436070188,csdhschn,0,4,2,6,0.391423,0.435012,0.000974,"#ffb800"
3452624963,juanumbarila1,19,0,5,5,0.391519,0.443702,0.000487,"#3e93ff"
3452948117,karl_jacoby,12,0,8,8,0.310903,0.447415,0.001948,"#ff77ff"
3475489514,Ssaucedo5050,26,19,7,26,0.318572,0.31673,0.010716,"#3e93ff"
3502238717,PalabrasRevist,46,2,3,5,0.307614,0.511699,0.000487,"#3bec00"
3503016755,rdiaz2016,19,0,5,5,0.638679,0.682748,0.000487,"#5456a6"
3508896378,AlessaKirchhoff,0,1,4,5,0.43084,0.43936,0.000487,"#3e93ff"
3535637368,UnedSegovia,46,0,4,4,0.449301,0.57733,0,"#ffb800"
3561415156,staticum,47,2,2,4,0.224103,0.442964,0,"#7e8b76"
3568118183,UMinho_Oficial,54,17,0,17,0.45898,0.482702,0.006332,"#c6cc85"
3585759137,academiaplay,1,8,0,8,0.426052,0.524428,0.001948,"#ff12a3"
3586372212,bibnewsbr,39,0,4,4,0.508182,0.354741,0,"#00e8b2"
3644026876,serlosan,18,12,0,12,0.162723,0.594811,0.003897,"#8ecfec"
3666400636,rugamarspr,12,0,5,5,0.266484,0.407684,0.000487,"#ff77ff"
3699733173,M_T_Miller,12,0,5,5,0.360279,0.424465,0.000487,"#ffb800"
3731574142,nucleoREA,54,1,3,4,0.538232,0.641277,0,"#c6cc85"
3737540126,evillegasme,16,3,1,4,0.313733,0.228598,0,"#3e93ff"
3740754315,MediaLabUTPL,9,3,3,6,0.313339,0.117853,0.000974,"#ff7a78"
3759433037,BenjaminGalacho,15,7,3,10,0.536096,0.511792,0.002923,"#ff0d69"
3773726002,tarushijio,39,13,0,13,0.373356,0.132596,0.004384,"#00e8b2"
3784265182,yezidalejandro,12,0,7,7,0.391626,0.407664,0.001461,"#ff77ff"
3801151648,CementerioLibro,21,4,47,51,0.573611,0.724086,0.022893,"#ffa64e"
3808295716,As94Dani,46,0,7,7,0.455167,0.609049,0.001461,"#ffb800"
3825053357,UGR_Igualdad,15,0,4,4,0.550047,0.53978,0,"#006032"
3832226723,AtlasLitterae,15,4,0,4,0.528029,0.493589,0,"#006032"
3841365562,PedroUrbano79,39,2,2,4,0.447271,0.434803,0,"#00e8b2"
3841576157,carga_viral,31,0,4,4,0.538878,0.396048,0,"#ff0d69"
3874106183,majodominguez13,54,3,9,12,0.532749,0.430337,0.003897,"#c6cc85"
3879371157,peregrina_babel,46,1,14,15,0.341617,0.533258,0.005358,"#ffb800"
3883068573,ArcheoAndrea,50,19,6,25,0.613192,0.491709,0.010229,"#008bdd"
3898454296,enetreseles,12,1,5,6,0.357445,0.439434,0.000974,"#ff77ff"
3935729837,IEMYRhd,28,38,13,51,0.379233,0.565543,0.022893,"#8ecfec"
3940349189,HdelArteUMA,15,1,5,6,0.483966,0.504885,0.000974,"#ff0d69"
3948385336,invest_ull,48,6,1,7,0.565182,0.679529,0.001461,"#008ebb"
3954714135,GuadamillasG,37,8,7,15,0.489315,0.613151,0.005358,"#fcae7e"
3957672539,ConsejoEFFYL,15,1,3,4,0.511675,0.527552,0,"#ff0d69"
3980710997,GardeJulian,37,4,7,11,0.481884,0.601844,0.00341,"#fcae7e"
3982698389,projeto_enders,39,17,54,71,0.397557,0.383925,0.032635,"#00e8b2"
3993008607,LuisGethsemani,49,4,0,4,0.474662,0.445177,0,"#3bec00"
3993191961,IEAL_US,22,9,11,20,0.355871,0.583108,0.007793,"#8ecfec"
3995456566,MaseleUS,22,1,7,8,0.372354,0.62097,0.001948,"#8ecfec"
4003308496,OElwes,37,0,4,4,0.437255,0.601346,0,"#fcae7e"
4008445576,DHiNorden,0,2,3,5,0.327262,0.406128,0.000487,"#ffb800"
4009999396,CecilyRaynor,0,14,8,22,0.349135,0.452422,0.008768,"#3e93ff"
4010332275,trinidad_arcos,37,0,7,7,0.515149,0.588808,0.001461,"#ffb800"
4017887925,becalpy,36,50,7,57,0.108316,0.467301,0.025816,"#00e8b2"
4048650860,HdigitalesAL,0,278,183,461,0.395764,0.491251,0.222601,"#3e93ff"
4048684288,Udelaruy,54,22,5,27,0.561566,0.662457,0.011203,"#c6cc85"
4048787009,MellonFdn,12,111,2,113,0.271687,0.410081,0.053093,"#ff77ff"
4053496954,universidad_si,49,3,3,6,0.546716,0.404448,0.000974,"#ffa64e"
4062465010,IFTS13,46,0,7,7,0.342115,0.547848,0.001461,"#3bec00"
4107241000,ActLenguas,10,9,0,9,0.257091,0.190421,0.002435,"#3e93ff"
4119351137,EstrellaDist,48,0,8,8,0.478284,0.525396,0.001948,"#008ebb"
4126322681,odi_madrid,48,1,3,4,0.487591,0.643584,0,"#008ebb"
4136598983,pabblo_h,36,3,6,9,0.124275,0.460945,0.002435,"#403538"
4152771843,_cocomaya,12,0,4,4,0.389552,0.408775,0,"#ff77ff"
4162410142,anwagnerdreas,12,3,29,32,0.376132,0.491883,0.013639,"#ff77ff"
4180929853,FundacionColmex,26,0,4,4,0.317669,0.326177,0,"#3e93ff"
4219421915,tanakaken14,1,0,4,4,0.430725,0.457172,0,"#ff0d69"
4220074768,PilarArrabal4,22,7,4,11,0.417806,0.581195,0.00341,"#8ecfec"
4236674193,gabra_lopes,39,0,6,6,0.405888,0.306859,0.000974,"#00e8b2"
877077240613359617,Hismedi,21,110,221,331,0.5419,0.736067,0.159279,"#ffa64e"
882649993013800963,MESA_MH_LATINA,21,4,1,5,0.603825,0.762524,0.000487,"#ffa64e"
826102642002817025,APPRecovery,12,270,77,347,0.271699,0.418811,0.167073,"#ff77ff"
967503330066010112,Real_Person_DH,0,0,164,164,0.380465,0.449637,0.077935,"#ff77ff"
1353711333951344640,DigiPhiLit,25,19,24,43,0.435988,0.566112,0.018997,"#8ecfec"
987712090071814144,DigtalHumanatee,12,0,443,443,0.393301,0.455972,0.213833,"#ff77ff"
1445694375573348357,Dynatinc,49,25,17,42,0.464841,0.460237,0.018509,"#3bec00"
4866400552,glaincorona,25,3,26,29,0.415392,0.548227,0.012177,"#8ecfec"
979085614686629895,tthubio,49,12,5,17,0.348843,0.478241,0.006332,"#3bec00"
940970240279801861,revista_hd,0,423,106,529,0.372064,0.483795,0.255723,"#3e93ff"
733704319833346050,HDCAICYT,46,238,1819,2057,0.293911,0.602925,1,"#3bec00"
830233215050928128,RevistaAcervo,39,31,4,35,0.416971,0.350203,0.0151,"#00e8b2"
1432168801655734275,Redlatdigital,49,4,0,4,0.412198,0.444192,0,"#3bec00"
1318992064168722435,MSUGlobalDH,0,8,8,16,0.423319,0.479377,0.005845,"#3e93ff"
750996397684617218,floresbenat,35,3,5,8,0.494108,0.527319,0.001948,"#c42c63"
1168169867482226696,martalecturas,22,4,8,12,0.399962,0.58123,0.003897,"#8ecfec"
869673002765623297,AlmudenaVido,25,6,19,25,0.366051,0.532803,0.010229,"#ff0d69"
1227326334386540544,dxvidmr,46,41,61,102,0.379914,0.507014,0.047735,"#ff0d69"
4893661588,luispcordero,22,5,2,7,0.31009,0.522261,0.001461,"#8ecfec"
1306286577820327937,catalogocuento,17,21,1,22,0.233693,0.560037,0.008768,"#ff77ff"
837213971744702464,fjimcal,22,0,6,6,0.386253,0.678531,0.000974,"#8ecfec"
1089215646020313090,Veristonelli,39,0,6,6,0.412835,0.364639,0.000974,"#00e8b2"
706852789792710656,Transkribus,39,7,2,9,0.462783,0.445425,0.002435,"#00e8b2"
718699558243405824,VidaInmanente,0,8,54,62,0.366408,0.483812,0.028251,"#3e93ff"
1452361182791311364,LeshePepe,21,0,4,4,0.587187,0.800744,0,"#ffa64e"
732901190397251584,Memoria_Publica,21,4,0,4,0.599589,0.797778,0,"#ffa64e"
898610394385743872,LADESBANDA,21,5,4,9,0.584622,0.789713,0.002435,"#ffa64e"
978228278493401088,CORTdMUSCLO,21,0,4,4,0.579627,0.800978,0,"#ffa64e"
735059281494544384,hilame_info,48,75,68,143,0.42751,0.569089,0.067706,"#008ebb"
931553177157230592,HumanitiesGU,0,6,0,6,0.388262,0.467209,0.000974,"#ffb800"
1036325562271322118,IesSanRoque,46,2,3,5,0.330329,0.735087,0.000487,"#ffb800"
1032947615414067200,ltiufpb,39,12,0,12,0.433667,0.342672,0.003897,"#00e8b2"
949283920222281728,ClioVis,12,0,72,72,0.35504,0.432783,0.033122,"#ff77ff"
751405862820802560,gbaezaventura,12,34,11,45,0.315397,0.430838,0.019971,"#ff77ff"
1377296194070798338,ProyectoLitPR,12,23,6,29,0.260137,0.390811,0.012177,"#ff77ff"
831165079164960768,ibero_historia,12,62,8,70,0.352178,0.353958,0.032148,"#ff77ff"
1248387098585051136,0jonjo,39,22,41,63,0.370169,0.376591,0.028738,"#00e8b2"
1141364337065582593,CentroCham,39,31,6,37,0.413313,0.38465,0.016074,"#00e8b2"
1176406930031595520,comcomunes,22,21,10,31,0.351689,0.645155,0.013151,"#8ecfec"
1032572338435448832,Journal_Iti,22,8,0,8,0.376426,0.52603,0.001948,"#8ecfec"
1393251606179745794,BotUFBA,39,0,6,6,0.394895,0.275107,0.000974,"#00e8b2"
737142202481016832,chidambara09,48,0,24,24,0.356572,0.472669,0.009742,"#ff0d69"
1147108534850658304,techie_wiz,1,0,5,5,0.344479,0.497226,0.000487,"#825403"
822902501645041664,sferna109,35,64,64,128,0.299536,0.416832,0.060399,"#c42c63"
1400173944712351747,Alexand04132949,39,3,6,9,0.380779,0.294856,0.002435,"#00e8b2"
1249741114103549952,HomenajeREP,21,3,2,5,0.558914,0.788884,0.000487,"#ffa64e"
1340369822765477893,AgoraColectivo,36,0,4,4,0.370015,0.422809,0,"#00e8b2"
705358078779199488,mhhdUPO,22,7,71,78,0.357962,0.514272,0.036045,"#8ecfec"
787603018086805504,LaSemyr,28,76,29,105,0.413016,0.533346,0.049196,"#8ecfec"
1298687874112671751,BotLabhd,39,6,557,563,0.38829,0.382838,0.272284,"#00e8b2"
1047876707246592000,reseau_EFE,49,0,4,4,0.540405,0.457962,0,"#3bec00"
4443585197,clairedjimenez,12,0,9,9,0.283693,0.413219,0.002435,"#ff77ff"
1196167915864776704,VanguardiaVirt1,35,0,9,9,0.348202,0.61479,0.002435,"#c42c63"
4603820789,muyfandel36,21,4,0,4,0.586862,0.765467,0,"#ffa64e"
1479091184215760902,educaclio,49,2,2,4,0.492802,0.435827,0,"#3bec00"
1072791998103543810,ArqueoURJC,49,1,3,4,0.48566,0.429124,0,"#3bec00"
1409898130313822219,Memorizate_,21,3,2,5,0.489814,0.649991,0.000487,"#ffa64e"
765190598085185536,UofTDHN,0,7,4,11,0.397741,0.446234,0.00341,"#ff0d69"
883479820117651456,LGauth19,12,80,38,118,0.282086,0.430455,0.055528,"#ff77ff"
1494298675606171653,iehm_uib,28,3,4,7,0.287361,0.557994,0.001461,"#8ecfec"
1454555426549288963,ElenaTruan,28,4,1,5,0.262121,0.537998,0.000487,"#8ecfec"
1328450174688038915,uhcuba,17,4,0,4,0.626451,0.605492,0,"#6c241e"
1340312202159542274,ufscbot,39,0,4,4,0.396379,0.349446,0,"#00e8b2"
725445697382809600,knowmetrics,15,222,109,331,0.440843,0.492845,0.159279,"#006032"
1380487097711259650,Mariola07431020,46,0,4,4,0.456165,0.543923,0,"#ffb800"
753531336816730112,UNEDBruselas,46,2,2,4,0.429401,0.675462,0,"#ffb800"
1097580840685658114,PaisPti,49,0,8,8,0.45297,0.476951,0.001948,"#ff0d69"
4923600039,FilologiaUsal,28,12,6,18,0.386861,0.53229,0.006819,"#8ecfec"
948178046045032448,kr_wittmann,48,9,12,21,0.49148,0.609115,0.008281,"#ff0d69"
968267480002121729,EHEITESM,36,24,11,35,0.261229,0.476174,0.0151,"#6c241e"
1030179869244764161,hangryhistorian,12,1,6,7,0.252763,0.401728,0.001461,"#ff77ff"
1243236136765489152,CateAgostini,39,45,19,64,0.366336,0.321713,0.029226,"#00e8b2"
1324278660111753218,hdh2021,49,80,17,97,0.425405,0.511168,0.0453,"#ff0d69"
1252313225011449856,OpenSciTalk,48,0,19,19,0.428398,0.513676,0.007306,"#008ebb"
794497864827359233,lupefrutos,25,0,19,19,0.359445,0.510541,0.007306,"#ff0d69"
1493140343335923718,Humd2122B,12,3,3,6,0.368032,0.452083,0.000974,"#ff77ff"
977081431833894912,gus_candela,12,8,26,34,0.398689,0.478378,0.014613,"#ff77ff"
837025047369945101,literatricia,48,0,31,31,0.413564,0.566368,0.013151,"#ffb800"
1257488000318976000,digihis,0,1,68,69,0.389619,0.496985,0.031661,"#3e93ff"
1323025564396113921,tekoaunila,49,10,3,13,0.44947,0.43501,0.004384,"#3bec00"
1292538421815193601,AgenciasH,12,28,15,43,0.469957,0.407485,0.018997,"#3bec00"
1383372332362731526,ArqueoBarros,49,4,0,4,0.47408,0.450399,0,"#3bec00"
1148918384807096321,izzzetan,25,0,6,6,0.402994,0.534988,0.000974,"#ffb800"
1450805981341011980,IAM_CSIC,49,0,4,4,0.505865,0.434091,0,"#3bec00"
1468602631115665408,ArchaeoFer,21,2,2,4,0.478972,0.546015,0,"#ffa64e"
877193871612137472,romanceiropt,39,2,2,4,0.458829,0.432588,0,"#00e8b2"
1394432849332211713,NewBooksNenesp,49,4,3,7,0.381258,0.61189,0.001461,"#3bec00"
1065266673563967488,ehuprest,36,5,0,5,0.499003,0.441826,0.000487,"#00e8b2"
1114561228041486336,map_usp,39,7,6,13,0.202544,0.515848,0.004384,"#00e8b2"
766230286535430144,ETSIIUNED,46,16,25,41,0.443191,0.540525,0.018022,"#ffb800"
1354776515473530888,humanidadesual,0,4,0,4,0.336296,0.430262,0,"#00e8b2"
1260629589346463744,_TFbot,0,0,7,7,0.332978,0.440875,0.001461,"#3e93ff"
1392410868613328896,SINCRISIS1,49,3,3,6,0.332109,0.54955,0.000974,"#ff0d69"
704613732614344704,uSIG_CCHS_CSIC,48,209,64,273,0.455572,0.547238,0.131028,"#008ebb"
1398514088645480448,pavaobot,36,5,389,394,0.427095,0.415814,0.189966,"#00e8b2"
801119508161236992,LibretaNegraMx,36,8,4,12,0.440437,0.365385,0.003897,"#00e8b2"
1306626901432324097,rstats_tweets,12,0,4,4,0.425427,0.422263,0,"#ff77ff"
1011817655957893120,rstatstweet,0,0,16,16,0.37339,0.472231,0.005845,"#3e93ff"
1219950181808070656,humboldtdigital,46,25,23,48,0.35848,0.481329,0.021432,"#3bec00"
1272656470782423040,CfpSpanish,25,0,7,7,0.393352,0.536787,0.001461,"#ff0d69"
724702270890323968,dhd2022,39,5,2,7,0.382806,0.432245,0.001461,"#00e8b2"
1300386336214577153,GarrochoS,49,12,1,13,0.64062,0.489428,0.004384,"#ffa64e"
751092352320667649,ReHDi_Co,19,234,55,289,0.410818,0.447727,0.138821,"#3e93ff"
922964946463416320,PUEC_UNAM,36,5,0,5,0.526903,0.222734,0.000487,"#00e8b2"
1076885700073668610,humanistasual,36,4,2,6,0.31079,0.414645,0.000974,"#00e8b2"
1468328965903368193,UAL_RacingTeam,36,5,0,5,0.294153,0.381041,0.000487,"#00e8b2"
4918282330,gamedinafrias,12,1,4,5,0.495263,0.374708,0.000487,"#ff77ff"
1259878565946023937,FactorData,36,23,3,26,0.133829,0.417274,0.010716,"#403538"
835239883857936386,B_GarridoRamos,46,18,36,54,0.396222,0.522864,0.024355,"#ffb800"
1484978715721445378,Cripto_B_Art,36,3,1,4,0.447608,0.461329,0,"#00e8b2"
708324971475542016,PosgradosUCES,46,24,0,24,0.34886,0.500412,0.009742,"#3bec00"
1319336780060151809,EcosPatrimonial,36,2,2,4,0.434538,0.384425,0,"#00e8b2"
4369790956,Martxoak3,21,9,1,10,0.527291,0.666888,0.002923,"#ffa64e"
1126575028852744193,AlcantaraPla,49,43,31,74,0.44726,0.527583,0.034096,"#ffa64e"
1418572460048494593,AnrVismin,39,4,4,8,0.438442,0.480109,0.001948,"#3bec00"
735482871754969088,psigehess,39,3,4,7,0.44483,0.51904,0.001461,"#3bec00"
1379360130131693569,ESCiencia_CSIC,48,3,5,8,0.41196,0.530083,0.001948,"#008ebb"
1361796898772963328,Profe_EmeGe,0,0,5,5,0.453524,0.395035,0.000487,"#3e93ff"
1042858258975875073,dgbsdiuaq,0,29,15,44,0.362304,0.435597,0.019484,"#3e93ff"
1225159200013156352,ricnomah,46,0,15,15,0.331538,0.486764,0.005358,"#3bec00"
992943418052460544,ricardo_ik_ahau,0,0,22,22,0.424343,0.412989,0.008768,"#3e93ff"
1415252910972231684,HumanidadesUPV,17,4,0,4,0.395416,0.482783,0,"#ff77ff"
908709861755641857,AlavaMedieval,48,1,8,9,0.458144,0.540187,0.002435,"#008ebb"
865014834143928322,Scripta_,48,59,73,132,0.450805,0.548349,0.062348,"#008ebb"
848222675227070464,medievalitis,48,47,10,57,0.44815,0.562179,0.025816,"#008ebb"
1378984636546682882,PMedhis,48,13,13,26,0.43187,0.513276,0.010716,"#008ebb"
861502060646346752,CongHDOlladasIM,48,19,19,38,0.402093,0.545593,0.016561,"#008ebb"
1070257033847472128,PetrifyingW,48,7,2,9,0.431332,0.556909,0.002435,"#008ebb"
1194379900339269632,HD_TecMonterrey,0,16,21,37,0.340592,0.504403,0.016074,"#3e93ff"
1493156495843856390,DHum2122S,39,7,4,11,0.429265,0.402957,0.00341,"#00e8b2"
1267475661280677888,libromedieval,48,14,10,24,0.444778,0.55559,0.009742,"#008ebb"
1257122912894672896,AndreaMPicaso,36,11,3,14,0.188082,0.456084,0.004871,"#00e8b2"
1420464728195862529,bnmx_,0,5,2,7,0.326698,0.388602,0.001461,"#3e93ff"
1133663771866685444,quentinmouchet,49,5,2,7,0.450087,0.439343,0.001461,"#3bec00"
980191735757377536,alandio_,49,4,4,8,0.507669,0.471509,0.001948,"#3bec00"
1493519197867061248,Dhum2122H,12,0,5,5,0.230467,0.491118,0.000487,"#ff77ff"
1064229467516747776,elMUELLEdelaSAL,1,4,12,16,0.357128,0.507784,0.005845,"#825403"
956187441857290242,revistatelos,1,123,25,148,0.355204,0.530895,0.070141,"#825403"
1377810525845880840,PequeninWarrior,1,0,16,16,0.336076,0.443954,0.005845,"#825403"
1249485951539150848,labinnovaso,15,0,6,6,0.412186,0.541428,0.000974,"#006032"
710827419394043904,MariePuren,0,1,4,5,0.329278,0.436798,0.000487,"#ffb800"
1392309512409812992,dh_japan,0,19,8,27,0.352738,0.452028,0.011203,"#ffb800"
735929506897235968,DigitalHumASA,0,14,0,14,0.352545,0.442477,0.004871,"#ffb800"
4327889474,aaDHumanities,0,15,3,18,0.359264,0.449883,0.006819,"#ffb800"
767745379957747712,luzmagcruz,17,1,10,11,0.41124,0.551943,0.00341,"#3bec00"
957205791173414912,Javi_Fdez_,48,0,10,10,0.44426,0.496539,0.002923,"#008ebb"
749138439061274624,lsorianorobles,48,0,4,4,0.473903,0.587637,0,"#008ebb"
1082399728850124802,GUILLEMEMORIA,36,0,18,18,0.444351,0.470617,0.006819,"#6c241e"
978453592561672192,larhud1,39,95,23,118,0.386777,0.408453,0.055528,"#00e8b2"
701832220089126912,coleman_kevin_p,12,9,0,9,0.232621,0.28494,0.002435,"#ff77ff"
783376447964676096,amoterocleves,19,1,6,7,0.416752,0.407465,0.001461,"#00ed5d"
1410357787272617985,ArtesUniandes,19,62,7,69,0.405868,0.427253,0.031661,"#ff77ff"
906917734700679173,LoveALinguist,22,0,5,5,0.353449,0.587843,0.000487,"#8ecfec"
978080298964602880,danilopenagosj,12,3,7,10,0.303218,0.404891,0.002923,"#ff77ff"
1176841765518790656,CanabarroRonald,39,5,0,5,0.345429,0.418637,0.000487,"#3bec00"
815908947181916160,LHFC_UNED,34,1,5,6,0.523092,0.586004,0.000974,"#ffb800"
1464147760148811777,PortalEDIRED,48,21,3,24,0.476648,0.6232,0.009742,"#008ebb"
1186504068954497025,Nanny89497957,48,0,9,9,0.446075,0.590253,0.002435,"#ffb800"
1071235686978609156,dhuppsala,12,6,1,7,0.38563,0.423116,0.001461,"#ff77ff"
715553633337737216,Master_HD_UAB,0,77,60,137,0.437712,0.511561,0.064783,"#ff0d69"
1155016546005258240,MCBouju,49,0,7,7,0.413107,0.434643,0.001461,"#3bec00"
1082826724935696386,liteharto,0,68,39,107,0.364347,0.458502,0.05017,"#3e93ff"
1048767035298205696,RedArchivos,0,13,28,41,0.398885,0.486309,0.018022,"#3e93ff"
1191725643932848130,saberfuturo,10,18,0,18,0.043506,0.613786,0.006819,"#3bec00"
781829562858663936,PoloDigitalMLG,15,31,4,35,0.549118,0.531104,0.0151,"#ff0d69"
1455392005404647429,ValleImu,12,0,7,7,0.227222,0.346585,0.001461,"#3e93ff"
1050470446687244289,_amayamendiko,49,1,6,7,0.440548,0.554931,0.001461,"#ffa64e"
1459974034985299970,Adesvergonzadas,21,5,3,8,0.637382,0.609947,0.001948,"#ffa64e"
1020295818144776192,AAlvarezOssorio,49,1,6,7,0.56706,0.465485,0.001461,"#3bec00"
1182676934842564609,Lab_HDig,39,52,34,86,0.413852,0.407136,0.039942,"#00e8b2"
1239277391656235013,MBelenBoned,48,0,6,6,0.404422,0.611407,0.000974,"#008ebb"
850329407986249729,StuTS_official,49,4,0,4,0.375269,0.421272,0,"#3bec00"
1343516679893094400,Barbararomf,0,0,4,4,0.428189,0.518924,0,"#ff0d69"
964273201323872257,SilviaMonMar,15,4,3,7,0.636142,0.561591,0.001461,"#ffb800"
1231952570412867585,luppa_ufrgs,39,14,0,14,0.423128,0.249195,0.004871,"#00e8b2"
1126277650211905536,DeniseFrigo2,0,2,61,63,0.38739,0.447458,0.028738,"#3e93ff"
1170963542243196928,OrrequiaAroa,0,4,10,14,0.359238,0.524613,0.004871,"#3e93ff"
1104444221778550786,EEsp01,36,0,4,4,0.167708,0.482963,0,"#00e8b2"
1349415055931170817,cespeparaguay,36,0,4,4,0.162742,0.476114,0,"#00e8b2"
1109452906028240896,enfanthese,12,0,12,12,0.410982,0.466442,0.003897,"#ff77ff"
911193053641273344,openmethods_dh,46,29,4,33,0.333164,0.466178,0.014126,"#3bec00"
1065392962975264768,filologicos,22,0,10,10,0.37299,0.523135,0.002923,"#8ecfec"
4821514037,BlogAhoraELE,22,0,4,4,0.334626,0.711175,0,"#8ecfec"
1158520085528506368,GaleLATAM,10,8,5,13,0.338932,0.370588,0.004384,"#3bec00"
704300151423242240,Actres_ule,22,0,4,4,0.360651,0.55931,0,"#8ecfec"
1109082720418914305,mlochoafer,22,0,4,4,0.385683,0.673843,0,"#8ecfec"
780760636493959169,marsosinski,22,0,5,5,0.385264,0.641656,0.000487,"#8ecfec"
1372566239126695942,MusivariaHD,46,5,4,9,0.462993,0.496267,0.002435,"#ffb800"
1184863774081241088,CinemahMov,15,11,1,12,0.606668,0.276553,0.003897,"#006032"
1098294086853906438,AndreaConsalvi,0,0,5,5,0.396753,0.461116,0.000487,"#3e93ff"
1466045589314015236,C21editions,49,0,4,4,0.316845,0.486686,0,"#3bec00"
828863719434235904,RadioLabUGR,15,11,8,19,0.483563,0.499452,0.007306,"#006032"
1237515474755375104,labhdufba,39,106,22,128,0.407646,0.37165,0.060399,"#00e8b2"
1202753815130394624,lf_slima,39,7,9,16,0.42679,0.283781,0.005845,"#00e8b2"
1051987905877397505,IJIDI1,0,11,2,13,0.363187,0.470728,0.004384,"#3e93ff"
1224122905753088000,m_h_ramirez,12,0,5,5,0.301607,0.429602,0.000487,"#ff77ff"
1370244144816349187,herdado,0,54,11,65,0.370027,0.463995,0.029713,"#3e93ff"
1270516534348300288,Castordebiblio,0,0,8,8,0.391464,0.494769,0.001948,"#3e93ff"
991771874488147968,RaquelLiceras,10,12,11,23,0.385247,0.463679,0.009255,"#00ed5d"
727614583922397185,f_humanidades,22,14,15,29,0.390489,0.534724,0.012177,"#8ecfec"
738094354045210625,Cdosvecesdom,0,2,10,12,0.423709,0.422741,0.003897,"#3e93ff"
1415635407946100736,FormacionP_UNED,46,8,4,12,0.413936,0.60897,0.003897,"#8ecfec"
885944535766978560,FabioMinervini,39,7,23,30,0.415263,0.369308,0.012664,"#00e8b2"
1321167701075808257,padredemiranda,36,2,2,4,0.652932,0.227903,0,"#00e8b2"
1104108075387179013,MiguelAntonioG_,36,5,2,7,0.605096,0.27204,0.001461,"#00e8b2"
891804290737737728,EdgardoTempore1,46,4,15,19,0.370655,0.516822,0.007306,"#3bec00"
927647719782539265,IvonneSosaSanM1,27,0,4,4,0.953609,0.182771,0,"#00ed5d"
714783444757254150,cazadorcerebros,27,27,4,31,0.900858,0.198255,0.013151,"#00ed5d"
902243707403063297,JesSalasAlvarez,49,0,4,4,0.440809,0.474614,0,"#3bec00"
822406859571204096,uned_filologia,46,45,13,58,0.422676,0.574681,0.026303,"#8ecfec"
1187326637983055873,LeidyJTorresC,19,0,5,5,0.401092,0.427888,0.000487,"#00ed5d"
1127630178644054018,stem_ai,1,0,8,8,0.329448,0.511904,0.001948,"#825403"
1154746676294422529,AnaDiamond16,27,0,4,4,0.938887,0.195833,0,"#00ed5d"
1158580779687059457,YoanaEstradaR,27,0,4,4,0.902439,0.172533,0,"#00ed5d"
1451105184009105410,big_onion_tech,27,0,4,4,0.915024,0.174997,0,"#00ed5d"
1404480457106939904,internacionalzp,39,0,5,5,0.46058,0.275962,0.000487,"#00e8b2"
1160606541604687873,cienlib,27,0,4,4,0.934708,0.193418,0,"#00ed5d"
1225487599147634688,SpinosaVittoria,27,0,4,4,0.911749,0.185614,0,"#00ed5d"
1235317545361641474,AmarillePer,27,0,4,4,0.919638,0.188186,0,"#00ed5d"
1025669551323848704,Thuban_Isesi,27,0,5,5,0.810649,0.279406,0.000487,"#00ed5d"
1446511093606662147,Cultureclub_100,27,0,4,4,0.950438,0.185417,0,"#00ed5d"
1039779177740873728,iesneruda,27,0,4,4,0.9016,0.18296,0,"#00ed5d"
1131348955256762369,Micaela12104980,27,0,4,4,0.940922,0.172168,0,"#00ed5d"
792326791616663552,misspornotv,27,0,4,4,0.932723,0.174842,0,"#00ed5d"
1274910124025487360,FIKM19,48,6,1,7,0.510307,0.540647,0.001461,"#008ebb"
4485077452,RebecaRubioR,37,40,25,65,0.46518,0.565083,0.029713,"#fcae7e"
1171340194542424066,IberlabE,15,3,6,9,0.393529,0.491936,0.002435,"#3bec00"
1300083781500645378,srsergior,19,1,5,6,0.419701,0.428323,0.000974,"#3e93ff"
1216723370210988032,HispaniaUdc,0,30,12,42,0.433922,0.48138,0.018509,"#ff0d69"
1374782833542234114,_sgesther_,34,1,4,5,0.500727,0.589543,0.000487,"#ffb800"
1355167841985716224,JavierMdMG,0,0,4,4,0.433499,0.473097,0,"#ff0d69"
4837861482,fcomUH,17,33,8,41,0.576442,0.536551,0.018022,"#6c241e"
988881035147534337,JuanCarlosFlorG,37,3,4,7,0.490518,0.465639,0.001461,"#fcae7e"
826204298069557249,452FJournal,25,12,1,13,0.36136,0.591153,0.004384,"#8ecfec"
1070512911364149248,vero_benitezp,35,21,25,46,0.316206,0.426365,0.020458,"#c42c63"
1359160680901935114,aeonfers,35,7,4,11,0.261381,0.428495,0.00341,"#c42c63"
4727030752,ArqueoRomARCYT,37,8,6,14,0.52181,0.666593,0.004871,"#fcae7e"
763212059890814976,DigitalLabUDP,10,27,36,63,0.321624,0.465188,0.028738,"#3bec00"
1339077984410611712,ObservatorioGDC,17,0,6,6,0.582662,0.699287,0.000974,"#6c241e"
1007306542268534784,CanariasCultur,37,4,5,9,0.505174,0.551854,0.002435,"#ffb800"
1058363812976451586,EncuentrosucmHA,0,17,5,22,0.423108,0.540298,0.008768,"#ff0d69"
865130942381338625,rosarioariasUMA,15,2,24,26,0.440739,0.501241,0.010716,"#ff0d69"
909456000700289026,2017_liraucio,0,0,4,4,0.365354,0.389105,0,"#3e93ff"
903262935618908160,LabCaHID,19,60,12,72,0.404071,0.441816,0.033122,"#00ed5d"
961637173266132992,AmigosAHN,48,1,8,9,0.50078,0.47894,0.002435,"#008ebb"
1295488409302118407,sbhciencia,39,7,1,8,0.369175,0.307606,0.001948,"#00e8b2"
727984050816856064,leogued,54,0,9,9,0.551953,0.656249,0.002435,"#c6cc85"
1174339812700151808,Corpus_ODE,22,14,7,21,0.430568,0.567319,0.008281,"#8ecfec"
1062639282937122816,CulturaUbu,12,0,13,13,0.428297,0.475645,0.004384,"#ff77ff"
1025165016620847104,podcastRAH,19,10,25,35,0.364606,0.377713,0.0151,"#3e93ff"
1385695122042523648,ExpHD_UdeA,0,0,31,31,0.412975,0.48546,0.013151,"#3e93ff"
1131572463597477890,Hitz_zentroa,12,25,16,41,0.380693,0.482697,0.018022,"#ff77ff"
1251928046036279296,REMED_20,0,0,4,4,0.357562,0.455254,0,"#3e93ff"
823878281695035394,siglo_18,28,0,8,8,0.459858,0.404619,0.001948,"#8ecfec"
1238212851262722048,Ciclos_udp,10,5,5,10,0.24557,0.465679,0.002923,"#3bec00"
1012809059320389633,DH2022_Tokyo,0,2,2,4,0.322031,0.444515,0,"#3e93ff"
717642000871333888,haplapemlct,12,5,4,9,0.37077,0.475762,0.002435,"#ff77ff"
871356497401454597,MedGoldenAge,28,6,15,21,0.387773,0.508677,0.008281,"#8ecfec"
735382172476018689,cjulialuna,46,24,13,37,0.382021,0.603313,0.016074,"#8ecfec"
1082828825556381698,sarahrubia,39,1,6,7,0.419783,0.387981,0.001461,"#00e8b2"
1138533277818601475,FundacionByB,10,2,2,4,0.273467,0.445297,0,"#3bec00"
1209204504165539840,cperezjimenez01,12,6,0,6,0.326829,0.42396,0.000974,"#ff77ff"
725441203118944256,jbretmaney,12,3,2,5,0.292385,0.438564,0.000487,"#ff77ff"
1386623724280074241,ProjectSemap,49,2,2,4,0.274149,0.455622,0,"#3bec00"
1278815100309254144,HuellasIncomoda,35,10,2,12,0.328629,0.418617,0.003897,"#c42c63"
1354157563114364929,iamgabbarson,49,0,6,6,0.325083,0.469126,0.000974,"#3bec00"
707739506603114496,Heritales,0,0,4,4,0.40873,0.48072,0,"#3e93ff"
1203359851973398530,Lidia_PdV,0,2,2,4,0.334598,0.427254,0,"#3e93ff"
1296330472146993152,juancarlos_rozo,0,1,4,5,0.364101,0.440526,0.000487,"#3e93ff"
1044196866353696770,infovestigacion,46,5,6,11,0.227289,0.485541,0.00341,"#3bec00"
745429756812861440,LianaOsorio1,10,10,18,28,0.371462,0.372147,0.01169,"#3e93ff"
1019681556548542464,TichaProject,0,0,5,5,0.38712,0.398338,0.000487,"#3e93ff"
825174189162246144,pdrslvr,39,5,10,15,0.40217,0.345934,0.005358,"#00e8b2"
744696909403684864,Eps5371,10,15,27,42,0.3512,0.390187,0.018509,"#3e93ff"
889429484436418560,cidehus_ue,39,19,1,20,0.456113,0.418653,0.007793,"#00e8b2"
1129829057435230208,_narellano,19,0,4,4,0.134869,0.06881,0,"#ff77ff"
891619821028347904,congresoCICID,46,2,2,4,0.404631,0.670436,0,"#3bec00"
836388241121153024,JMendezMartinez,46,5,19,24,0.396442,0.554781,0.009742,"#3bec00"
1318998016620154881,CarlaoBot,36,0,4,4,0.26454,0.594571,0,"#008ebb"
1321412793497780225,ScienceBot8,39,0,4,4,0.406097,0.216463,0,"#00e8b2"
1222750580390727685,khalilacp,12,0,8,8,0.303187,0.482984,0.001948,"#ff77ff"
977239071041912832,AniaRHdez,0,37,3,40,0.425495,0.457048,0.017535,"#3e93ff"
1243362024127594500,faboramaa,0,2,7,9,0.370539,0.563297,0.002435,"#3e93ff"
1125349461641842696,EuropeanAn,48,5,0,5,0.453506,0.530419,0.000487,"#008ebb"
929574097020956672,ArevaloGuizar,0,6,15,21,0.337629,0.429975,0.008281,"#3e93ff"
1265458935726776326,Elisassgallardo,17,0,10,10,0.347377,0.69993,0.002923,"#3bec00"
1233887141408755712,TransUma,0,7,9,16,0.457253,0.497739,0.005845,"#ff0d69"
4875570585,ArnaldusV,48,5,7,12,0.455425,0.56677,0.003897,"#ff0d69"
913031252034379776,imfcsic,48,39,10,49,0.437569,0.569938,0.021919,"#008ebb"
1014768317716889601,Kiwosancom,54,0,5,5,0.61469,0.596656,0.000487,"#c6cc85"
1300412833725853696,ppghufba,39,0,13,13,0.419984,0.369287,0.004384,"#00e8b2"
1182821034547806209,CEAScdmx,26,3,2,5,0.326899,0.233309,0.000487,"#3e93ff"
1245372231582171137,binobiasutti,39,0,4,4,0.397811,0.276298,0,"#00e8b2"
1356055663135354886,PhiTech_,19,0,7,7,0.423414,0.442524,0.001461,"#ff77ff"
925836225315065857,ManzanillaMiel5,49,0,16,16,0.484307,0.518606,0.005845,"#8ecfec"
1081752531758395392,RuthCaicedo14,12,1,8,9,0.394977,0.453789,0.002435,"#ff77ff"
1221706313450901504,DokumentaV,22,2,15,17,0.393292,0.471979,0.006332,"#8ecfec"
1144979837632876545,Trab211,39,0,4,4,0.418268,0.196116,0,"#00e8b2"
737252789949190149,raul_villgrs,48,10,14,24,0.41568,0.535188,0.009742,"#008ebb"
1249908519559737345,Angalore2,19,2,5,7,0.410007,0.411457,0.001461,"#ff77ff"
1093455743955668992,dominichi,39,0,7,7,0.423204,0.366754,0.001461,"#00e8b2"
720813814904696833,mxlzinha,39,2,7,9,0.41973,0.314016,0.002435,"#00e8b2"
788430113859854336,unicampoficial,39,20,0,20,0.448159,0.259018,0.007793,"#00e8b2"
966406486766292992,hdcicuba,46,35,21,56,0.44249,0.501764,0.025329,"#ffb800"
1270370128014774273,kmanyola,46,0,6,6,0.363792,0.511847,0.000974,"#ffb800"
1213877104657354757,CBDRS_BIDISO,0,18,12,30,0.449429,0.526749,0.012664,"#ff0d69"
992961013879377920,apariciomex,0,0,4,4,0.358335,0.43475,0,"#3e93ff"
745294543507984385,mediateca_inah,0,5,0,5,0.399019,0.482537,0.000487,"#3e93ff"
927406258268844032,fronteriza956,12,18,33,51,0.309681,0.406028,0.022893,"#ff77ff"
1184473847682211841,lenguapodcast,25,2,2,4,0.423071,0.559676,0,"#8ecfec"
719687574428782592,tainacan_l3p,39,7,2,9,0.395856,0.320469,0.002435,"#00e8b2"
818776501617393665,CienciaGob,46,12,0,12,0.391671,0.541818,0.003897,"#ffb800"
771533659815878656,PenelopeUbaldo1,12,0,7,7,0.399672,0.414596,0.001461,"#ff77ff"
1141653316851707905,UNEDfilosofia,46,1,3,4,0.445379,0.583495,0,"#ffb800"
1412777505417740288,pdh_journal,39,4,0,4,0.447375,0.359515,0,"#00e8b2"
921124139850706946,luaramai,19,6,14,20,0.406527,0.40954,0.007793,"#ff77ff"
962303224828039168,Colombianists,19,0,23,23,0.419907,0.438026,0.009255,"#00ed5d"
781570475222769664,BiblioUniAlcala,15,8,0,8,0.521976,0.575519,0.001948,"#006032"
750762938923884544,biblioinefupm,15,3,2,5,0.515002,0.592276,0.000487,"#006032"
1197220698764148736,SOLCHAred,25,0,4,4,0.310559,0.364645,0,"#ff0d69"
982308925151178753,ADerechoCultura,37,11,10,21,0.514424,0.441315,0.008281,"#fcae7e"
1005436073609179137,AModernistas,37,16,7,23,0.508448,0.423834,0.009255,"#fcae7e"
864425724240855040,rsemap,37,21,6,27,0.526331,0.373786,0.011203,"#fcae7e"
787690626225737728,bonzos1979,28,0,4,4,0.599865,0.619949,0,"#00ed5d"
1321066142476193792,isizquierdo1,15,1,3,4,0.542122,0.582176,0,"#006032"
1349781648808833029,MunainGorka,48,16,1,17,0.273938,0.628515,0.006332,"#008ebb"
1098982940695060480,estefanialsalas,0,3,6,9,0.444897,0.509472,0.002435,"#ff0d69"
803996027149778944,Crai_Upr,46,0,4,4,0.460559,0.573524,0,"#ffb800"
925830117623988224,claudiabagla,49,0,4,4,0.460016,0.545592,0,"#ff0d69"
1261368837188063232,100DaysofDH,49,0,10,10,0.319323,0.444332,0.002923,"#3bec00"
781673995343101952,Alba_Comino,10,4,0,4,0.359164,0.435223,0,"#00ed5d"
953205478036836352,DiggingCH,10,18,12,30,0.336965,0.451289,0.012664,"#00ed5d"
4581241035,APuentesBlanco,48,3,8,11,0.459607,0.574898,0.00341,"#008ebb"
1426225987356962816,emilio_vivo,25,3,1,4,0.42284,0.597375,0,"#8ecfec"
1324326310206910465,RAracne,0,26,2,28,0.423925,0.532664,0.01169,"#ff0d69"
1174685846127239169,MundosTrabalho,39,13,17,30,0.397805,0.360586,0.012664,"#00e8b2"
1395682496713531396,UnlockArchives,10,15,3,18,0.417665,0.399074,0.006819,"#00ed5d"
1263419673296670721,ScriptoriumD,0,0,13,13,0.425554,0.514652,0.004384,"#3e93ff"
1435257152382423049,cc2b_bot,21,0,9,9,0.486743,0.523702,0.002435,"#ffa64e"
1396200873169195013,viaje_palabra,36,4,0,4,0.596945,0.335552,0,"#00e8b2"
1009905478053351424,Nerina_EAO,0,3,12,15,0.392899,0.542518,0.005358,"#ff0d69"
963734195293032454,JorgeLeivaRojo,15,6,2,8,0.54845,0.50427,0.001948,"#ff0d69"
1331365041556381703,HistArtUma,15,15,7,22,0.482484,0.490786,0.008768,"#ff0d69"
4645342272,NuclearWolf79,1,14,3,17,0.219181,0.440185,0.006332,"#825403"
1217873092128780288,javierhist,12,0,7,7,0.366303,0.425922,0.001461,"#ff77ff"
926582230784397312,Verukita1,39,5,0,5,0.315859,0.344776,0.000487,"#ff77ff"
1192893485214502912,GalbarroJaime,0,0,15,15,0.400627,0.511161,0.005358,"#ffb800"
1172482407397765123,eea_csic,48,7,2,9,0.290566,0.728482,0.002435,"#ffb800"
1007750569916694528,imorenonava,0,3,3,6,0.417792,0.449124,0.000974,"#3e93ff"
1423291747438714891,NEPEHD,39,19,6,25,0.360299,0.299064,0.010229,"#00e8b2"
1224365686782296064,DigitalesMaster,49,62,47,109,0.417404,0.486964,0.051145,"#ffa64e"
925597948410580993,RoccoLozano,21,4,9,13,0.48709,0.479965,0.004384,"#ffa64e"
1141063687459020800,YPereiraMelo,49,5,9,14,0.471359,0.485629,0.004871,"#ffa64e"
1175349369962475520,IT_GesPub,21,11,18,29,0.550682,0.535061,0.012177,"#ffa64e"
1158792716110749698,foro_deh,36,14,3,17,0.289596,0.339054,0.006332,"#6c241e"
1367865108999897090,andrefmpaiva,39,0,4,4,0.436663,0.384192,0,"#00e8b2"
775163304939511809,huerta_ricard,15,1,4,5,0.482626,0.453344,0.000487,"#006032"
1147824745032945665,StellizHt,27,78,1,79,0.769599,0.208473,0.036532,"#00ed5d"
1252171810289995776,NegueruelaDario,0,0,6,6,0.418439,0.473313,0.000974,"#3e93ff"
1121364987178618880,UNEDNLP,21,2,3,5,0.502739,0.535102,0.000487,"#ffa64e"
1192643174218510336,artemalvac,21,0,4,4,0.612301,0.40228,0,"#ffa64e"
1133523609455091718,modernaemfoco,37,0,4,4,0.499341,0.417094,0,"#fcae7e"
1239231847072235521,GIAP_ICAC,48,1,3,4,0.506715,0.733164,0,"#008ebb"
1217361330786664450,ICAC_cat,48,3,6,9,0.502577,0.739917,0.002435,"#008ebb"
1129762583404253185,agarciag_UAH,21,1,3,4,0.490953,0.447966,0,"#ffa64e"
968902304530337793,AECPA_,21,8,1,9,0.588675,0.508409,0.002435,"#ffa64e"
897940722392813569,CAA_Australasia,0,2,2,4,0.329544,0.41014,0,"#3e93ff"
1414065872495390720,a_solernou,19,0,7,7,0.384196,0.458248,0.001461,"#3e93ff"
1064220753351069702,SilGFerreyra,46,0,6,6,0.402899,0.463795,0.000974,"#3bec00"
749764966174056448,Yenice91,19,0,5,5,0.400874,0.450325,0.000487,"#ff77ff"
719288111998574593,pablaevelina,46,1,6,7,0.335989,0.521286,0.001461,"#3bec00"
975445388646903808,HDRio_2018,39,15,0,15,0.396222,0.355102,0.005358,"#00e8b2"
1321330133064699904,aluzsanchez1,19,0,5,5,0.381141,0.446033,0.000487,"#ff77ff"
4706485827,JoseDavCortes,19,0,6,6,0.379565,0.445536,0.000974,"#3e93ff"
719816239124783105,XHumDigitUAB,48,56,15,71,0.487306,0.543206,0.032635,"#ff0d69"
1042058069843296257,DeUaq,0,20,23,43,0.332387,0.479005,0.018997,"#3e93ff"
1387346503673524229,feryx92,26,5,0,5,0.332699,0.338923,0.000487,"#3e93ff"
849599580224278528,G_Adamez_C,22,0,7,7,0.447991,0.552339,0.001461,"#ff0d69"
854958702197125121,Ahistcon,21,8,0,8,0.535271,0.706493,0.001948,"#ffa64e"
4898171715,lozgarrido,48,38,17,55,0.441994,0.527984,0.024842,"#ffb800"
1264857541726605313,Marisonne1,49,0,6,6,0.49166,0.543785,0.000974,"#ffa64e"
4866873579,margalarramendi,39,5,6,11,0.450127,0.68816,0.00341,"#fcae7e"
801028007901143040,hidalgo_tenorio,49,0,8,8,0.431968,0.52097,0.001948,"#ffa64e"
954361349529853952,SEHMedicina,48,4,2,6,0.427086,0.563932,0.000974,"#008ebb"
1347656361677631490,HPSshouts,48,0,4,4,0.378669,0.532877,0,"#008ebb"
717465024168640512,masterencritica,49,2,2,4,0.525137,0.472739,0,"#ffa64e"
1134816808408702976,YuriPires6,39,4,5,9,0.42374,0.341236,0.002435,"#00e8b2"
1132124495173623809,ErichsenLucas,39,2,4,6,0.388507,0.273115,0.000974,"#00e8b2"
970596409975156737,fdmhildesheim,0,0,8,8,0.364182,0.432658,0.001948,"#3e93ff"
714465139899166722,intcocho,25,2,4,6,0.359029,0.593131,0.000974,"#ff0d69"
1379808931787251721,dhtech_group,0,9,0,9,0.328488,0.433124,0.002435,"#ffb800"
786490414953934848,MaquisPelicula,21,7,3,10,0.555775,0.777468,0.002923,"#ffa64e"
842524220684943360,LASARESEARCH,36,13,7,20,0.402659,0.398019,0.007793,"#ff77ff"
1045633197231550465,innova_udc,0,4,12,16,0.442777,0.521883,0.005845,"#ff0d69"
935181221893730309,verogomezphd,46,3,9,12,0.320871,0.465582,0.003897,"#3bec00"
1034180055453392896,HGCP_UC,26,12,4,16,0.297541,0.267408,0.005845,"#3e93ff"
1264514995192303620,jrastiz,0,4,3,7,0.485578,0.456829,0.001461,"#ff0d69"
1055387920343851008,Mojarromero,25,9,4,13,0.386209,0.564017,0.004384,"#8ecfec"
1124765991924199424,aliciabedul,12,1,3,4,0.260774,0.39919,0,"#ff77ff"
974330797971988482,HabEscritoras,35,3,7,10,0.164045,0.333207,0.002923,"#c42c63"
1348558873636921349,opensource_orgs,49,0,5,5,0.281685,0.43554,0.000487,"#3bec00"
907721809075863552,StephanieSR05,19,0,8,8,0.468106,0.423833,0.001948,"#00ed5d"
1018318954555723776,UnedMexico,46,6,6,12,0.444347,0.537069,0.003897,"#ffb800"
1200223080070692872,vitamina_leo,39,1,3,4,0.393679,0.27147,0,"#00e8b2"
728316752766062593,s_boadas,0,10,30,40,0.426337,0.520088,0.017535,"#ff0d69"
947685474570661889,RMS_UNAM,26,9,0,9,0.276253,0.227321,0.002435,"#3e93ff"
4373963417,DHBBAW,12,0,45,45,0.366213,0.457897,0.019971,"#ff77ff"
1334205949750489089,historisismos,12,10,1,11,0.42255,0.383004,0.00341,"#ff77ff"
714585866715291649,rdrx_,0,0,14,14,0.347387,0.445917,0.004871,"#3e93ff"
1169195169717084160,hezikt_eus,46,0,4,4,0.418215,0.539798,0,"#ffb800"
747721267982237696,_ITEMadrid_,25,34,9,43,0.371041,0.508799,0.018997,"#ff0d69"
1266192708412080130,RIHISTORIADORAS,12,6,5,11,0.428658,0.376265,0.00341,"#3bec00"
898265837857013763,AmenazaRoboto,21,12,4,16,0.633949,0.356869,0.005845,"#ffa64e"
1266191612843110402,ProfBedStuy,21,0,4,4,0.635153,0.348408,0,"#ffa64e"
946870215081709573,epistolaria,21,0,4,4,0.636036,0.342489,0,"#ffa64e"
909891254338703360,PodRoboto,21,0,4,4,0.639872,0.345068,0,"#ffa64e"
1294393330973970435,Historia152,22,5,6,11,0.387337,0.557419,0.00341,"#8ecfec"
1250172899882946560,lazarobot,0,5,1,6,0.46735,0.471724,0.000974,"#ff0d69"
877931790719221760,PublicHistoryIT,49,6,0,6,0.303459,0.428419,0.000974,"#3bec00"
1282173705070669824,sciBot6,49,0,5,5,0.326788,0.474854,0.000487,"#3bec00"
1182642793698811905,venicedph,0,11,3,14,0.365093,0.441154,0.004871,"#3e93ff"
1390415263800119300,litelectronica,1,2,8,10,0.33208,0.483492,0.002923,"#825403"
1166374846848258048,riramosuniv,15,0,6,6,0.370888,0.48404,0.000974,"#006032"
1027891560002846720,R_Consuelo_GG,0,0,4,4,0.421354,0.533056,0,"#ff0d69"
702161516469030912,AnaBubenik,36,3,1,4,0.403505,0.532701,0,"#00e8b2"
773528630064537600,MuseosColombia,19,0,9,9,0.41538,0.438744,0.002435,"#00ed5d"
1352348858580402181,EscuelitaSA,12,0,10,10,0.288452,0.410186,0.002923,"#ff77ff"
1290418317262544896,life_x_code,12,0,5,5,0.294232,0.425625,0.000487,"#ff77ff"
1026851154934882304,PorChicana,12,4,0,4,0.279207,0.420912,0,"#ff77ff"
709333678925750273,NanetteRissler,0,0,29,29,0.385227,0.493866,0.012177,"#ff0d69"
1402287396830466058,AlmagroTClasico,36,4,2,6,0.468743,0.484391,0.000974,"#00e8b2"
1318371547720175618,chiviroOwl,12,0,7,7,0.374348,0.419332,0.001461,"#ff77ff"
1397322379706130437,cite_lab,39,9,3,12,0.4072,0.392352,0.003897,"#00e8b2"
1243161081633259524,ach2021,12,7,3,10,0.316412,0.421486,0.002923,"#ff77ff"
1272448855628492800,asodat2023,25,17,4,21,0.392622,0.517622,0.008281,"#ff0d69"
4567815741,music_enfanthen,0,0,4,4,0.253349,0.563973,0,"#ff0d69"
950451187039592448,zvilac,25,12,16,28,0.42052,0.522634,0.01169,"#ff0d69"
924377431611527169,RedArgEA,46,27,12,39,0.371473,0.522379,0.017048,"#3bec00"
1205464890158338049,UniversidadGob,15,5,0,5,0.475707,0.472344,0.000487,"#006032"
776717161159065600,CheckoutLabs,21,5,3,8,0.572113,0.767666,0.001948,"#ffa64e"
975442223302094849,RevistaEpidauro,12,9,0,9,0.348255,0.479499,0.002435,"#3bec00"
1062024953732698112,EprMujeres,21,6,0,6,0.566694,0.765823,0.000974,"#ffa64e"
879825421352583168,RLadiesCDMX,0,6,3,9,0.321729,0.424985,0.002435,"#3e93ff"
747491433658060800,dankerohe,39,0,5,5,0.381297,0.321465,0.000487,"#00e8b2"
1128114424060030976,CRIEA3,0,0,5,5,0.390127,0.476159,0.000487,"#3e93ff"
822379388570218497,UCAextension,36,3,2,5,0.558084,0.392066,0.000487,"#00e8b2"
1232298369072148482,DptFilolModerna,37,9,10,19,0.418511,0.68106,0.007306,"#fcae7e"
788410789443018752,alissonmasoares,39,3,4,7,0.4279,0.406391,0.001461,"#00e8b2"
1131605625862008832,RubnChacn3,46,10,3,13,0.450513,0.475212,0.004384,"#ffb800"
1380540745661218817,EyPPFLACSO,36,4,0,4,0.551309,0.476262,0,"#00e8b2"
861524140536332288,CLUNL_,39,9,4,13,0.422117,0.409999,0.004384,"#00e8b2"
705194246127529984,cibercliografia,12,3,4,7,0.372251,0.423026,0.001461,"#ff77ff"
1396730653081804801,Revista_REDOC,36,3,1,4,0.341243,0.477968,0,"#00e8b2"
4874205953,ArtemisNymph,36,5,2,7,0.495733,0.486367,0.001461,"#ff0d69"
1061697864550752256,iara_gautier,36,3,1,4,0.567453,0.31399,0,"#00e8b2"
1227917842118561793,agusnieto77,31,2,4,6,0.431076,0.448189,0.000974,"#3bec00"
920000089820663808,YadiraLizamaMue,19,0,5,5,0.535101,0.496149,0.000487,"#3e93ff"
1116204493350346752,HDitadura,39,4,0,4,0.410736,0.331502,0,"#00e8b2"
1060206426134585344,poetadiletante,22,0,8,8,0.344249,0.546622,0.001948,"#8ecfec"
796191699815038977,serpientederio,0,0,5,5,0.410476,0.425386,0.000487,"#3e93ff"
748520777385926656,DigitalHumani,0,2,11,13,0.419715,0.50039,0.004384,"#ffb800"
743456072673992704,elindepcom,35,5,0,5,0.33892,0.751155,0.000487,"#c42c63"
1171484900412706816,RevistaJanus,0,11,3,14,0.411099,0.496507,0.004871,"#ff0d69"
1297617007668596745,fest_digital,46,9,2,11,0.450921,0.621291,0.00341,"#ffb800"
704247685470097408,HuDiCat,0,23,4,27,0.417724,0.476873,0.011203,"#ff0d69"
986053054905581568,MikAlice_M,46,0,5,5,0.301567,0.505317,0.000487,"#3bec00"
1321422923312279552,HumanidadesDig3,36,3,1,4,0.485886,0.465396,0,"#ffb800"
4697014770,_Laris_Lari,39,0,6,6,0.370289,0.262659,0.000974,"#00e8b2"
724695976179539969,usaldci,36,2,2,4,0.345441,0.499845,0,"#00e8b2"
1177490993592991744,cmmalagafair,15,10,5,15,0.53461,0.503766,0.005358,"#ff0d69"
1195807221373919232,jfm4em,12,1,7,8,0.276139,0.415294,0.001948,"#ff77ff"
810962229071908865,rsc2110,12,0,4,4,0.437085,0.446764,0,"#ff77ff"
1196451299526610945,dh_univr,46,19,4,23,0.442636,0.531772,0.009255,"#ff0d69"
1496070887866576899,surculturas,15,4,0,4,0.529933,0.534939,0,"#ff0d69"
933646192092819458,clasicas_uam,48,8,1,9,0.511228,0.502754,0.002435,"#008ebb"
1075444961867374592,Gabriel39194377,0,5,2,7,0.241329,0.464168,0.001461,"#3e93ff"
920229878728814593,amidi_com,0,0,4,4,0.333415,0.385422,0,"#3e93ff"
1026636127380361217,AlanColin_Arce,35,0,7,7,0.256397,0.384886,0.001461,"#c42c63"
795748043832381442,lellislolellis,39,5,9,14,0.354369,0.363093,0.004871,"#00e8b2"
1346131952546541570,GuiLaitano,31,3,2,5,0.417327,0.424372,0.000487,"#3bec00"
1252986071249555457,arroyo_labrador,39,9,1,10,0.534963,0.481425,0.002923,"#ffb800"
905470522602938373,DistantReading,12,20,0,20,0.404966,0.456783,0.007793,"#ff77ff"
809514440504868864,bncolorado,0,1,4,5,0.39983,0.53295,0.000487,"#3e93ff"
1016377495057297408,archiviststan,12,3,14,17,0.351237,0.431781,0.006332,"#ff77ff"
1109155467484450817,HumanidadesUfv,39,33,8,41,0.430999,0.653872,0.018022,"#fcae7e"
836704501411299328,henar_pizarro,39,0,4,4,0.504445,0.580813,0,"#ffb800"
1015384340077928448,ObsHistoria,39,11,27,38,0.443182,0.367083,0.016561,"#00e8b2"
1299341136474132482,practicalIIIF,39,5,2,7,0.364299,0.34594,0.001461,"#00e8b2"
1394398771425972231,DptoHa,48,4,1,5,0.418359,0.527319,0.000487,"#008ebb"
1239205478774816775,_LecturaComun_,1,227,0,227,0.523649,0,0.108622,"#ffa64e"
1153749813961379841,DominoeDancer,0,1,7,8,0.325477,0.501901,0.001948,"#3e93ff"
876432438175596548,rominickyDL,46,45,49,94,0.354625,0.494779,0.043838,"#3bec00"
1038037615856021504,PatriciaJuezGa1,39,7,12,19,0.430316,0.615799,0.007306,"#fcae7e"
1364631878549057538,ISIDROLAPUENTE,34,0,6,6,0.587654,0.628394,0.000974,"#ffb800"
723905729669828608,L_DigitalesUCM,15,8,1,9,0.385956,0.59476,0.002435,"#ffb800"
791640220068380673,esAsiaOriental,0,4,1,5,0.54684,0.433955,0.000487,"#ff0d69"
1108039887926763520,mhd_ub,48,18,4,22,0.491331,0.526658,0.008768,"#008ebb"
753615934326210560,master_gcd,48,6,4,10,0.507513,0.576378,0.002923,"#008ebb"
1242776999619330048,LgHumanMachine,46,3,1,4,0.44309,0.432961,0,"#ffb800"
905178483894214656,clavilux_of_FL,12,2,11,13,0.377931,0.424495,0.004384,"#ff77ff"
796369544080146432,Xbal_Urbano,48,1,8,9,0.520003,0.570176,0.002435,"#008ebb"
1227488549165043714,UnitedFronteras,35,36,10,46,0.314256,0.431316,0.020458,"#c42c63"
4793645256,ana_asaenz,0,0,7,7,0.37742,0.46628,0.001461,"#3e93ff"
1060202869977243649,RedesMigrantes,35,2,3,5,0.314377,0.402484,0.000487,"#c42c63"
938049703064809472,O_GarciaObregon,0,0,4,4,0.254803,0.353428,0,"#3e93ff"
864445647704948736,UNAM_UK,22,1,3,4,0.349579,0.557821,0,"#8ecfec"
4895170186,FL_ICTs,22,0,6,6,0.382931,0.656636,0.000974,"#8ecfec"
1327751389087473664,AmargadaLimena,19,0,4,4,0.437125,0.43315,0,"#00ed5d"
1313622876457762816,Elias_Stephen31,19,0,4,4,0.431372,0.429807,0,"#00ed5d"
1237331381455372288,BittersweetHis2,19,0,4,4,0.433427,0.43038,0,"#00ed5d"
1209013521956122626,abc_cordoba,46,0,6,6,0.316227,0.516053,0.000974,"#3bec00"
1395309103900155905,CbaQuest,12,2,2,4,0.211687,0.374469,0,"#ff77ff"
1189229957744119808,marmolizqedit,46,7,11,18,0.438899,0.51077,0.006819,"#ffb800"
954705808088059904,humdigus,22,39,10,49,0.363225,0.541153,0.021919,"#8ecfec"
1015579177704181762,unifesp,39,11,0,11,0.408831,0.370267,0.00341,"#00e8b2"
1361279729337315328,dhum2021D,46,0,4,4,0.3456,0.502301,0,"#6c241e"
1168564690026455040,SclTug,47,6,2,8,0.311365,0.463393,0.001948,"#7e8b76"
893531729855688704,BACartography,12,10,50,60,0.331897,0.413845,0.027277,"#ff77ff"
730034146672775168,SlaveSocieties,12,0,6,6,0.324213,0.419365,0.000974,"#ff77ff"
772701076986466304,BantaniEdu,39,4,0,4,0.33836,0.370665,0,"#ff77ff"
1168165050672189440,Conver_Historia,21,9,0,9,0.563087,0.744567,0.002435,"#ffa64e"
1011751695162880000,hannahljnc,46,1,5,6,0.310011,0.468023,0.000974,"#3bec00"
1382411904468062214,ClusterMelilla,15,2,4,6,0.482958,0.479077,0.000974,"#ff0d69"
1088817673440514050,BibyArchRANME,39,0,17,17,0.402239,0.589947,0.006332,"#fcae7e"
928966702599110656,artshumsdigit,39,2,5,7,0.398088,0.374179,0.001461,"#00e8b2"
1101092269044785152,UABOpenLabs,48,6,3,9,0.489778,0.566964,0.002435,"#008ebb"
1034746397902467072,javihaller,21,4,4,8,0.533257,0.777415,0.001948,"#ffa64e"
1284118227807809537,ACIMarxistes,21,0,4,4,0.531049,0.796907,0,"#ffa64e"
804273644792848384,SibFUniversity,46,6,0,6,0.419745,0.468867,0.000974,"#00e8b2"
1241045456018460674,ChMuellerHvlB,46,3,6,9,0.334725,0.466528,0.002435,"#3bec00"
1382693386478612482,Paisajescoloni1,12,42,0,42,0.458979,0.29776,0.018509,"#ff77ff"
723431520375967744,nuno_ivo,39,3,2,5,0.549108,0.424547,0.000487,"#00e8b2"
961613644088868864,carloslmarch,46,0,6,6,0.362104,0.532884,0.000974,"#3bec00"
1214531946061213696,HDRio2020,39,40,10,50,0.411755,0.334356,0.022406,"#00e8b2"
1339603122897883137,FornetJaime,15,0,4,4,0.504255,0.514614,0,"#006032"
1288887110943027201,blackstembot,12,0,4,4,0.36988,0.447753,0,"#3e93ff"
1361230103808798720,hdum2021A,36,4,7,11,0.350788,0.52194,0.00341,"#ffb800"
1361235266221006848,humd2021,48,2,3,5,0.439652,0.588862,0.000487,"#ffb800"
1048651879180378112,mario_casado_m,49,1,4,5,0.399349,0.597566,0.000487,"#ff0d69"
1359989292605591553,dsb_lu,0,3,9,12,0.368611,0.455894,0.003897,"#c42c63"
1127720139682668544,HDigitalesChile,0,19,5,24,0.31793,0.4501,0.009742,"#3e93ff"
1117483379128250369,digmodlang,46,3,5,8,0.354691,0.499568,0.001948,"#3bec00"
1311709736614723587,RedeHumanidades,46,4,2,6,0.461846,0.41013,0.000974,"#ffb800"
1022402798183477248,BeaMilz,39,3,6,9,0.412158,0.364463,0.002435,"#00e8b2"
1118111620042055680,cezaryrosinski_,25,6,3,9,0.338342,0.444173,0.002435,"#ff0d69"
1104764042609070080,IBLPAN,25,7,2,9,0.320485,0.421908,0.002435,"#ff0d69"
1172296849975365637,letcesar,39,9,5,14,0.418971,0.35092,0.004871,"#00e8b2"
923288995144093697,tomaszumerle,25,0,4,4,0.321557,0.473383,0,"#ff0d69"
1000032762064199680,okRa_Barreto,39,0,5,5,0.450659,0.362398,0.000487,"#00e8b2"
727651724169744384,pablo_spindola,39,0,4,4,0.445807,0.405692,0,"#00e8b2"
1235297245546893313,DocenciaY,46,0,5,5,0.31771,0.483453,0.000487,"#3bec00"
1186795623892357121,Lahisd_UFU,39,2,2,4,0.396305,0.389643,0,"#00e8b2"
973121494254530566,Geotec_UMA,15,10,4,14,0.592089,0.508069,0.004871,"#ff0d69"
777100568573702146,AJPintoT,15,2,4,6,0.671184,0.514576,0.000974,"#ff0d69"
855336729850421248,CrearigrupUV,15,56,25,81,0.492321,0.496837,0.037506,"#006032"
958767985325375490,ReDCA_FBA,0,5,0,5,0.263264,0.50944,0.000487,"#3e93ff"
1318492511464263682,ciaourense,46,3,2,5,0.462316,0.674269,0.000487,"#ffb800"
829015419050721280,Victoriasoca1,46,0,6,6,0.428885,0.610611,0.000974,"#ffb800"
1016759119708131329,UNEDOurense,46,7,7,14,0.469127,0.630744,0.004871,"#ffb800"
877517892098588672,FCPySUAEMex,35,6,0,6,0.231976,0.397693,0.000974,"#c42c63"
1027329803073015814,abraham_gm1916,35,4,8,12,0.252985,0.398143,0.003897,"#c42c63"
715126615810904064,IA_UNED,46,2,13,15,0.454568,0.576495,0.005358,"#ffb800"
989993497238401024,LEDIFCS,39,14,4,18,0.407332,0.294856,0.006819,"#00e8b2"
1276572906395439104,desgranges_nina,39,4,2,6,0.405553,0.273641,0.000974,"#00e8b2"
1186327570465411072,xxciajihle,22,7,0,7,0.395737,0.61968,0.001461,"#8ecfec"
1258121134438047744,rg_natha,12,3,5,8,0.44793,0.384919,0.001948,"#ff77ff"
1369704248624185351,fajalauzahd,15,2,5,7,0.691789,0.559761,0.001461,"#006032"
1347118601841602562,IrnRincon,46,0,6,6,0.362843,0.475054,0.000974,"#3e93ff"
788328554253709312,jl_rodriguezg,48,36,6,42,0.47151,0.526443,0.018509,"#3bec00"
736284761589714944,ymontoyag,39,1,11,12,0.415805,0.428899,0.003897,"#00e8b2"
939917215079550976,ALAntropologia,50,4,1,5,0.422271,0.422307,0.000487,"#008bdd"
904956262634450944,HispanicasUCLM,37,0,4,4,0.380286,0.60755,0,"#fcae7e"
863650220797812737,leofn,39,12,0,12,0.388422,0.374451,0.003897,"#00e8b2"
1199368489263419393,GoHumanities,39,3,13,16,0.436021,0.424804,0.005845,"#00e8b2"
1132403172440510465,gcprazeres,39,0,4,4,0.40817,0.311294,0,"#00e8b2"
1311668487710887942,joanacvp,39,4,2,6,0.434868,0.384144,0.000974,"#00e8b2"
1153612563483103232,dani_sanches,39,22,15,37,0.414337,0.390375,0.016074,"#00e8b2"
794186032283525121,PeriodicoToledo,37,0,4,4,0.488441,0.694183,0,"#fcae7e"
784349432296931329,caroubauer,39,24,6,30,0.414071,0.259949,0.012664,"#00e8b2"
1167074462841417728,manuellacaputo,39,1,6,7,0.395289,0.304412,0.001461,"#00e8b2"
1176509223724900352,revistasuchile,46,15,8,23,0.254304,0.475073,0.009255,"#3bec00"
750286186392977409,ACDH_OeAW,0,18,5,23,0.388771,0.475444,0.009255,"#3e93ff"
723481866754510848,aascastellucci,39,1,13,14,0.404024,0.30651,0.004871,"#00e8b2"
1370150104687054848,VozesANPUH,39,4,2,6,0.390937,0.292432,0.000974,"#00e8b2"
1250861593245736962,historianawiki,39,8,6,14,0.379039,0.330469,0.004871,"#00e8b2"
931865682689646592,Postfranquismo,21,4,3,7,0.561128,0.772156,0.001461,"#ffa64e"
941699387272650752,AlbertoGamGon,0,5,2,7,0.437875,0.495564,0.001461,"#ff0d69"
1022155139191386113,ppdunam,0,19,7,26,0.368015,0.421561,0.010716,"#3e93ff"
989576496103788546,INULAB_ULL,0,0,4,4,0.396222,0.507637,0,"#3e93ff"
4765272913,IUEDUNED,46,8,8,16,0.423201,0.584427,0.005845,"#ffb800"
734033143397781504,MercBriones1,21,0,4,4,0.570365,0.784884,0,"#ffa64e"
1116435971732594689,LegsSadovsky_,46,1,7,8,0.34472,0.51524,0.001948,"#ff77ff"
1284135676280221696,Caadiazma,19,0,8,8,0.388724,0.409012,0.001948,"#ff77ff"
1365546325635436546,Fainer77591466,12,0,4,4,0.356973,0.407215,0,"#ff77ff"
709382318788644866,HarvardOnline,0,6,0,6,0.385272,0.451169,0.000974,"#3e93ff"
1139084646795436032,MayaAndGonzalez,0,0,8,8,0.374652,0.43483,0.001948,"#3e93ff"
968041433872719873,FAMCollioure,21,4,0,4,0.57724,0.770026,0,"#ffa64e"
1304169169517187072,GaleBrasil,10,0,4,4,0.324545,0.28949,0,"#3bec00"
845348579451506689,carmlarramendi,39,10,10,20,0.435258,0.638655,0.007793,"#fcae7e"
994232501391503360,odiloncaldeira,39,1,3,4,0.41661,0.339296,0,"#00e8b2"
1164964138214481920,revistafiguras,0,10,2,12,0.416227,0.440167,0.003897,"#3e93ff"
999020146965536768,Conversation_E,15,47,5,52,0.436655,0.561385,0.02338,"#ffa64e"
1144591663706382336,chesapeakedh,35,4,0,4,0.286339,0.411439,0,"#c42c63"
1184797855044853765,LenguaUcm,22,20,1,21,0.320006,0.700579,0.008281,"#8ecfec"
1152538829926125568,AhleAsociacion,22,6,0,6,0.320362,0.643873,0.000974,"#8ecfec"
805248855990292480,filonewsOK,36,11,0,11,0.143352,0.480317,0.00341,"#403538"
730111190647590913,diegofrailegmz,1,0,5,5,0.345756,0.575111,0.000487,"#825403"
1149047460154748929,RNArqueoDigital,12,1,19,20,0.336256,0.494012,0.007793,"#ff77ff"
842076086691344392,castro_mrosa,49,2,10,12,0.393583,0.501047,0.003897,"#ffa64e"
1159526698351828994,DelAlumFiloUNED,46,3,2,5,0.383798,0.564186,0.000487,"#8ecfec"
1040925667188199424,olivejacquot,12,1,13,14,0.364419,0.469762,0.004871,"#ff77ff"
881859697090981888,archivocolonial,48,1,10,11,0.383422,0.549968,0.00341,"#008ebb"
804380656704823297,hernan_ISDIEB,48,1,6,7,0.540243,0.54648,0.001461,"#008ebb"
1127110122944245760,KunigoSomos,19,7,2,9,0.512202,0.45551,0.002435,"#00ed5d"
1065253005581275136,jhumanidades,46,2,15,17,0.391371,0.537643,0.006332,"#ffb800"
974448919269822464,ciberhumanidad,50,116,20,136,0.563843,0.450902,0.064296,"#008bdd"
1351515081117491201,RiveraSalwator,12,0,8,8,0.40681,0.470577,0.001948,"#ff77ff"
1135199470914719745,ViveroDominguez,12,0,5,5,0.377605,0.410883,0.000487,"#ff77ff"
1082786080850620418,ObservaCiencia,17,28,2,30,0.776229,0.541783,0.012664,"#6c241e"
869128565110996992,EEAGrantsPT,39,3,3,6,0.483766,0.314688,0.000974,"#00e8b2"
705772915615211520,iNOVAmedialab,39,2,3,5,0.460455,0.389386,0.000487,"#00e8b2"
1206880986199404544,MnemosineP,46,3,1,4,0.429146,0.485866,0,"#ffb800"
953265927851855872,Dr_Saint_Herard,12,1,4,5,0.307525,0.453382,0.000487,"#ff77ff"
926505813522501632,Ibero_Judaica,12,0,4,4,0.40074,0.339897,0,"#ff77ff"
736179924684406785,mjofiguerero,46,1,9,10,0.288937,0.414234,0.002923,"#3bec00"
965911621678911488,redinedgob,1,0,12,12,0.519763,0.503471,0.003897,"#ff12a3"
1257309949983461382,TIDD_PUCSP,39,2,2,4,0.443043,0.378176,0,"#00e8b2"
1047567355067416581,ComisionVerdadC,19,6,0,6,0.407019,0.376605,0.000974,"#00ed5d"
1220742727224250368,Empleocscol,19,0,4,4,0.434168,0.398011,0,"#00ed5d"
1304108141752315905,unicampbot,39,0,4,4,0.415088,0.30421,0,"#00e8b2"
837022921172389894,TransmediaCat,51,2,2,4,0.414254,0.680712,0,"#ff0d69"
841781617282674689,mirelys_puerta,39,2,9,11,0.439261,0.483024,0.00341,"#006032"
966329753719529472,LauraLozanoMar,39,1,3,4,0.646586,0.507302,0,"#ff0d69"
720776561230802944,AndreLAppel,39,7,2,9,0.43472,0.35519,0.002435,"#00e8b2"
1301538860405579776,RojoAndreaT,35,1,5,6,0.303388,0.370468,0.000974,"#c42c63"
1242356665200062464,DH_BUW,0,4,0,4,0.350259,0.46193,0,"#3e93ff"
816970398126501888,AnaBMartinezG,49,8,3,11,0.500344,0.5424,0.00341,"#8ecfec"
1301645635720863749,sgalindoa001,35,1,4,5,0.280601,0.403499,0.000487,"#c42c63"
1301637643642580992,JUrielAlcantar1,35,0,4,4,0.268265,0.400308,0,"#c42c63"
1301539523239784449,MaraTap34736456,35,0,4,4,0.276482,0.39793,0,"#c42c63"
1179574164992266240,Suggy_Jimenez,35,2,4,6,0.278153,0.402803,0.000974,"#c42c63"
1026658483406422016,Lizz11716784,35,2,3,5,0.279545,0.394584,0.000487,"#c42c63"
1013735388593229824,InFoDiTex,46,1,6,7,0.337538,0.438519,0.001461,"#3bec00"
1145769738733334538,ElGemotron9,35,2,3,5,0.259299,0.39093,0.000487,"#c42c63"
1307276675214958592,AgenteCordel,0,13,4,17,0.439947,0.522337,0.006332,"#ff0d69"
1102974261793300481,OWSDUY,15,0,4,4,0.470635,0.554356,0,"#006032"
1224721146605637633,CinthyaRosas13,35,1,5,6,0.266556,0.396687,0.000974,"#c42c63"
1093514846719627264,JovanaVaher,35,2,6,8,0.273421,0.400992,0.001948,"#c42c63"
4843916997,cult_latina,50,0,8,8,0.524356,0.428069,0.001948,"#008bdd"
1105900802273656834,yare_cubalit,52,13,3,16,0.903012,0.619392,0.005845,"#b66f7a"
953985170629066752,jgutiear,48,4,6,10,0.479081,0.569186,0.002923,"#008ebb"
1116764693115428865,cubano_libro,52,2,2,4,0.841141,0.60252,0,"#b66f7a"
921355475777617920,cuba_literaria,52,10,5,15,0.775128,0.589795,0.005358,"#b66f7a"
1048208597841338368,895Fahrenheit,0,6,9,15,0.324747,0.48594,0.005358,"#3e93ff"
1124238252595142656,MVRColombia,19,1,3,4,0.306223,0.303398,0,"#00ed5d"
978656265428701186,SLASLatAm,19,4,8,12,0.380354,0.374244,0.003897,"#00ed5d"
1189245689450110976,GLAM_labs,12,1,3,4,0.34746,0.491393,0,"#ff77ff"
4871408776,GutCarrasco,28,0,4,4,0.386675,0.69464,0,"#8ecfec"
1248489341346709504,ImaginaViral,0,2,4,6,0.36403,0.427779,0.000974,"#3e93ff"
1328793725347258368,LuisDeossa,46,4,0,4,0.332598,0.4757,0,"#3bec00"
1329181648953470980,Romiaguirre851,17,0,7,7,0.271663,0.633474,0.001461,"#006032"
1145548724233543680,abichuelx,35,0,4,4,0.277695,0.390653,0,"#c42c63"
1303092496633921536,CreatioUnicosta,26,0,4,4,0.29216,0.372995,0,"#3e93ff"
1065576048883056641,AleJosiowicz,39,24,28,52,0.398806,0.326937,0.02338,"#00e8b2"
858636077267136513,PMarmolAvila,46,1,3,4,0.426776,0.551047,0,"#ffb800"
932698067052191744,MarceloVitores,46,8,9,17,0.34994,0.511897,0.006332,"#3bec00"
1111387660973756416,RadioVozAndina,12,4,1,5,0.300862,0.455127,0.000487,"#ff77ff"
958667793838329856,PensarEducacao,39,4,0,4,0.404126,0.353955,0,"#00e8b2"
1324417356337131521,dasilvarrenato,39,0,5,5,0.426996,0.158412,0.000487,"#00e8b2"
1101577699720601600,2020Aiso,0,6,1,7,0.389017,0.501905,0.001461,"#ff0d69"
786873943298805760,TIC_CFIEVA,1,0,4,4,0.621376,0.429191,0,"#ff12a3"
786873128089706496,convivem_CFIEVA,1,0,5,5,0.635163,0.434393,0.000487,"#ff12a3"
4852215574,GermanIvanMtz,0,3,12,15,0.338275,0.331027,0.005358,"#3e93ff"
786875080592744448,Social_CFIEVA,1,0,4,4,0.631896,0.427661,0,"#ff12a3"
786874743521697792,lengua_CFIEVA,1,0,5,5,0.642815,0.432414,0.000487,"#ff12a3"
786870268362944512,sociales_CFIEVA,1,4,7,11,0.614715,0.419456,0.00341,"#ff12a3"
716959739888971776,lenguae_CFIEVA,1,1,5,6,0.643962,0.437377,0.000974,"#ff12a3"
926428329598648321,frances_CFIEVA,1,0,4,4,0.634155,0.426265,0,"#ff12a3"
789044827874787328,tecno_CFIEVA,1,0,4,4,0.629687,0.422443,0,"#ff12a3"
712642114681704448,NISOInfo,39,5,2,7,0.423873,0.357641,0.001461,"#00e8b2"
1275899320311611392,dandomingx,39,2,2,4,0.37688,0.245568,0,"#00e8b2"
1297742372407738371,cdasilvajnr,39,2,2,4,0.376535,0.249324,0,"#00e8b2"
958733805497540608,geohumanidades,54,10,26,36,0.459439,0.529125,0.015587,"#c6cc85"
1300444429732532225,ArJuridicas,46,0,8,8,0.310004,0.499884,0.001948,"#3bec00"
1054460344838619136,womanscroquets,22,0,4,4,0.35694,0.617613,0,"#8ecfec"
1244627223900020737,asaihistoria,46,0,4,4,0.32002,0.404822,0,"#3bec00"
4795017121,CulturaUANL,38,11,0,11,0.567667,0.184754,0.00341,"#3e93ff"
1121406574143123458,Aline_LaraG,22,0,4,4,0.341098,0.509397,0,"#8ecfec"
1085148003944534018,RevistasUv,46,8,2,10,0.296998,0.472665,0.002923,"#3bec00"
1162023906384982022,volveralfuturok,46,6,1,7,0.379952,0.430454,0.001461,"#3bec00"
1150883865302589441,profanelize,39,4,0,4,0.410697,0.342744,0,"#00e8b2"
1262315674338295810,garcia_mingo_e,48,1,3,4,0.8239,0.751554,0,"#66e087"
930745718834376704,janasinakeck,0,0,5,5,0.366741,0.489996,0.000487,"#ffb800"
1292447934563454976,MetaJournalist,0,0,5,5,0.354759,0.488672,0.000487,"#ffb800"
1272897522462269441,hicpan,0,4,7,11,0.494869,0.51364,0.00341,"#ff0d69"
1267480989678305283,GAvenoza,22,0,5,5,0.445705,0.57249,0.000487,"#ff0d69"
1290328760361930752,LaClasicoteca,48,4,1,5,0.680169,0.254646,0.000487,"#008ebb"
764248244348157952,holasoclemma,0,0,4,4,0.495108,0.473809,0,"#ff0d69"
993506420313255939,UCNRevistas,46,7,0,7,0.316458,0.471691,0.001461,"#3bec00"
741319002719289344,_BarbaraCabrera,53,11,1,12,0.398225,0.157074,0.003897,"#3e93ff"
839821268299972614,bibloterapias,46,0,20,20,0.334515,0.62142,0.007793,"#3bec00"
1115649350267363328,INEFOPoficial,48,1,3,4,0.630263,0.54311,0,"#ff0d69"
806481186839298048,SPEC_UCLM,37,0,4,4,0.42425,0.523505,0,"#fcae7e"
1163758118549016576,historiapublik,21,1,3,4,0.452654,0.571423,0,"#00ed5d"
824298069755883525,aransangines,15,3,8,11,0.591792,0.521891,0.00341,"#006032"
878741760695975936,DEmiliopics,48,0,5,5,0.40569,0.568388,0.000487,"#ffb800"
1241002570698625025,IAI_Bibliothek,12,6,5,11,0.347356,0.516816,0.00341,"#3bec00"
882953575164502016,adrianvaruna,28,0,4,4,0.468511,0.439563,0,"#8ecfec"
905160243079995399,CienciaQueSomos,0,2,2,4,0.250608,0.211974,0,"#3e93ff"
993069278759915520,Revistas_Cult,12,15,36,51,0.352844,0.472149,0.022893,"#ff77ff"
822354309857902593,UNIR_Ecuador,25,4,1,5,0.326048,0.585323,0.000487,"#ff0d69"
975437131408642048,daphretamozo,12,1,13,14,0.373395,0.495034,0.004871,"#ff77ff"
1264673168213639178,griseluna00,39,5,0,5,0.408781,0.451574,0.000487,"#00e8b2"
880142233563000832,romulopredes,39,0,4,4,0.395131,0.292941,0,"#00e8b2"
1064305929330528256,der_zeitgeist_,12,0,4,4,0.395991,0.399881,0,"#ff77ff"
965590611150671874,MadridTrc,28,0,4,4,0.502162,0.356756,0,"#8ecfec"
1220093610185633792,caroecheverri,19,2,3,5,0.436341,0.45476,0.000487,"#3bec00"
1278127266103353345,jardin_lac,15,1,3,4,0.632312,0.535623,0,"#006032"
1090944524522803200,GeohumanDARIAH,54,1,4,5,0.508288,0.573446,0.000487,"#c6cc85"
1116727565060902912,mariaclarapaixs,39,7,0,7,0.102182,0.619266,0.001461,"#00e8b2"
4588448793,MireiaSalgot,48,1,8,9,0.54516,0.53189,0.002435,"#ff0d69"
790552376117714944,ChristianeBirr,46,0,6,6,0.339374,0.493699,0.000974,"#3bec00"
1233844525858197504,naniagudelo,46,2,8,10,0.358343,0.503202,0.002923,"#3e93ff"
755781289240911876,RECoD_ok,46,0,5,5,0.40222,0.522044,0.000487,"#3bec00"
818132133776592898,etothczifra,46,14,3,17,0.337047,0.489049,0.006332,"#3bec00"
891699908054581249,magugo33,54,0,5,5,0.435333,0.706241,0.000487,"#c6cc85"
749907166950264832,Cepli_uclm,15,1,3,4,0.559247,0.556821,0,"#006032"
914948188464930816,mrcosan_ramir,12,0,13,13,0.398236,0.449416,0.004384,"#ff77ff"
847045340167589888,OceanicEx,0,13,2,15,0.363592,0.435985,0.005358,"#3e93ff"
781331251441655808,Lala_yubarta,0,4,0,4,0.377648,0.380048,0,"#3e93ff"
1083728790369509377,cimbage,46,10,3,13,0.297123,0.526135,0.004384,"#3bec00"
1271570415454912513,pesquisadoraexp,39,62,2,64,0.120658,0.677491,0.029226,"#00e8b2"
836412937652830209,camilopjXIX,12,6,43,49,0.386799,0.467868,0.021919,"#ff77ff"
1108565691509153793,DigiLabour,39,7,3,10,0.395365,0.211009,0.002923,"#00e8b2"
988100900920156160,FPE_UFV,39,7,2,9,0.420095,0.715604,0.002435,"#fcae7e"
1268099601103454209,MarMir58616220,12,0,4,4,0.255842,0.40131,0,"#ff77ff"
976825858383073281,times_serif,12,0,4,4,0.367191,0.405457,0,"#ff77ff"
963273918336458752,FernandaSousa_8,39,8,1,9,0.368288,0.170311,0.002435,"#00e8b2"
767406438255849472,KimJoaoUn,39,1,4,5,0.447217,0.219347,0.000487,"#00e8b2"
1137881685931057153,picveis,31,17,3,20,0.437351,0.436311,0.007793,"#3bec00"
1216436872060207104,inclusiongob,15,7,0,7,0.520418,0.597081,0.001461,"#006032"
983775631149293570,CuadernosdelSur,10,20,2,22,0.381288,0.25913,0.008768,"#3e93ff"
1026589695478771712,Ricardo52288879,35,3,3,6,0.249388,0.379507,0.000974,"#c42c63"
4833033172,Rojaskrmen1,0,0,4,4,0.377643,0.458106,0,"#3e93ff"
780353835046932480,Caro_Escarlata,22,2,7,9,0.376008,0.492195,0.002435,"#8ecfec"
904806253649698816,tellesjornal,39,4,0,4,0.420502,0.378472,0,"#00e8b2"
851160531138473984,HumanitatsUAB,0,4,7,11,0.458916,0.501261,0.00341,"#ff0d69"
949833126204837893,CiberEticArg,46,1,3,4,0.50038,0.61545,0,"#3bec00"
930093080660848645,EducacioUAB,0,4,0,4,0.426797,0.470688,0,"#ff0d69"
1006107832498966528,TraduccioUAB,0,4,0,4,0.417198,0.468883,0,"#ff0d69"
1270021961528348672,l_demagalhaes,39,1,4,5,0.458364,0.272646,0.000487,"#00e8b2"
897422271190585345,mbroullon,46,5,3,8,0.394234,0.617109,0.001948,"#8ecfec"
1245070078548348928,brazil_gale,10,7,1,8,0.251241,0.34388,0.001948,"#3bec00"
1034208783034200069,kumoontun,10,2,3,5,0.396161,0.188489,0.000487,"#3e93ff"
865488862750965761,e_health_,31,0,5,5,0.473963,0.407972,0.000487,"#ff0d69"
1267867464836296704,coruja_digital,1,0,4,4,0.331717,0.50012,0,"#825403"
758561835897479168,SantillanaLAB,15,8,1,9,0.577606,0.574969,0.002435,"#006032"
769173528058990592,DrGSEspinosa,25,0,12,12,0.451783,0.43828,0.003897,"#ff0d69"
991160475432968192,IvanParro1,28,0,6,6,0.43324,0.464087,0.000974,"#8ecfec"
4820804277,machinelearnflx,1,4,1,5,0.16968,0.54782,0.000487,"#825403"
835245892311613440,dan_rudmann,46,1,4,5,0.321643,0.528251,0.000487,"#3bec00"
902084381405323264,MariaVidriero,39,12,3,15,0.418096,0.58581,0.005358,"#fcae7e"
960617534293716992,wikidata_es,37,4,0,4,0.281691,0.486163,0,"#ffb800"
825814191114182657,Joseido4098,46,1,8,9,0.345752,0.47041,0.002435,"#3bec00"
1200284639119708160,sebsr_,12,0,5,5,0.453388,0.42167,0.000487,"#ff77ff"
1182617887569334274,LenguasY,28,0,4,4,0.423376,0.579606,0,"#008ebb"
915948076946411520,inctdd,39,4,0,4,0.428567,0.310443,0,"#00e8b2"
1192848641771393027,Colmixe,10,4,1,5,0.345617,0.215919,0.000487,"#3e93ff"
902968555855003648,dh2018cdmx,10,59,28,87,0.351408,0.441939,0.040429,"#00ed5d"
801630392000225281,RedTDPC,10,3,1,4,0.328174,0.407334,0,"#3e93ff"
1240591329052299266,UGRenCasa,15,13,3,16,0.494373,0.516394,0.005845,"#006032"
837751580845801472,ulpgcresearch,37,7,4,11,0.489951,0.572821,0.00341,"#ffb800"
1131214586730942464,technetempire,39,6,8,14,0.401006,0.383449,0.004871,"#00e8b2"
948781476207673349,random_hash_tag,39,0,4,4,0.426845,0.324451,0,"#00e8b2"
1227500224219951104,humd1920t1,0,0,8,8,0.355047,0.429227,0.001948,"#3e93ff"
1134549909854720000,sehcyt,39,1,3,4,0.463112,0.640571,0,"#fcae7e"
824380117304668162,labingranada,15,3,4,7,0.510219,0.549048,0.001461,"#006032"
1228149556564463621,AideCuarenta,35,1,4,5,0.245086,0.374076,0.000487,"#c42c63"
1227642241570820103,tei_publisher,46,3,1,4,0.259276,0.493626,0,"#3e93ff"
1302422896644632577,PaolaRicaurte,0,86,0,86,0.371282,0.499989,0.039942,"#3e93ff"
1110694569908338688,JuanGomez1495,15,0,7,7,0.481456,0.494957,0.001461,"#006032"
907360541143965696,godinez4punto0,0,0,7,7,0.365019,0.418359,0.001461,"#3e93ff"
1250910763461550080,rubiales46,25,0,4,4,0.345933,0.524794,0,"#ff0d69"
1152951115304095744,uv_pedagogia,15,0,5,5,0.497744,0.478327,0.000487,"#006032"
963794355806003201,EBarrosoCruz,21,0,4,4,0.47356,0.46243,0,"#ffa64e"
4709931749,fyluniovi,48,5,5,10,0.505353,0.557655,0.002923,"#ffb800"
785110444008673280,chabe_ruiz_pena,48,0,6,6,0.530403,0.587614,0.000974,"#ffb800"
1017401037978648578,FAILUREPROJECT1,21,0,7,7,0.576028,0.451734,0.001461,"#ffa64e"
1011529528370499584,GradoUam,21,0,4,4,0.593893,0.443414,0,"#ffa64e"
1049965256733335552,reire_idp,15,5,1,6,0.470221,0.51018,0.000974,"#006032"
1147051146080653312,DanielRRivera3,12,0,6,6,0.391943,0.419139,0.000974,"#ff77ff"
798566411157303296,IUMemoria,21,3,5,8,0.547734,0.786523,0.001948,"#ffa64e"
1224720829000355840,Mariana16107991,35,2,3,5,0.281251,0.412456,0.000487,"#c42c63"
887818786396672000,foster_ivanoo,35,1,3,4,0.241699,0.385616,0,"#c42c63"
1112475692153884673,historiayvideo1,28,22,2,24,0.613887,0.580072,0.009742,"#00ed5d"
4854351471,conectados2p,12,0,5,5,0.463756,0.42906,0.000487,"#ff77ff"
971340693569441793,RCEstrategicas,15,7,2,9,0.597812,0.528322,0.002435,"#ff0d69"
1017878369973743616,TsiolisVassilis,37,2,2,4,0.480389,0.615875,0,"#fcae7e"
1102636829554196480,FacultadTeIUVa,48,6,3,9,0.625642,0.483219,0.002435,"#008ebb"
1153228268532830211,CREARIcongreso,15,56,9,65,0.456801,0.48743,0.029713,"#006032"
1188157686254309378,selat_org,37,6,0,6,0.604008,0.580505,0.000974,"#ffb800"
1237141641133162496,UnColombia,19,25,6,31,0.427702,0.43768,0.013151,"#00ed5d"
1481213247713861632,AndaluciaDig,46,6,0,6,0.338201,0.593927,0.000974,"#3bec00"
1166869737856524288,Avila_Unica,15,0,4,4,0.50401,0.484575,0,"#006032"
984716531006431234,Inaki_nav,15,0,4,4,0.505657,0.484912,0,"#006032"
1155084044004143104,DHSIatlantic,46,10,1,11,0.466189,0.416036,0.00341,"#ffb800"
1054032045075247104,KatiusciaDarici,46,3,1,4,0.437771,0.516461,0,"#ff0d69"
847591188332990466,JEP_Colombia,19,4,0,4,0.461593,0.395512,0,"#00ed5d"
1114001391540822017,RepDeFiFidonia,16,4,0,4,0.32339,0.226021,0,"#3e93ff"
1065381758286336000,memoriademexico,0,11,3,14,0.360463,0.369942,0.004871,"#3e93ff"
946022581374775296,UrcaInstitute,39,3,5,8,0.459868,0.347111,0.001948,"#00e8b2"
749911783398408192,igrezan,19,2,5,7,0.542093,0.427394,0.001461,"#00ed5d"
788781514830049280,MasterAntigua,49,4,3,7,0.508748,0.526874,0.001461,"#ffa64e"
1092356840845967360,saharasoundsca2,15,2,7,9,0.501682,0.518877,0.002435,"#006032"
4296417136,ETSIIT_UGR,15,9,4,13,0.512513,0.52146,0.004384,"#006032"
831973105904078849,aranohtar,1,8,3,11,0.423016,0.532485,0.00341,"#ff12a3"
955529490154733568,Dvaronac1984,0,0,7,7,0.410318,0.470876,0.001461,"#ff0d69"
944238703106494464,jrhentschke,19,1,4,5,0.370809,0.316258,0.000487,"#00ed5d"
901882312622825473,ErikaNa13945882,1,0,5,5,0.348498,0.505847,0.000487,"#825403"
1160977945474871296,UCaldasFAH,19,5,4,9,0.647881,0.631475,0.002435,"#5456a6"
866610838756622340,OCMDigiDoc,15,1,4,5,0.519294,0.524556,0.000487,"#006032"
924714834616311810,PropylaeumAnt,28,5,12,17,0.41864,0.548774,0.006332,"#8ecfec"
957851988175159298,rottamotta,1,0,5,5,0.343509,0.496961,0.000487,"#825403"
1102846276520026115,Aunclicdelastic,1,4,0,4,0.138587,0.589294,0,"#825403"
918965304893599745,debasmachado,39,11,1,12,0.420444,0.226045,0.003897,"#00e8b2"
826855556979761152,Ps_Digitales,46,12,0,12,0.180465,0.332103,0.003897,"#3bec00"
832648418950393857,ire_ub,15,6,7,13,0.336818,0.513335,0.004384,"#006032"
990031363129606145,RaquelJorgeR,46,2,2,4,0.353394,0.562357,0,"#3bec00"
958461195945697280,MaEsL_UA,46,2,2,4,0.434905,0.608854,0,"#ff0d69"
4625706267,desingedic,46,16,19,35,0.365238,0.528478,0.0151,"#ffb800"
1115879423138521089,hdh2019,37,32,13,45,0.447719,0.598982,0.019971,"#fcae7e"
1137059446071468039,MaluMar71683932,39,0,4,4,0.499787,0.010486,0,"#00e8b2"
1146818113549275143,egevtec,36,2,2,4,0.231647,0.515307,0,"#6c241e"
1126421043374186496,emlexmundus,54,2,3,5,0.517959,0.416117,0.000487,"#c6cc85"
996341413762732032,acadcienciaslx,54,3,4,7,0.521666,0.384424,0.001461,"#c6cc85"
1386460246730756100,_daq_,1,5,0,5,0.289035,0.557595,0.000487,"#825403"
1229443529866387456,dhpaulspence,46,31,0,31,0.429363,0.466034,0.013151,"#ffb800"
1023487660000768000,AsetelTeoria,15,14,1,15,0.447275,0.649178,0.005358,"#ff0d69"
700670591011926017,visgraflab,39,1,5,6,0.416845,0.327287,0.000974,"#00e8b2"
815917666108051458,mecarrillo2017,15,0,4,4,0.423384,0.555878,0,"#ff0d69"
988806663783239680,fortext_catma,0,5,2,7,0.34508,0.463116,0.001461,"#3e93ff"
769293081434873857,DILAC_GT,12,0,4,4,0.360517,0.419341,0,"#ff77ff"
1098996903432409093,CideHistoria,27,3,1,4,0.452482,0.207682,0,"#ff77ff"
1159658953497698305,arc_lopezt,35,2,5,7,0.251427,0.388441,0.001461,"#c42c63"
1123197929186037760,IEXCUL1,49,6,3,9,0.545944,0.470093,0.002435,"#ffa64e"
933009376239063040,mavi_mestre,15,10,0,10,0.450629,0.479713,0.002923,"#006032"
1159095657258504192,dhCenter_,0,4,0,4,0.346564,0.516442,0,"#ff0d69"
708007315287445504,ICTKasia,15,0,4,4,0.417389,0.557313,0,"#006032"
970783788556013570,LetrasUM,28,7,0,7,0.459878,0.690138,0.001461,"#008ebb"
940672922678693888,LopezToranJM,37,4,11,15,0.483462,0.610996,0.005358,"#fcae7e"
1008379470129090562,MangasNatalia,28,0,4,4,0.448184,0.577603,0,"#8ecfec"
801772516444372993,Ocnos_revista,48,0,4,4,0.499269,0.555672,0,"#008ebb"
838879264246226944,CECLM_UCLM,37,6,5,11,0.490891,0.614412,0.00341,"#fcae7e"
4927174383,EducacionUsal,28,0,6,6,0.402057,0.594187,0.000974,"#8ecfec"
4321161454,jacastellanosl,37,0,5,5,0.442771,0.579782,0.000487,"#fcae7e"
4517893702,uclm_inter,37,1,9,10,0.476218,0.580812,0.002923,"#fcae7e"
1119698516102787079,IUnisabaneta,19,2,2,4,0.603644,0.992694,0,"#5456a6"
751427214630064128,numeteris,46,4,0,4,0.384822,0.463956,0,"#3bec00"
1181422752085020672,ColoquioHDMzles,19,0,8,8,0.677818,0.682261,0.001948,"#5456a6"
728608124081348609,PrismaRU,26,4,5,9,0.318664,0.287388,0.002435,"#3e93ff"
1088817493320318978,CSICmasI,48,19,1,20,0.531494,0.485038,0.007793,"#ff0d69"
1073742015337123840,GMarquezColin,26,4,0,4,0.330847,0.319391,0,"#3e93ff"
1033955641411493888,BabaCirculo,19,0,11,11,0.405745,0.422333,0.00341,"#00ed5d"
801962927305564160,IntrusaDocument,0,0,7,7,0.504725,0.360034,0.001461,"#3e93ff"
943139401558839299,Madrid_IAS,49,6,4,10,0.539535,0.479776,0.002923,"#3bec00"
1115375807596244994,XVIIIWSREBIUN,15,3,2,5,0.425059,0.666176,0.000487,"#006032"
4732637128,ope_ucm,48,4,1,5,0.549698,0.482184,0.000487,"#ff0d69"
822826632671010816,Pinzon_Fuchs,19,0,5,5,0.429689,0.434476,0.000487,"#3e93ff"
830007823065034752,paulapsobrino,15,5,0,5,0.515129,0.729864,0.000487,"#006032"
1014901823440908289,MPlanetarias,46,0,6,6,0.350348,0.499306,0.000974,"#3e93ff"
798165447300485121,RedInvestChile,10,6,5,11,0.255837,0.445558,0.00341,"#3bec00"
1089604367429312512,ECUDIE1,31,26,8,34,0.419005,0.454631,0.014613,"#3e93ff"
866681638574542849,summa_edu,15,2,2,4,0.599041,0.728373,0,"#006032"
779033789079048194,coleccionesUNAM,26,3,1,4,0.580903,0.314252,0,"#3e93ff"
938009624007139329,ArnauBaroMas,48,2,3,5,0.471751,0.595689,0.000487,"#ff0d69"
1035169781568163841,DianaPalardy,0,6,3,9,0.286104,0.483239,0.002435,"#ff77ff"
997031968402563072,martaherrer0,15,1,3,4,0.278581,0.510435,0,"#006032"
1149016871267708929,SeecValladolid,37,4,0,4,0.737566,0.536278,0,"#ffb800"
742992646730330113,RdH_UNED,46,5,2,7,0.476373,0.617359,0.001461,"#ffb800"
836222725798547456,pcabrera7,37,0,5,5,0.464182,0.58964,0.000487,"#008ebb"
961520527675416576,feijoo_costa,48,2,4,6,0.307563,0.584896,0.000974,"#ffb800"
976728152507600896,DH2019_NL,0,7,0,7,0.409056,0.476241,0.001461,"#3e93ff"
782647665234292736,amoralesrondan,21,12,45,57,0.520909,0.396333,0.025816,"#ffa64e"
778176348938440705,Cultura_FiloUSC,48,4,0,4,0.361566,0.606701,0,"#008ebb"
1124113035516420096,HerdingTrish,12,0,4,4,0.380909,0.410684,0,"#ff77ff"
1085728843711897600,smsociologia,26,40,0,40,0.715398,0.5306,0.017535,"#3e93ff"
960937800081334275,pasado_abierto,31,5,1,6,0.57964,0.389989,0.000974,"#3bec00"
1020385106727440384,CAPES_Oficial,39,5,0,5,0.458295,0.28062,0.000487,"#00e8b2"
899796658678104065,BalticoIdeas,19,0,5,5,0.61799,0.411976,0.000487,"#00ed5d"
964498863632584707,dhinstitutes,12,2,3,5,0.383654,0.316535,0.000487,"#3e93ff"
869155874014711808,AfiladorM21,28,2,3,5,0.500843,0.148396,0.000487,"#8ecfec"
1053236455680696320,weareshifta,48,4,1,5,0.519761,0.367064,0.000487,"#ff0d69"
1096097520843771904,Andrese244,35,2,2,4,0.243974,0.374667,0,"#c42c63"
1366866408844500997,ScriptaManent12,48,7,0,7,0.406383,0.573768,0.001461,"#ff0d69"
874601569735643137,dg_romance,49,3,2,5,0.373529,0.552489,0.000487,"#ff0d69"
1113035931014049792,ArteAsri,0,10,0,10,0.424149,0.492111,0.002923,"#3e93ff"
994941054729285632,qgises,54,5,0,5,0.49203,0.493371,0.000487,"#c6cc85"
905213155659456512,GeochicasOSM,54,1,4,5,0.468168,0.494214,0.000487,"#c6cc85"
702900243646586880,secctthh,39,7,0,7,0.442003,0.615855,0.001461,"#ffb800"
985875694570926083,tecnoeduc_usc,49,4,3,7,0.157467,0.538013,0.001461,"#c6cc85"
1099982238995922944,group6thum18,12,0,8,8,0.343677,0.469348,0.001948,"#ff77ff"
851506489906933760,InvesAyH,10,6,2,8,0.261332,0.419196,0.001948,"#3bec00"
837219264679526401,Trans_Literacy,19,4,0,4,0.437218,0.39506,0,"#00ed5d"
1118915895940796425,Yorick20435346,46,0,4,4,0.339782,0.5336,0,"#3bec00"
1073980184766935041,juanasa96586050,0,0,4,4,0.338815,0.472883,0,"#3e93ff"
818936775741685764,CCyTT_UMA,39,4,0,4,0.386274,0.605873,0,"#ffb800"
1067903097727578112,ATHARProject,12,0,4,4,0.35654,0.420821,0,"#ff77ff"
863573257684910086,danielmbarragn,12,0,4,4,0.390846,0.398553,0,"#ff77ff"
825463363929042944,MisticaVirtual,46,6,1,7,0.349782,0.591687,0.001461,"#ffb800"
801411977314795520,DelegacionH,37,1,3,4,0.491056,0.586705,0,"#fcae7e"
4705633128,outwither,19,0,4,4,0.407314,0.40939,0,"#ff77ff"
873308336120352768,virginia_ahedo,36,4,0,4,0.601658,0.358159,0,"#00e8b2"
736256190812848130,patrimonio_mex,35,4,1,5,0.156947,0.344228,0.000487,"#c42c63"
909173661164347392,HistPartes,0,0,4,4,0.382292,0.406248,0,"#3e93ff"
875552762980913152,ErikaVG_SLP,0,0,4,4,0.366908,0.418361,0,"#3e93ff"
822625227628834817,LabMediosyTec,0,0,4,4,0.425681,0.418761,0,"#3e93ff"
1096541624211927041,MurielBazaldua,8,0,6,6,0.750871,0.140471,0.000974,"#3e93ff"
985809543916670981,tropeliasunizar,28,5,0,5,0.555868,0.664653,0.000487,"#00ed5d"
999031882015789057,octimana,28,4,2,6,0.452297,0.687284,0.000974,"#8ecfec"
709384412480335872,cvbrandoe,12,0,12,12,0.413426,0.477569,0.003897,"#ff77ff"
1093882399459590149,QuotesHDsur,19,8,0,8,0.455844,0.431916,0.001948,"#3e93ff"
829749537233330176,colabora_hd,54,32,14,46,0.460979,0.461029,0.020458,"#c6cc85"
1119167012398194690,canalull,48,24,0,24,0.553243,0.585155,0.009742,"#008ebb"
1082600503001911296,IECanarios,48,1,3,4,0.528668,0.599705,0,"#008ebb"
700416747229351936,epihum,37,37,2,39,0.472722,0.535351,0.017048,"#ffb800"
778042183236542464,VictorLpezMtz,46,0,5,5,0.346619,0.441119,0.000487,"#3bec00"
1014875433521893379,OficinaEquidad,10,5,6,11,0.261044,0.084297,0.00341,"#3bec00"
4634988073,_perroTuerto,0,2,4,6,0.43031,0.481059,0.000974,"#3e93ff"
1040262846549041152,mujermodernaUCM,46,8,3,11,0.378706,0.519368,0.00341,"#3e93ff"
772719688497434624,CFIDT_UNED,46,8,16,24,0.422045,0.527486,0.009742,"#ffb800"
829782776463384576,IsisReneeCampos,12,7,1,8,0.289124,0.432291,0.001948,"#ff77ff"
1060151720934825984,CEComparatistas,15,1,3,4,0.479455,0.468422,0,"#ff0d69"
965621075316035584,Universia,46,4,0,4,0.452176,0.485532,0,"#ff0d69"
804632977519112192,CongresoHDH2017,15,133,44,177,0.426415,0.537415,0.084267,"#ff0d69"
787323204075393025,UncoveringC,48,0,5,5,0.450523,0.466578,0.000487,"#ff0d69"
776579967060676608,RevMenocchio,12,1,5,6,0.362486,0.486202,0.000974,"#ff77ff"
1025711423970848768,GeneracionNu,54,4,3,7,0.492805,0.49718,0.001461,"#c6cc85"
4897204209,DPE_CSIC,48,4,4,8,0.499402,0.534532,0.001948,"#008ebb"
763382415121346560,Aleccrin,0,0,4,4,0.439894,0.446092,0,"#ff0d69"
4927222775,FilosofiaUsal,28,1,5,6,0.401525,0.594123,0.000974,"#8ecfec"
4927160571,EconomiaUsal,28,0,5,5,0.402635,0.611762,0.000487,"#8ecfec"
4827210033,ILG_USC,46,3,6,9,0.43227,0.53784,0.002435,"#ffb800"
832008080384745476,BonaudiCecilia,46,0,5,5,0.306171,0.506106,0.000487,"#3bec00"
827156848478261248,fosterc_upv,48,3,1,4,0.555373,0.462162,0,"#ff0d69"
721758002357866496,souto_esther,46,4,3,7,0.473087,0.548986,0.001461,"#ffb800"
4325976913,LARRLASA,19,5,0,5,0.398931,0.420185,0.000487,"#00ed5d"
4363999037,diazfranciscoj6,50,6,2,8,0.748211,0.419498,0.001948,"#008bdd"
846014785246367745,Fisher85M,14,5,0,5,0.610284,0.27926,0.000487,"#b6cb00"
708996369713905664,INDI_viladecans,14,5,11,16,0.609354,0.289235,0.005845,"#b6cb00"
948536322226053120,gjescudero,48,3,5,8,0.392604,0.609456,0.001948,"#00e8b2"
1001450135166111744,wsRebiun17,15,5,5,10,0.532619,0.573615,0.002923,"#ff0d69"
961332696940208128,67Indo,50,0,4,4,0.692608,0.410736,0,"#008bdd"
4749643519,LorienTinuviel,12,0,4,4,0.389039,0.432796,0,"#ff77ff"
1009002213178519552,atalisfunding,48,13,1,14,0.536445,0.443749,0.004871,"#ff0d69"
747843141215064064,artecoles,50,11,14,25,0.556686,0.471817,0.010229,"#008bdd"
721916342828343297,technofeminism,15,0,15,15,0.427287,0.461682,0.005358,"#ff77ff"
1008250478688374784,CulturaCDMX,8,9,0,9,0.625531,0.354452,0.002435,"#3e93ff"
779299908515926017,BurmanPhD,12,0,6,6,0.237658,0.429731,0.000974,"#ff77ff"
884145923307302912,ideas_libertad,50,2,2,4,0.730009,0.450863,0,"#008bdd"
1002147850636185601,GrupoUhu,15,4,4,8,0.38482,0.654559,0.001948,"#008ebb"
988862056978886659,nabecitasube,54,0,5,5,0.585895,0.692105,0.000487,"#c6cc85"
727875505698054144,EgresadosFIC,54,14,0,14,0.59987,0.664285,0.004871,"#c6cc85"
764074078324023296,DeptoBiol,54,0,5,5,0.596957,0.687476,0.000487,"#c6cc85"
772440726085001217,Mancini_Epic,54,0,7,7,0.590582,0.682371,0.001461,"#c6cc85"
931906726424731649,Ds_Pol_As,15,10,6,16,0.468373,0.518889,0.005845,"#006032"
717055881569959936,UT_HistDept,12,5,6,11,0.332407,0.422244,0.00341,"#ff77ff"
1024398395220393984,AEF_UdelaR,54,0,5,5,0.592247,0.682148,0.000487,"#c6cc85"
1498945219584221188,mhbeals,12,10,0,10,0.398562,0.464986,0.002923,"#ff77ff"
4774959796,RafaelaJaramani,50,0,4,4,0.62092,0.41563,0,"#008bdd"
997147935459627008,UBAposgrados,46,5,5,10,0.208892,0.568584,0.002923,"#3bec00"
977186999227551745,AladaaArgentina,46,5,0,5,0.100323,0.528041,0.000487,"#3bec00"
786576462556127233,ULA_DTES,50,12,5,17,0.617863,0.382831,0.006332,"#008bdd"
1250018230254604288,ZiziChan,50,24,0,24,0.620464,0.411318,0.009742,"#008bdd"
987412476496105472,barcosinaia,21,3,3,6,0.570459,0.671695,0.000974,"#ffa64e"
1000791860498063360,RafaelR2498,24,5,1,6,0.640671,0.512684,0.000974,"#3bec00"
4923178515,gcardax,12,0,4,4,0.324598,0.452091,0,"#ff77ff"
952988847012491265,vdelpentagrama,19,13,6,19,0.40899,0.489609,0.007306,"#00ed5d"
843865704805912576,mibibliotecarev,28,2,2,4,0.344388,0.639571,0,"#8ecfec"
737416794068025346,redeschilenas,10,0,4,4,0.233327,0.443633,0,"#3bec00"
733320756206034945,raquel_riro,0,0,5,5,0.351045,0.38563,0.000487,"#3e93ff"
770988007209959425,lindsayvantine,12,0,5,5,0.375268,0.412206,0.000487,"#ff77ff"
923269061399674880,vilar_la,48,6,2,8,0.475315,0.596212,0.001948,"#008ebb"
831573560313384966,CEHA2018,15,8,2,10,0.491562,0.55836,0.002923,"#ff0d69"
882563270539870208,StrategicWays,14,0,10,10,0.578407,0.29609,0.002923,"#b6cb00"
800698962504130560,revistaeviterna,15,4,4,8,0.455011,0.463714,0.001948,"#ff0d69"
1445482112191123466,MedialabPrado,46,16,0,16,0.51857,0.574667,0.005845,"#ffb800"
735165892426903552,informacionytic,46,0,8,8,0.32418,0.542172,0.001948,"#3bec00"
748058404313239552,TaniaSafuraAdam,14,8,3,11,0.561596,0.274904,0.00341,"#b6cb00"
909697060823343104,pintofscienceMX,12,0,4,4,0.338386,0.357368,0,"#3e93ff"
698226643232538624,CenturyHotelMx,26,0,4,4,0.335557,0.376751,0,"#3e93ff"
4803098175,apsanchez_,48,3,2,5,0.460099,0.427589,0.000487,"#006032"
859122675456847873,mcmartinezg,14,0,10,10,0.594444,0.290643,0.002923,"#b6cb00"
830094660815220736,Revolucio4,14,4,9,13,0.598529,0.230027,0.004384,"#b6cb00"
905485960133177344,_Impaciencia_,15,5,10,15,0.549957,0.509053,0.005358,"#006032"
746700659290939393,earlymusproject,28,8,4,12,0.576862,0.719088,0.003897,"#008ebb"
834432423878336513,XarxaRecerCaixa,48,4,6,10,0.520797,0.575507,0.002923,"#ff0d69"
918748087195197440,Civihudi,46,5,4,9,0.406264,0.53633,0.002435,"#8ecfec"
4909252079,FundacionCEDCS,48,9,9,18,0.457093,0.447651,0.006819,"#ffb800"
839214983288344576,itxaso_deotazu,46,4,0,4,0.312532,0.592829,0,"#3bec00"
755854671953080320,prf1z,46,6,3,9,0.370097,0.530201,0.002435,"#3e93ff"
885988160378982401,ed_coralnegro,22,3,7,10,0.384691,0.544518,0.002923,"#8ecfec"
858977877324378112,CaribeNostrum,22,0,6,6,0.368529,0.552882,0.000974,"#8ecfec"
744315056175874048,eugetsukino,12,0,4,4,0.393089,0.416048,0,"#ff77ff"
705930570887520256,DrMartinSanto,0,0,4,4,0.362921,0.482723,0,"#3e93ff"
725385283802390531,Digital_HD_TIC,46,14,31,45,0.395084,0.535582,0.019971,"#3bec00"
946013227355435008,lingsev,22,2,3,5,0.361318,0.601426,0.000487,"#8ecfec"
695313583413030913,Arqus_3D,15,5,2,7,0.493609,0.477311,0.001461,"#ff0d69"
700398412689235968,SergioTerrera,46,3,2,5,0.293699,0.622771,0.000487,"#3bec00"
730813453246464001,MConstituciones,0,6,4,10,0.339242,0.400268,0.002923,"#3e93ff"
850698599117856769,duttanjan84,48,4,0,4,0.529256,0.591261,0,"#ff0d69"
930483592009887745,taiarrano,46,7,1,8,0.366537,0.516618,0.001948,"#3bec00"
753299973022834688,mfressoli,46,1,3,4,0.311798,0.506275,0,"#3bec00"
1383063807698857993,ahencyclopedia,15,10,0,10,0.349568,0.66456,0.002923,"#ff0d69"
4853978344,revistaatalanta,22,3,3,6,0.383703,0.575095,0.000974,"#8ecfec"
995994829657010176,dibam_cl,32,164,0,164,0.112226,0.219234,0.077935,"#00ed5d"
4654584375,_N_SG_,46,0,6,6,0.409782,0.559874,0.000974,"#8ecfec"
707278302139052032,paolabanegas82,46,1,5,6,0.389497,0.592493,0.000974,"#3bec00"
868928393613643776,labo_lamop,48,7,3,10,0.412225,0.576977,0.002923,"#008ebb"
937378694561239041,AsnesMariela,35,0,4,4,0.189158,0.387408,0,"#c42c63"
4360821376,musacces,46,3,3,6,0.486683,0.667721,0.000974,"#ffb800"
1227708533078097921,comunicaunirio,39,5,0,5,0.401459,0.077188,0.000487,"#00e8b2"
856071812509302784,Anda_Labs,15,4,2,6,0.574859,0.551527,0.000974,"#006032"
781521249877065728,entresiglos2016,46,3,1,4,0.382694,0.622993,0,"#ffb800"
842033838385709057,seepluex,39,0,5,5,0.591458,0.443678,0.000487,"#00e8b2"
842793924829876224,AnitaCorts2,46,4,0,4,0.302685,0.595018,0,"#3bec00"
740178241445593088,SuemiHiguchi,39,7,0,7,0.344517,0.388884,0.001461,"#00e8b2"
4619684853,big_data_flow,48,0,5,5,0.407148,0.518507,0.000487,"#3bec00"
721031747161468928,arqueo_lucia,46,3,1,4,0.452665,0.557456,0,"#ffb800"
799625332005470209,AMenendezDeLaC1,46,1,5,6,0.445347,0.535302,0.000974,"#ffb800"
744635256574218240,paco_ferrandiz,48,5,3,8,0.458328,0.564444,0.001948,"#008ebb"
847334338521845760,asyrasinfo,15,0,5,5,0.413086,0.576871,0.000487,"#ff0d69"
902311193372749825,_MEMEMX,0,3,3,6,0.252448,0.385328,0.000974,"#00ed5d"
890329789944541184,CuVimx,1,4,0,4,0.150808,0.495444,0,"#825403"
1290078643289497605,antrophistoria,17,17,0,17,0.219432,0.5355,0.006332,"#825403"
907885245952876544,MatchingChina,15,5,0,5,0.467924,0.500281,0.000487,"#ff0d69"
822516479639724032,arqdillinger1,0,4,28,32,0.319943,0.337191,0.013639,"#3e93ff"
877922772466511877,CIESTAAM_UACh,15,3,4,7,0.573277,0.537364,0.001461,"#006032"
815289129734930432,Sr_Grasshoper,46,3,6,9,0.376048,0.53117,0.002435,"#ffb800"
829271118913605633,ISSI_UNED,46,0,7,7,0.445854,0.564265,0.001461,"#ffb800"
4786036942,dLoCaribbean,42,9,2,11,0.346914,0.195016,0.00341,"#005076"
859741324060360704,DLGMA_CSIC,48,4,0,4,0.464812,0.581658,0,"#008ebb"
781484233311264768,MilagrosLetras,15,0,7,7,0.474086,0.511257,0.001461,"#ff0d69"
817478777299050496,herna_santigo,48,0,4,4,0.583748,0.531418,0,"#ff12a3"
1325633905668608002,CulturalSanMar,46,19,0,19,0.330599,0.572706,0.007306,"#3bec00"
718181412264751104,vistahermosama1,35,5,6,11,0.262014,0.450827,0.00341,"#c42c63"
768452408108285952,ElObservadorWeb,46,4,0,4,0.33067,0.576831,0,"#3bec00"
821666958680719361,lsi_uned,46,11,3,14,0.44354,0.580939,0.004871,"#ffb800"
729717485394595840,UNEDmasterInfor,46,11,0,11,0.450376,0.582549,0.00341,"#ffb800"
791197272902098944,CanalFONCE_UNED,46,0,4,4,0.442613,0.602899,0,"#ffb800"
4449802275,pablorlMadrid,48,4,2,6,0.464812,0.620321,0.000974,"#ffb800"
4501457112,CerebroUrbanoMx,0,2,3,5,0.305392,0.457861,0.000487,"#3e93ff"
809437758448107521,UCMJornadasDig,46,21,14,35,0.460467,0.569469,0.0151,"#ffb800"
827276374473740289,RuiOaxaca,12,0,4,4,0.295671,0.601529,0,"#3bec00"
782860647621095424,evamaoliv,46,6,3,9,0.460884,0.559733,0.002435,"#ffb800"
795616618286092288,humanosdigitale,46,6,1,7,0.288717,0.547449,0.001461,"#3bec00"
705857447848763392,CorunaBloggers,54,4,2,6,0.545582,0.54908,0.000974,"#c6cc85"
736999961620058113,_sophiegrimaldi,46,4,0,4,0.444555,0.559146,0,"#ffb800"
4830027369,huma_nun,46,5,0,5,0.360261,0.57686,0.000487,"#3bec00"
707899199094964224,ProgArqDigital,46,8,7,15,0.381865,0.560623,0.005358,"#ffb800"
745315925113573376,ddmag_es,22,4,1,5,0.390972,0.639292,0.000487,"#8ecfec"
4858132510,libroensevilla,22,6,2,8,0.353904,0.643053,0.001948,"#8ecfec"
778631747487592448,LuisaLoisM,21,5,1,6,0.420271,0.623319,0.000974,"#ffb800"
739849159637893120,tek_fest,54,2,3,5,0.542554,0.545976,0.000487,"#c6cc85"
774360460330209280,TICEVale,26,0,4,4,0.324512,0.379241,0,"#3e93ff"
745972119113207808,martab_lib,46,0,4,4,0.379399,0.540775,0,"#ffb800"
1358554256383627267,akatoxkatl,0,11,0,11,0.3657,0.43168,0.00341,"#3e93ff"
747474927759007745,e_LITEMAD,21,2,3,5,0.450337,0.75237,0.000487,"#ffa64e"
937997865418358784,SilviaEGT,0,30,0,30,0.372254,0.456555,0.012664,"#3e93ff"
823187349228154881,UAB_info,48,12,0,12,0.483445,0.538114,0.003897,"#ff0d69"
700489489584562176,SocArgLing,46,0,4,4,0.367801,0.539202,0,"#3bec00"
4830827233,dhwg_tamu,0,0,4,4,0.334816,0.421989,0,"#3e93ff"
704393516869287936,EdulabIlce,17,0,6,6,0.357172,0.568444,0.000974,"#3bec00"
4527152596,SchulbaumO,48,11,1,12,0.530915,0.435883,0.003897,"#ff0d69"
4923953953,stewartbbrand,17,6,0,6,0.340665,0.565845,0.000974,"#3bec00"
799557600564150272,InstitutF,46,8,0,8,0.417291,0.583144,0.001948,"#ffb800"
855506065957560321,AntonioCruces4,15,4,0,4,0.476531,0.492189,0,"#ff0d69"
