Id,Label,modularity_class,indegree,outdegree,degree,X,Y,Size,Color
4783,Adriana,41,1,0,1,0.371891,0.392277,0,"#697b00"
4816,EFF,13,1,0,1,0.404013,0.392435,0,"#3bec00"
11084,hdh,30,9,0,9,0.52976,0.527133,0.003891,"#ff77ff"
11545,diegocambiaso,38,0,1,1,0.674245,0.416365,0,"#662859"
12306,zentree,34,0,3,3,0.459265,0.438201,0.000973,"#ff0d69"
35993,jbj,36,0,5,5,0.442343,0.373163,0.001946,"#825403"
58613,gallo1,3,1,0,1,0.46698,0.661565,0,"#ffb3ff"
60283,javierleiva,19,6,0,6,0.537049,0.611577,0.002432,"#00d3ff"
61253,javiermoya,0,11,7,18,0.457159,0.54482,0.008268,"#8ecfec"
62963,jjmerelo,31,0,6,6,0.552697,0.526628,0.002432,"#3e93ff"
352553,dh,55,1,0,1,0.700311,0.521841,0,"#cb3f32"
420343,uam,37,7,0,7,0.526657,0.520656,0.002918,"#006032"
712963,paulasimoes,36,15,19,34,0.551421,0.48529,0.016051,"#825403"
727903,nova,36,1,0,1,0.567003,0.312949,0,"#825403"
731833,oneeyedman,30,0,1,1,0.436827,0.700093,0,"#ff77ff"
732943,nataliavivas,34,2,1,3,0.573721,0.449851,0.000973,"#ff0d69"
760807,lacordero,13,8,4,12,0.455511,0.390214,0.00535,"#3bec00"
762426,ramonsang,14,1,2,3,0.509652,0.543533,0.000973,"#00eeff"
763841,Hipertextual,30,4,0,4,0.528186,0.613802,0.001459,"#ff77ff"
767742,sinhuebaez,13,1,0,1,0.224013,0.510161,0,"#3bec00"
768841,lion05,13,0,1,1,0.47744,0.238772,0,"#3bec00"
782482,paw,13,0,4,4,0.496739,0.417618,0.001459,"#3bec00"
783214,Twitter,13,1,0,1,0.440092,0.367656,0,"#3bec00"
784885,lernys,13,0,1,1,0.422394,0.526861,0,"#3bec00"
789833,EmilioMendozaF,15,0,1,1,0.564488,0.752544,0,"#008ebb"
792920,ecerverab,14,2,3,5,0.567356,0.550084,0.001946,"#00eeff"
803441,thigo212,36,0,1,1,0.546462,0.312787,0,"#825403"
807095,nytimes,30,5,0,5,0.519903,0.569245,0.001946,"#ff77ff"
811377,Reddit,49,2,0,2,0.404787,0.536291,0.000486,"#ff7007"
816178,MADRID,58,69,0,69,0.583061,0.355238,0.033074,"#005076"
819051,ManuelBartual,0,0,1,1,0.773168,0.59926,0,"#8ecfec"
823057,adolflow,22,0,2,2,0.551467,0.576182,0.000486,"#00e8b2"
823905,wordpressdotcom,1,24,0,24,0.503268,0.592678,0.011187,"#b6cb00"
887971,morenovski,36,2,0,2,0.489637,0.345333,0.000486,"#825403"
941401,textundblog,13,1,6,7,0.512647,0.476748,0.002918,"#3bec00"
1046661,science,22,1,0,1,0.517888,0.677354,0,"#00e8b2"
1091241,jfreire,3,12,2,14,0.485382,0.572231,0.006323,"#ffb3ff"
1095651,taih,14,0,1,1,0.598539,0.498237,0,"#00eeff"
1200241,griffey,49,0,2,2,0.55115,0.380704,0.000486,"#ff7007"
1275921,SimonTanner,13,0,1,1,0.488065,0.365574,0,"#3bec00"
1344951,WIRED,36,9,0,9,0.502637,0.438552,0.003891,"#825403"
1347441,josemurilo,36,1,1,2,0.301264,0.558982,0.000486,"#825403"
1527461,ssn,36,0,1,1,0.565985,0.437156,0,"#825403"
1550681,eltransito,58,0,2,2,0.594979,0.309177,0.000486,"#005076"
1583811,jtauber,22,1,0,1,0.507545,0.678156,0,"#00e8b2"
1589381,RyanDeschamps,34,0,1,1,0.463986,0.372178,0,"#ff0d69"
1636821,wwwhatsnew,1,1,0,1,0.514481,0.656405,0,"#b6cb00"
1677721,NickEllis,36,1,0,1,0.442569,0.153165,0,"#825403"
1736841,loretahur,31,1,0,1,0.637796,0.521885,0,"#3e93ff"
1782991,antounh,36,0,3,3,0.47914,0.253456,0.000973,"#825403"
1818181,jairogalindo,3,14,11,25,0.352686,0.555783,0.011673,"#ffb3ff"
1821291,luizahguimaraes,36,0,1,1,0.503062,0.304759,0,"#825403"
1851301,Ginetto,55,1,0,1,0.609388,0.569036,0,"#cb3f32"
1853021,birasuegi,36,0,1,1,0.335004,0.155913,0,"#825403"
1862631,txerren,30,0,1,1,0.467512,0.618867,0,"#ff77ff"
1908541,teketen,36,0,1,1,0.331828,0.15109,0,"#825403"
1952751,Julio_Valentim,36,0,2,2,0.534428,0.442284,0.000486,"#825403"
2021281,sydneyskybetter,34,0,1,1,0.337375,0.433004,0,"#ff0d69"
2108531,ignace,49,0,1,1,0.337864,0.493041,0,"#ff7007"
2170361,olea,2,4,0,4,0.714807,0.647996,0.001459,"#ffa64e"
2256781,cronai,36,1,0,1,0.413821,0.218933,0,"#825403"
2280391,adolfoestalella,22,3,3,6,0.516726,0.350719,0.002432,"#00e8b2"
2291631,rlaf,34,0,1,1,0.372094,0.48121,0,"#ff0d69"
2331061,nopiedra,34,1,6,7,0.507794,0.541418,0.002918,"#ff0d69"
2331081,Vic,49,2,0,2,0.467366,0.572718,0.000486,"#ff7007"
2437791,Sr_Sotomonte,14,1,3,4,0.601019,0.57465,0.001459,"#00eeff"
2647811,QuintoHache,31,0,3,3,0.569332,0.490154,0.000973,"#3e93ff"
2673391,marionel,38,2,1,3,0.59849,0.379639,0.000973,"#662859"
2676431,juleniturbe,18,7,6,13,0.694865,0.568998,0.005837,"#5456a6"
2876971,VictorMoral,13,0,1,1,0.532378,0.393379,0,"#3bec00"
2931631,kavango,30,15,49,64,0.490423,0.546999,0.030642,"#ff77ff"
2953551,magpie,34,27,3,30,0.489837,0.459121,0.014105,"#ff0d69"
2965701,josuka,49,0,1,1,0.418705,0.575312,0,"#ff7007"
3007491,todrobbins,13,0,1,1,0.399669,0.387688,0,"#3bec00"
3122211,eraser,0,58,42,100,0.515502,0.476286,0.048152,"#8ecfec"
3137551,mcortesmartin,34,0,3,3,0.450281,0.44505,0.000973,"#ff0d69"
3195971,Boletin,30,1,0,1,0.47441,0.709129,0,"#ff77ff"
3365101,versae,30,11,31,42,0.512106,0.509665,0.019942,"#ff77ff"
3408521,lolox,0,0,1,1,0.384446,0.548483,0,"#8ecfec"
3411801,jlpalacios,31,0,2,2,0.572065,0.593447,0.000486,"#3e93ff"
3550661,joewiz,36,0,2,2,0.430962,0.512953,0.000486,"#825403"
3608801,emingonaval,49,1,0,1,0.378401,0.622287,0,"#ff7007"
3740971,generico,14,3,0,3,0.593915,0.489273,0.000973,"#00eeff"
3744021,andrelemos,36,1,0,1,0.53289,0.310045,0,"#825403"
3874361,ferrenet,49,1,0,1,0.391172,0.68322,0,"#ff7007"
3893121,ampato,30,0,1,1,0.604984,0.664524,0,"#ff77ff"
3917471,Misifusi,13,0,3,3,0.441122,0.451112,0.000973,"#3bec00"
3926511,jborrego,30,0,14,14,0.503695,0.518191,0.006323,"#ff77ff"
3975661,Anayancy,3,1,0,1,0.623307,0.578183,0,"#ffb3ff"
4046891,ganyet,8,21,2,23,0.63531,0.394835,0.0107,"#00ed5d"
4052731,cesarastudillo,35,6,1,7,0.638611,0.443872,0.002918,"#00faff"
4174231,krmita,22,0,1,1,0.571846,0.733783,0,"#00e8b2"
4181751,CamaradaBakunin,22,0,1,1,0.396615,0.610821,0,"#00e8b2"
4386321,LA,58,4,0,4,0.451927,0.567663,0.001459,"#005076"
4594121,autonauta,40,0,2,2,0.100941,0.402282,0.000486,"#ff12a3"
4609241,Humanidades,55,2,0,2,0.716489,0.518349,0.000486,"#cb3f32"
4628161,tiscar,22,2,1,3,0.5982,0.550843,0.000973,"#00e8b2"
4648731,Horizonte24,49,1,0,1,0.389168,0.679942,0,"#ff7007"
4861221,FJ_Mateo,14,0,1,1,0.40839,0.531501,0,"#00eeff"
5033321,elmorsa,31,0,4,4,0.614648,0.456939,0.001459,"#3e93ff"
5044731,dagosalas,49,1,8,9,0.486482,0.488989,0.003891,"#ff7007"
5067561,UNE,14,1,0,1,0.698938,0.50035,0,"#00eeff"
5127621,upo,1,14,0,14,0.675951,0.540471,0.006323,"#b6cb00"
5204051,VtheWanderer,38,0,2,2,0.615352,0.620941,0.000486,"#662859"
5251921,julianab,1,5,7,12,0.49446,0.549305,0.00535,"#b6cb00"
5444722,sarok,14,0,11,11,0.562597,0.486234,0.004864,"#00eeff"
5493242,DiariodeNavarra,1,6,0,6,0.622333,0.49487,0.002432,"#b6cb00"
5520702,esponjita,19,2,3,5,0.589872,0.491597,0.001946,"#00d3ff"
5625972,eventbrite,30,1,0,1,0.501474,0.633882,0,"#ff77ff"
5695032,Yale,2,8,0,8,0.498985,0.531676,0.003405,"#ffa64e"
5710862,arkangel,31,0,3,3,0.580484,0.515305,0.000973,"#3e93ff"
5713842,antonigr,0,1,5,6,0.502812,0.547636,0.002432,"#8ecfec"
5776732,pbongiovanni,37,14,8,22,0.457667,0.591004,0.010214,"#006032"
5851532,iridium,34,0,2,2,0.449714,0.453896,0.000486,"#ff0d69"
5871682,Streamweaver,34,0,1,1,0.409894,0.284252,0,"#ff0d69"
5936422,minipetite,3,1,0,1,0.474829,0.663493,0,"#ffb3ff"
5943942,SoundCloud,55,2,0,2,0.627337,0.554415,0.000486,"#cb3f32"
5967322,jcmorocho,34,0,4,4,0.442356,0.46661,0.001459,"#ff0d69"
5976792,ubibene,30,0,2,2,0.54609,0.68497,0.000486,"#ff77ff"
6003222,Solano,37,1,0,1,0.372035,0.314748,0,"#006032"
6066942,chimosoler,22,3,0,3,0.631424,0.567225,0.000973,"#00e8b2"
6067212,bi0xid,1,1,2,3,0.466258,0.563256,0.000973,"#b6cb00"
6108882,jmcclurken,34,0,4,4,0.360731,0.455673,0.001459,"#ff0d69"
6114332,patrick_mj,49,0,1,1,0.352797,0.482928,0,"#ff7007"
6182422,angelesb,13,0,1,1,0.479004,0.395104,0,"#3bec00"
6217612,Yano_,7,0,1,1,0.360696,0.325896,0,"#ffb800"
6230612,Amparo,40,0,1,1,0.61338,0.040385,0,"#ff12a3"
6244412,chinto,0,0,2,2,0.2855,0.54093,0.000486,"#8ecfec"
6367162,MartaPastor,8,0,2,2,0.665256,0.303044,0.000486,"#00ed5d"
6390182,sfern,41,1,0,1,0.308024,0.388346,0,"#697b00"
6417982,pastordc3110,17,1,0,1,0.744272,0.195812,0,"#ff9cc7"
6477792,LuisB,37,0,2,2,0.646388,0.552945,0.000486,"#006032"
6489892,verarex,49,0,1,1,0.804625,0.577932,0,"#ff7007"
6524592,jcpeyssard,36,0,2,2,0.423311,0.508063,0.000486,"#825403"
6567482,acastrillejo,30,0,5,5,0.543483,0.498694,0.001946,"#ff77ff"
6580122,OUPAcademic,36,3,0,3,0.442554,0.342062,0.000973,"#825403"
6605462,jcramirezf,19,1,0,1,0.680089,0.780436,0,"#00d3ff"
6643882,javiercelaya,0,19,2,21,0.558353,0.598368,0.009728,"#8ecfec"
6709582,rbarlam,31,0,1,1,0.641271,0.504434,0,"#3e93ff"
6723132,nirak,34,0,3,3,0.442932,0.462805,0.000973,"#ff0d69"
6735732,jmrayas,14,0,1,1,0.295953,0.442993,0,"#00eeff"
6752632,flamencastone,30,6,0,6,0.547058,0.577825,0.002432,"#ff77ff"
6771532,lukasnet,3,4,5,9,0.469357,0.605341,0.003891,"#ffb3ff"
6810492,lievesofgrass,13,0,2,2,0.472731,0.408026,0.000486,"#3bec00"
6819312,msguasha,22,0,1,1,0.567201,0.736369,0,"#00e8b2"
6865442,dariah,30,1,0,1,0.594346,0.562231,0,"#ff77ff"
6868092,LuisBermejo,49,1,0,1,0.393166,0.677256,0,"#ff7007"
6886052,lindacq,14,1,0,1,0.296934,0.428605,0,"#00eeff"
6937342,Albornoz,38,0,1,1,0.658918,0.421517,0,"#662859"
6964542,alejandroangel,38,6,3,9,0.546897,0.353447,0.003891,"#662859"
7067082,PedroCarrillo,1,20,66,86,0.495433,0.520335,0.041342,"#b6cb00"
7092342,yamilsalinas,0,0,1,1,0.376821,0.573389,0,"#8ecfec"
7152572,librarycongress,22,1,0,1,0.621043,0.618483,0,"#00e8b2"
7157292,bourdieu,7,4,5,9,0.62381,0.494145,0.003891,"#ffb800"
7272222,eurom,19,4,0,4,0.64006,0.736031,0.001459,"#00d3ff"
7305532,Musebrarian,7,0,3,3,0.441322,0.40867,0.000973,"#ffb800"
7306822,alvaroliuzzi,3,1,0,1,0.454785,0.676977,0,"#ffb3ff"
7312902,RosaCruzBejaran,37,0,1,1,0.441759,0.673461,0,"#006032"
7334402,alfranken,49,4,0,4,0.448244,0.632204,0.001459,"#ff7007"
7445912,pablod,41,0,1,1,0.329856,0.349041,0,"#697b00"
7465672,quinnanya,34,26,9,35,0.467855,0.481967,0.016537,"#ff0d69"
7480172,gleonhard,31,1,0,1,0.333176,0.52321,0,"#3e93ff"
7506322,edmundogs,3,20,7,27,0.473735,0.586012,0.012646,"#ffb3ff"
7556392,Invertia,31,1,0,1,0.740908,0.57663,0,"#3e93ff"
7601052,Hugo_pardo,8,1,0,1,0.288987,0.676681,0,"#00ed5d"
7650242,zanoni,8,2,0,2,0.388565,0.710958,0.000486,"#00ed5d"
7666852,uchile,56,1,0,1,0.379381,0.088923,0,"#384205"
7679392,CatalunyaRadio,8,2,0,2,0.658794,0.296224,0.000486,"#00ed5d"
7734362,erchache2000,1,0,2,2,0.445676,0.599118,0.000486,"#b6cb00"
7746742,jorgaf,13,0,1,1,0.527424,0.398816,0,"#3bec00"
7769322,pablomatamoros,49,1,0,1,0.317028,0.681038,0,"#ff7007"
7789622,NievesGlez,1,0,1,1,0.364307,0.551138,0,"#b6cb00"
7802892,mdlt,3,1,1,2,0.465409,0.639433,0.000486,"#ffb3ff"
7809342,tefisahakian,3,0,1,1,0.469435,0.665954,0,"#ffb3ff"
7827962,infobaeamerica,22,1,0,1,0.632757,0.418241,0,"#00e8b2"
7845362,elipariser,49,2,0,2,0.463308,0.687012,0.000486,"#ff7007"
7847282,edic,30,1,0,1,0.485819,0.653249,0,"#ff77ff"
7889802,Beltzane,22,0,2,2,0.543693,0.608873,0.000486,"#00e8b2"
7910642,parselis,3,3,5,8,0.4718,0.61834,0.003405,"#ffb3ff"
7938852,historiador,22,8,0,8,0.66003,0.399862,0.003405,"#00e8b2"
7961212,lucasexequiel,34,0,1,1,0.367031,0.478045,0,"#ff0d69"
7996082,el_pais,2,67,1,68,0.594287,0.595506,0.032588,"#ffa64e"
8039622,james3neal,34,0,2,2,0.363022,0.458155,0.000486,"#ff0d69"
8062702,grjenkin,36,0,1,1,0.525973,0.295459,0,"#825403"
8081312,Chucheria,37,0,1,1,0.557246,0.623256,0,"#006032"
8083032,nimbusaeta,37,27,18,45,0.527324,0.550613,0.021401,"#006032"
8083992,guadalopez,49,1,1,2,0.428845,0.55934,0.000486,"#ff7007"
8087392,polisea,31,176,65,241,0.558469,0.524172,0.116732,"#3e93ff"
8089762,mtascon,14,0,2,2,0.570311,0.530214,0.000486,"#00eeff"
8097602,Aina_Borras,14,5,11,16,0.52053,0.516618,0.007296,"#00eeff"
8099122,evahmf,2,0,2,2,0.459269,0.64623,0.000486,"#ffa64e"
8099802,neuromancien,7,3,8,11,0.50904,0.504988,0.004864,"#ffb800"
8168562,elcomercio,31,5,0,5,0.590016,0.488584,0.001946,"#3e93ff"
8188202,RubenQuesada,34,0,1,1,0.318512,0.409041,0,"#ff0d69"
8204452,levante_emv,31,1,0,1,0.649608,0.513725,0,"#3e93ff"
8301552,AnthonyMasure,36,4,8,12,0.510621,0.527262,0.00535,"#825403"
8314502,p4olamosso,21,0,2,2,0.442572,0.713964,0.000486,"#c6cc85"
8352352,glovink,13,0,3,3,0.443954,0.443628,0.000973,"#3bec00"
8391292,jelenabartermad,3,0,1,1,0.459709,0.660374,0,"#ffb3ff"
8408702,mrmxyzptlk,21,0,1,1,0.336503,0.45651,0,"#c6cc85"
8470992,yaso,49,2,0,2,0.52774,0.420954,0.000486,"#ff7007"
8497902,historia,1,2,0,2,0.44382,0.626388,0.000486,"#b6cb00"
8536532,tnor27,34,0,5,5,0.441096,0.476154,0.001946,"#ff0d69"
8626252,alesscar,36,0,1,1,0.671222,0.404687,0,"#825403"
8627932,ictlogist,8,17,8,25,0.536113,0.478582,0.011673,"#00ed5d"
8639402,madrimasd,2,7,6,13,0.603425,0.652606,0.005837,"#ffa64e"
8675782,HeK_Basel,1,3,0,3,0.467177,0.464215,0.000973,"#b6cb00"
8681442,dmartins,36,1,0,1,0.513982,0.274061,0,"#825403"
8705572,amaciel,49,0,2,2,0.375414,0.535638,0.000486,"#ff7007"
8727882,criswergara,49,0,1,1,0.377945,0.309958,0,"#ff7007"
8729462,evamoraga,30,10,1,11,0.50637,0.559967,0.004864,"#ff77ff"
8742642,evamen,30,10,11,21,0.497563,0.581468,0.009728,"#ff77ff"
8756852,fathermocker,21,0,3,3,0.272594,0.356595,0.000973,"#c6cc85"
8813332,heliopaz,36,0,1,1,0.523634,0.204608,0,"#825403"
8816652,busuab,14,0,5,5,0.602285,0.548815,0.001946,"#00eeff"
8817502,andrepase,36,0,1,1,0.513539,0.202194,0,"#825403"
8831402,tristan_roddis,36,6,2,8,0.468011,0.412766,0.003405,"#825403"
8874622,mind_booster,36,0,5,5,0.557229,0.455016,0.001946,"#825403"
8938182,CinemaErratico,37,0,2,2,0.411851,0.485758,0.000486,"#006032"
9005192,tomasoski,21,0,2,2,0.253487,0.284761,0.000486,"#c6cc85"
9104202,jeroenbosman,49,1,0,1,0.39441,0.531348,0,"#ff7007"
9123032,petrizzo,34,0,1,1,0.410231,0.468178,0,"#ff0d69"
9128552,elcontemplador,49,1,0,1,0.347106,0.69696,0,"#ff7007"
9192272,monrodriguez,3,0,2,2,0.443162,0.618561,0.000486,"#ffb3ff"
9206682,dreig,30,1,0,1,0.635858,0.706831,0,"#ff77ff"
9260282,pascalin,49,0,1,1,0.311533,0.498885,0,"#ff7007"
9276252,terenet,22,68,74,142,0.558945,0.577445,0.06858,"#00e8b2"
9291632,mjspinto,3,2,0,2,0.575532,0.800058,0.000486,"#ffb3ff"
9334522,atarecos,42,1,1,2,0.689726,0.473835,0.000486,"#66e087"
9383442,dam1an,0,0,2,2,0.452235,0.384552,0.000486,"#8ecfec"
9387452,RafaelFajardo,21,0,1,1,0.330819,0.437556,0,"#c6cc85"
9407372,fcioni,37,0,1,1,0.44828,0.668742,0,"#006032"
9546132,Wilsofo,34,2,5,7,0.515355,0.437468,0.002918,"#ff0d69"
9557662,juglardelzipa,34,0,4,4,0.500412,0.341423,0.001459,"#ff0d69"
9563732,formagrupo,31,0,1,1,0.762994,0.920805,0,"#3e93ff"
9588742,crism321,22,1,2,3,0.525699,0.609758,0.000973,"#00e8b2"
9590442,patjarmar,38,6,5,11,0.529,0.535539,0.004864,"#662859"
9613942,cuadernos,51,1,0,1,0.543843,0.184411,0,"#c44aac"
9633802,ELTIEMPO,38,4,0,4,0.618067,0.481307,0.001459,"#662859"
9656342,paulamonse,49,0,2,2,0.387846,0.510013,0.000486,"#ff7007"
9676152,SlideShare,49,24,0,24,0.458696,0.520317,0.011187,"#ff7007"
9685592,espiritusanto,0,0,1,1,0.792996,0.697332,0,"#8ecfec"
9727422,igrgavilan,49,1,0,1,0.366682,0.628418,0,"#ff7007"
9751592,yobiblioteca,49,12,2,14,0.487177,0.58612,0.006323,"#ff7007"
9758512,prensa14,0,64,4,68,0.466047,0.550928,0.032588,"#8ecfec"
9775372,fernandoruiz,30,0,2,2,0.350526,0.522017,0.000486,"#ff77ff"
9776942,viuda_politica,21,0,1,1,0.207485,0.199576,0,"#c6cc85"
9785862,omeka,36,12,3,15,0.517352,0.466296,0.006809,"#825403"
9788592,dloc,34,1,0,1,0.459777,0.218277,0,"#ff0d69"
9812592,Tengoku,36,1,0,1,0.505444,0.16698,0,"#825403"
9823342,jmdodero,37,0,1,1,0.343903,0.343938,0,"#006032"
9834362,radarqnet,13,1,0,1,0.407004,0.422547,0,"#3bec00"
9846452,paualsina,14,7,19,26,0.529137,0.514862,0.01216,"#00eeff"
9893772,zotero,34,34,0,34,0.451052,0.485265,0.016051,"#ff0d69"
9894072,mvjbomfim,36,1,8,9,0.499442,0.302086,0.003891,"#825403"
9894272,chnm,34,0,3,3,0.44013,0.435879,0.000973,"#ff0d69"
9986382,arguhlin,34,0,1,1,0.332133,0.398591,0,"#ff0d69"
10012122,bbcmundo,38,3,0,3,0.478917,0.38305,0.000973,"#662859"
10020762,Mnemosine,30,1,0,1,0.597356,0.554309,0,"#ff77ff"
10034972,tjowens,0,1,0,1,0.523108,0.406594,0,"#8ecfec"
10074662,J_A_Mata,14,0,1,1,0.701888,0.549811,0,"#00eeff"
10135862,samadeu,36,4,2,6,0.480531,0.314715,0.002432,"#825403"
10162032,Soares_LucianoS,34,0,7,7,0.492466,0.386154,0.002918,"#ff0d69"
10164002,constnz,49,1,5,6,0.439373,0.564444,0.002432,"#ff7007"
10228272,YouTube,30,92,0,92,0.54403,0.5012,0.044261,"#ff77ff"
10253742,Oyerista,3,0,2,2,0.488893,0.569545,0.000486,"#ffb3ff"
10263532,Ixchelik,13,0,2,2,0.457904,0.411071,0.000486,"#3bec00"
10278552,craiublletres,14,0,5,5,0.5682,0.586075,0.001946,"#00eeff"
10338632,MyrnaLee,49,0,1,1,0.461763,0.621494,0,"#ff7007"
10342242,pabloescandon,22,0,22,22,0.532493,0.53805,0.010214,"#00e8b2"
10362822,andreasaraiva,36,0,2,2,0.506306,0.276003,0.000486,"#825403"
10385522,bydiox,30,0,1,1,0.45439,0.59226,0,"#ff77ff"
10397822,danipsicologa80,49,0,6,6,0.443861,0.515839,0.002432,"#ff7007"
10463722,thc1972,41,0,1,1,0.336875,0.350209,0,"#697b00"
10507892,Brazoli,36,0,1,1,0.531251,0.207231,0,"#825403"
10524772,arivero,31,0,1,1,0.595953,0.463084,0,"#3e93ff"
10531562,alvarezamo,58,0,1,1,0.365742,0.574465,0,"#005076"
10535552,ricardov_cl,49,7,14,21,0.416757,0.470784,0.009728,"#ff7007"
10602772,joakinen,22,6,6,12,0.392659,0.580314,0.00535,"#00e8b2"
10607522,pgervas,30,3,0,3,0.519927,0.612374,0.000973,"#ff77ff"
10609732,teadira,42,2,3,5,0.611912,0.417221,0.001946,"#66e087"
10628022,vistarini,22,0,1,1,0.240389,0.688062,0,"#00e8b2"
10634512,leofoletto,49,1,0,1,0.38689,0.622105,0,"#ff7007"
10712662,sescsp,36,2,0,2,0.503681,0.224142,0.000486,"#825403"
10737472,precariobecario,14,0,3,3,0.58071,0.488431,0.000973,"#00eeff"
10741522,chernandez,55,0,1,1,0.778564,0.535409,0,"#cb3f32"
10773422,DarkWing_V,38,0,1,1,0.733704,0.327188,0,"#662859"
10805852,enmarcha,14,3,1,4,0.521074,0.355274,0.001459,"#00eeff"
10832182,asantimartinez,7,6,0,6,0.450751,0.426679,0.002432,"#ffb800"
10863952,rubenman,13,0,4,4,0.48601,0.428225,0.001459,"#3bec00"
10908822,baradit,21,0,2,2,0.210523,0.262659,0.000486,"#c6cc85"
10928862,Sciuridae,38,2,0,2,0.398164,0.21924,0.000486,"#662859"
11025592,Maperez324,13,0,34,34,0.472117,0.508883,0.016051,"#3bec00"
11031402,TAC_NISO,49,0,2,2,0.559151,0.376677,0.000486,"#ff7007"
11059612,gamoia,14,0,2,2,0.482097,0.508168,0.000486,"#00eeff"
11060492,jmejia00,31,0,3,3,0.608482,0.565874,0.000973,"#3e93ff"
11112192,veek,49,8,2,10,0.447925,0.49334,0.004377,"#ff7007"
11207112,leonardotoledo,34,0,1,1,0.488013,0.37788,0,"#ff0d69"
11231412,Yoriento,14,1,0,1,0.698629,0.361622,0,"#00eeff"
11297602,ivdacruz,0,0,5,5,0.457326,0.516138,0.001946,"#8ecfec"
11305842,cdkloos,2,0,2,2,0.662732,0.619568,0.000486,"#ffa64e"
11327242,felixlozano,22,14,10,24,0.60358,0.5229,0.011187,"#00e8b2"
11332442,FIDRomanistik,13,28,102,130,0.497414,0.507666,0.062743,"#3bec00"
11403252,jordisn,14,1,0,1,0.654892,0.506218,0,"#00eeff"
11440702,jjbotev,30,0,6,6,0.497491,0.537363,0.002432,"#ff77ff"
11448222,ontoligent,49,0,1,1,0.353698,0.474569,0,"#ff7007"
11484132,kzhr,36,0,1,1,0.384772,0.482472,0,"#825403"
11488672,skotperez,31,0,1,1,0.585056,0.468084,0,"#3e93ff"
11553312,aovalle,34,0,4,4,0.454305,0.451191,0.001459,"#ff0d69"
11581562,culturas_cl,21,0,3,3,0.293742,0.249764,0.000973,"#c6cc85"
11641272,agoraidea,22,0,1,1,0.842143,0.300395,0,"#00e8b2"
11647702,personaUP,22,0,2,2,0.81586,0.298395,0.000486,"#00e8b2"
11661342,JavierNoguerol,30,1,0,1,0.554889,0.590098,0,"#ff77ff"
11661402,marindacos,13,1,0,1,0.428197,0.409947,0,"#3bec00"
11691052,susana79,1,0,2,2,0.383839,0.546205,0.000486,"#b6cb00"
11702102,Jessifer,31,2,0,2,0.596274,0.535611,0.000486,"#3e93ff"
11753412,stephieborges,36,0,1,1,0.498806,0.220237,0,"#825403"
11919222,Aulo,22,2,3,5,0.420019,0.582193,0.001946,"#00e8b2"
11960432,Bagolina,13,1,0,1,0.400121,0.400342,0,"#3bec00"
12035172,patana,49,31,21,52,0.431722,0.490452,0.024805,"#ff7007"
12043242,briancroxall,36,0,1,1,0.426503,0.563268,0,"#825403"
12068692,madsjvk,13,1,0,1,0.344611,0.301178,0,"#3bec00"
12083202,rosabg,31,0,1,1,0.639756,0.517006,0,"#3e93ff"
12098842,cadaunante,21,0,1,1,0.207701,0.238289,0,"#c6cc85"
12108822,AuntySue,14,0,2,2,0.574814,0.498485,0.000486,"#00eeff"
12110922,jmescotet,30,0,2,2,0.549629,0.61107,0.000486,"#ff77ff"
12148062,alorenzo64,49,1,0,1,0.369914,0.608851,0,"#ff7007"
12160482,marc_smith,36,0,1,1,0.390601,0.312837,0,"#825403"
12237542,friede,49,2,1,3,0.428142,0.536556,0.000973,"#ff7007"
12344732,pilica,19,4,2,6,0.61318,0.497887,0.002432,"#00d3ff"
12346172,metik,13,2,6,8,0.4906,0.445275,0.003405,"#3bec00"
12351972,voxgraeca,22,1,2,3,0.40941,0.600208,0.000973,"#00e8b2"
12366502,jadedid,34,2,0,2,0.416232,0.443838,0.000486,"#ff0d69"
12392442,diegocruzblog,1,0,2,2,0.731748,0.566693,0.000486,"#b6cb00"
12432262,McDawg,13,0,2,2,0.475464,0.415154,0.000486,"#3bec00"
12523152,patricioalegre,3,0,3,3,0.52859,0.609559,0.000973,"#ffb3ff"
12537022,claulopez,21,0,1,1,0.308341,0.44908,0,"#c6cc85"
12556232,karlotti,49,1,0,1,0.406058,0.661406,0,"#ff7007"
12563152,mauricioangel,38,0,4,4,0.500957,0.465758,0.001459,"#662859"
12570802,valcilon,34,0,2,2,0.469672,0.417241,0.000486,"#ff0d69"
12595332,bfernandez,7,0,3,3,0.463873,0.494299,0.000973,"#ffb800"
12609292,OpenSociety,38,1,0,1,0.528196,0.367207,0,"#662859"
12632702,redpuntoes,0,20,0,20,0.471514,0.582321,0.009241,"#8ecfec"
12640312,DEJPett,34,0,3,3,0.454071,0.468475,0.000973,"#ff0d69"
12725692,piscitelli,3,214,69,283,0.483748,0.579287,0.13716,"#ffb3ff"
12760682,mari3la,21,0,2,2,0.215649,0.260695,0.000486,"#c6cc85"
12815132,elmostrador,21,8,0,8,0.71642,0.475421,0.003405,"#c6cc85"
12824222,perearagones,8,1,0,1,0.651335,0.23897,0,"#00ed5d"
12869372,ardiluzu,18,1,1,2,0.726359,0.603705,0.000486,"#5456a6"
12915562,Bibliojo,13,0,1,1,0.540254,0.403676,0,"#3bec00"
13053492,fedkukso,49,1,1,2,0.402537,0.572717,0.000486,"#ff7007"
13058772,LinkedIn,1,3,0,3,0.463993,0.584527,0.000973,"#b6cb00"
13068142,rdelavega,15,0,2,2,0.648452,0.42804,0.000486,"#008ebb"
13071032,DanielBenchi,49,2,1,3,0.420209,0.675518,0.000973,"#ff7007"
13180032,gusei,3,2,0,2,0.458309,0.62842,0.000486,"#ffb3ff"
13195602,zegim,30,0,1,1,0.46367,0.598741,0,"#ff77ff"
13235112,jrodiles,3,0,3,3,0.456902,0.570217,0.000973,"#ffb3ff"
13257922,manovich,36,26,7,33,0.503684,0.522124,0.015564,"#825403"
13265452,nbrx,37,0,1,1,0.473431,0.314018,0,"#006032"
13284982,cioran10506,37,1,1,2,0.545585,0.516083,0.000486,"#006032"
13285502,socialcolectivo,38,2,0,2,0.631161,0.455608,0.000486,"#662859"
13291482,carlosarcila,30,0,1,1,0.475474,0.632272,0,"#ff77ff"
13312312,jhidalgo,42,6,1,7,0.606239,0.447873,0.002918,"#66e087"
13315562,prestrepoo,38,2,0,2,0.638005,0.460547,0.000486,"#662859"
13323622,anadefinisterra,36,0,5,5,0.517248,0.36124,0.001946,"#825403"
13334762,github,30,1,0,1,0.467394,0.600712,0,"#ff77ff"
13343682,migpapi,30,0,1,1,0.613799,0.478549,0,"#ff77ff"
13344262,sms2sms,36,1,9,10,0.457963,0.334189,0.004377,"#825403"
13467742,espinosaanke,37,0,1,1,0.450107,0.61668,0,"#006032"
13493522,saandreoli,49,7,7,14,0.368707,0.568736,0.006323,"#ff7007"
13507572,1000io,49,1,0,1,0.41325,0.686782,0,"#ff7007"
13568892,denisparra,49,2,0,2,0.371176,0.469085,0.000486,"#ff7007"
13663322,ManoloCastillo,14,0,2,2,0.616608,0.508473,0.000486,"#00eeff"
13708782,canalsur,19,1,0,1,0.626495,0.793415,0,"#00d3ff"
13745182,mgiraldo,38,11,5,16,0.604761,0.418363,0.007296,"#662859"
13790232,mapc,49,0,8,8,0.358751,0.398414,0.003405,"#ff7007"
13802082,thatcamp,34,1,0,1,0.496035,0.377237,0,"#ff0d69"
13883652,danimoi2,58,2,2,4,0.544115,0.609664,0.001459,"#005076"
14053306,LanceStrate,36,2,0,2,0.456876,0.401066,0.000486,"#825403"
14058041,cm4rt,34,1,0,1,0.541258,0.385021,0,"#ff0d69"
14060977,alberuiza,14,2,1,3,0.679127,0.548674,0.000973,"#00eeff"
14075146,libreros,22,24,11,35,0.586653,0.548299,0.016537,"#00e8b2"
14078152,alexbensan,14,3,5,8,0.479237,0.588894,0.003405,"#00eeff"
14078613,ERamirez_,36,0,5,5,0.465977,0.500863,0.001946,"#825403"
14079548,jdegra,49,1,0,1,0.409264,0.696189,0,"#ff7007"
14084259,arkatPDA,13,0,1,1,0.528991,0.396613,0,"#3bec00"
14084406,gworthey,13,15,29,44,0.478329,0.467844,0.020914,"#3bec00"
14086502,mdalmau,49,2,4,6,0.441989,0.508548,0.002432,"#ff7007"
14086852,UMD_MITH,49,31,6,37,0.448521,0.513077,0.01751,"#ff7007"
14089054,fraistat,30,0,8,8,0.495013,0.489453,0.003405,"#ff77ff"
14093970,estebanmoro,4,0,4,4,0.918405,0.242186,0.001459,"#f4c8cf"
14097765,dadaisis,13,1,0,1,0.52854,0.354024,0,"#3bec00"
14104338,renzoarauco,34,2,0,2,0.452985,0.522514,0.000486,"#ff0d69"
14108417,javo01,34,2,0,2,0.459574,0.363734,0.000486,"#ff0d69"
14112146,ngc2020,30,0,5,5,0.500471,0.574856,0.001946,"#ff77ff"
14114461,angelalmarza,34,9,33,42,0.473859,0.484595,0.019942,"#ff0d69"
14118112,DocDre,34,0,2,2,0.380626,0.460057,0.000486,"#ff0d69"
14136205,padaguan,37,14,5,19,0.478233,0.400236,0.008755,"#006032"
14138776,manuentropia,18,0,2,2,0.753505,0.58913,0.000486,"#5456a6"
14147110,julio80,7,0,1,1,0.405636,0.354498,0,"#ffb800"
14149194,KiriCarini,36,5,1,6,0.447895,0.441535,0.002432,"#825403"
14149396,mundoenlinea,49,1,0,1,0.414782,0.68098,0,"#ff7007"
14157408,BBVAInnovation,22,1,0,1,0.624809,0.638691,0,"#00e8b2"
14165894,tonferret_,15,0,2,2,0.625693,0.512118,0.000486,"#008ebb"
14167084,amadeucorbera,40,0,1,1,0.596129,0.037919,0,"#ff12a3"
14172818,Kiadorindani,13,0,2,2,0.413335,0.473682,0.000486,"#3bec00"
14178113,xpectro,3,4,0,4,0.467072,0.561143,0.001459,"#ffb3ff"
14181097,dancohen,36,1,0,1,0.590021,0.426191,0,"#825403"
14184263,jasonrhody,36,0,1,1,0.448868,0.311626,0,"#825403"
14184585,alaznegonzalez,3,3,1,4,0.58671,0.624616,0.001459,"#ffb3ff"
14191318,unsworth,49,1,0,1,0.368195,0.530236,0,"#ff7007"
14196493,lborras,15,1,0,1,0.573634,0.622406,0,"#008ebb"
14201969,bgmartins,36,0,2,2,0.577617,0.413624,0.000486,"#825403"
14214983,emastromatteo,49,4,12,16,0.508598,0.51847,0.007296,"#ff7007"
14215044,jserranom,14,7,1,8,0.603166,0.579529,0.003405,"#00eeff"
14216117,harmodio,14,3,3,6,0.39915,0.508211,0.002432,"#00eeff"
14217300,aschifani,49,2,0,2,0.424375,0.513848,0.000486,"#ff7007"
14221013,nowviskie,13,3,6,9,0.476006,0.470666,0.003891,"#3bec00"
14225088,elcomerciodigit,14,2,0,2,0.625999,0.902883,0.000486,"#00eeff"
14229832,Adam_Crymble,34,70,23,93,0.481949,0.456467,0.044747,"#ff0d69"
14233770,piotrr70,30,2,9,11,0.517483,0.525434,0.004864,"#ff77ff"
14234306,joseantvazquez,19,0,1,1,0.649239,0.631135,0,"#00d3ff"
14234902,benwbrum,49,8,7,15,0.471203,0.452638,0.006809,"#ff7007"
14235803,josepvives,8,0,3,3,0.675441,0.423541,0.000973,"#00ed5d"
14237268,purbiola,0,0,1,1,0.39542,0.557834,0,"#8ecfec"
14238371,Rusajoropera,14,1,1,2,0.596066,0.454682,0.000486,"#00eeff"
14242599,mvallez,2,0,1,1,0.652481,0.659143,0,"#ffa64e"
14245878,claudiomanoel,36,1,0,1,0.422453,0.284394,0,"#825403"
14251177,jaireeo,36,1,0,1,0.302802,0.392367,0,"#825403"
14260694,foblike,13,0,1,1,0.434089,0.402795,0,"#3bec00"
14271401,marianolopata,49,0,1,1,0.798861,0.583529,0,"#ff7007"
14276656,tmtn,36,0,2,2,0.417033,0.462852,0.000486,"#825403"
14276782,daniela_quiroz,21,0,1,1,0.217111,0.207745,0,"#c6cc85"
14279589,mferna,22,3,0,3,0.433866,0.702353,0.000973,"#00e8b2"
14281578,labarranca,49,1,0,1,0.368064,0.653407,0,"#ff7007"
14298448,ryanfb,13,0,1,1,0.504501,0.399151,0,"#3bec00"
14299702,diegopimentel,49,7,3,10,0.404536,0.581141,0.004377,"#ff7007"
14308843,kfitz,36,7,8,15,0.440644,0.462983,0.006809,"#825403"
14309193,guzmanadrian,3,0,4,4,0.473104,0.58658,0.001459,"#ffb3ff"
14313408,juliadantas,21,1,0,1,0.650692,0.162522,0,"#c6cc85"
14330959,jafurtado,7,1,1,2,0.58277,0.514318,0.000486,"#ffb800"
14331786,recercat,8,1,0,1,0.687949,0.254813,0,"#00ed5d"
14331818,edsu,36,2,9,11,0.46067,0.376717,0.004864,"#825403"
14334375,Eurecat_news,37,1,0,1,0.693973,0.554902,0,"#006032"
14335904,AnnaSimo,8,2,0,2,0.592879,0.383403,0.000486,"#00ed5d"
14339121,tokkamak,22,0,1,1,0.582409,0.623576,0,"#00e8b2"
14339792,adolfocorujo,0,0,2,2,0.652444,0.628644,0.000486,"#8ecfec"
14349708,esparver,8,0,4,4,0.682224,0.242792,0.001459,"#00ed5d"
14351258,bertaisabel,19,0,1,1,0.612486,0.454189,0,"#00d3ff"
14356676,lafurys,38,0,1,1,0.525527,0.322561,0,"#662859"
14359862,marianorico,22,8,2,10,0.541805,0.616465,0.004377,"#00e8b2"
14364838,joseoyarce,49,1,0,1,0.38775,0.64457,0,"#ff7007"
14365625,geramovel,22,0,1,1,0.56688,0.679094,0,"#00e8b2"
14371276,editora,30,0,1,1,0.571032,0.740675,0,"#ff77ff"
14387513,jgordin,49,1,0,1,0.359344,0.633143,0,"#ff7007"
14389790,UQAM,30,1,0,1,0.540604,0.622515,0,"#ff77ff"
14391603,BertaAresY,30,1,1,2,0.499579,0.561922,0.000486,"#ff77ff"
14392350,joannathebug,36,0,2,2,0.501456,0.21156,0.000486,"#825403"
14394972,torressalinas,31,4,2,6,0.604667,0.537242,0.002432,"#3e93ff"
14395513,CelesteLopezP,8,1,2,3,0.594793,0.445259,0.000973,"#00ed5d"
14410795,777SHEM,49,2,0,2,0.445389,0.588293,0.000486,"#ff7007"
14411275,lmi,13,1,0,1,0.42928,0.494916,0,"#3bec00"
14417479,parraa23,35,0,1,1,0.725271,0.415158,0,"#00faff"
14427119,sbassi,55,1,0,1,0.768075,0.646761,0,"#cb3f32"
14430185,TheGotzReport,36,1,0,1,0.557685,0.100895,0,"#825403"
14435873,javier_raya,30,0,2,2,0.596874,0.44457,0.000486,"#ff77ff"
14436030,elmundoes,37,16,0,16,0.51457,0.506106,0.007296,"#006032"
14438300,luishernando,22,0,1,1,0.668287,0.526289,0,"#00e8b2"
14440299,guzferreira,36,0,1,1,0.446072,0.267552,0,"#825403"
14455944,tazy,4,0,1,1,0.836549,0.227344,0,"#f4c8cf"
14456615,xebatrocas,21,0,1,1,0.17048,0.225239,0,"#c6cc85"
14468423,laurien,34,7,8,15,0.449377,0.362562,0.006809,"#ff0d69"
14479180,auconet,34,0,2,2,0.514632,0.428619,0.000486,"#ff0d69"
14481695,ChicaBurbuja,21,0,1,1,0.194523,0.196015,0,"#c6cc85"
14489131,cyber_gusy,7,0,1,1,0.34404,0.320093,0,"#ffb800"
14512341,salvadorleal,3,0,1,1,0.688868,0.709833,0,"#ffb3ff"
14516324,robertosaviano,38,1,0,1,0.546523,0.36604,0,"#662859"
14517051,renataaquino,49,0,5,5,0.507092,0.559149,0.001946,"#ff7007"
14522154,felipecl,9,10,9,19,0.657369,0.612364,0.008755,"#008f7b"
14525080,joseantoniogall,22,0,1,1,0.557653,0.651915,0,"#00e8b2"
14526209,ravsirius,22,4,2,6,0.505219,0.600383,0.002432,"#00e8b2"
14554446,mevision,31,0,1,1,0.653857,0.550663,0,"#3e93ff"
14554759,uv,13,3,0,3,0.426887,0.460584,0.000973,"#3bec00"
14559995,viramundeando,0,0,1,1,0.420639,0.390737,0,"#8ecfec"
14564385,juanibelbis,49,3,6,9,0.424072,0.518207,0.003891,"#ff7007"
14569247,Baeticus,22,1,0,1,0.208864,0.628123,0,"#00e8b2"
14570718,lisaspiro,13,8,0,8,0.464718,0.454795,0.003405,"#3bec00"
14571948,arenitasoria,49,12,9,21,0.408497,0.44171,0.009728,"#ff7007"
14573832,hiperterminal,38,4,6,10,0.566882,0.411587,0.004377,"#662859"
14579047,marianoa,7,0,1,1,0.414711,0.358232,0,"#ffb800"
14584238,DrMiguelRoman,41,0,1,1,0.336278,0.346538,0,"#697b00"
14585572,pmhswe,34,1,5,6,0.408008,0.442162,0.002432,"#ff0d69"
14586613,victorpipa,14,0,1,1,0.585249,0.459265,0,"#00eeff"
14587325,trementyna,13,1,1,2,0.456165,0.369847,0.000486,"#3bec00"
14605554,elli_m,49,8,2,10,0.450514,0.497405,0.004377,"#ff7007"
14606609,tithius,49,9,2,11,0.447459,0.552007,0.004864,"#ff7007"
14611005,jdribo,34,0,2,2,0.36812,0.417149,0.000486,"#ff0d69"
14618725,ginebra,13,0,1,1,0.477294,0.387212,0,"#3bec00"
14620824,congosto,19,3,5,8,0.557184,0.606604,0.003405,"#00d3ff"
14621282,FAngelico,36,0,3,3,0.640371,0.439209,0.000973,"#825403"
14628538,anabee,36,1,1,2,0.755998,0.319482,0.000486,"#825403"
14650624,interaubis,36,0,2,2,0.550242,0.319148,0.000486,"#825403"
14655111,daviddominguez,13,1,0,1,0.418578,0.403844,0,"#3bec00"
14656344,JaviReq,30,0,1,1,0.638222,0.68455,0,"#ff77ff"
14661530,jmarinpu,8,0,5,5,0.526168,0.375329,0.001946,"#00ed5d"
14662475,Kolega,40,0,1,1,0.586072,0.042603,0,"#ff12a3"
14667145,knagasaki,36,0,17,17,0.460849,0.466243,0.007782,"#825403"
14698820,mrsnorris,22,0,13,13,0.572207,0.625056,0.005837,"#00e8b2"
14699166,josesardon,31,0,2,2,0.580718,0.531045,0.000486,"#3e93ff"
14701548,amyeetx,49,3,0,3,0.396895,0.385514,0.000973,"#ff7007"
14710282,LuisOlaveA,49,1,0,1,0.367384,0.620126,0,"#ff7007"
14716327,manuchis,13,0,1,1,0.412422,0.496323,0,"#3bec00"
14722537,rafaeliba,22,0,1,1,0.523528,0.707781,0,"#00e8b2"
14724464,vrmex,49,1,0,1,0.357331,0.608053,0,"#ff7007"
14726505,WalterScolz,49,4,0,4,0.466972,0.553952,0.001459,"#ff7007"
14748208,adlangmead,57,0,1,1,0.714856,0.541539,0,"#b66f7a"
14758529,cescept,14,3,9,12,0.533598,0.617112,0.00535,"#00eeff"
14775733,DOGSocialIntel,0,0,2,2,0.431411,0.581547,0.000486,"#8ecfec"
14789602,sserrano44,49,1,0,1,0.416025,0.689669,0,"#ff7007"
14790618,epiccino,25,4,0,4,0.576187,0.09788,0.001459,"#f4a2ff"
14803078,bgros,8,1,0,1,0.305537,0.679699,0,"#00ed5d"
14821116,charlley,19,3,4,7,0.575712,0.453799,0.002918,"#00d3ff"
14824411,IzquierdaUnida,19,1,0,1,0.638485,0.772993,0,"#00d3ff"
14831098,JorgeGalindo,49,3,0,3,0.424569,0.534255,0.000973,"#ff7007"
14834302,elespectador,38,92,1,93,0.472066,0.687674,0.044747,"#662859"
14838389,marich,30,0,1,1,0.527609,0.656457,0,"#ff77ff"
14842401,balhisay,31,4,2,6,0.597115,0.527007,0.002432,"#3e93ff"
14846961,joguldi,22,2,2,4,0.553088,0.517171,0.001459,"#00e8b2"
14864273,gonzalo_sanchez,3,0,1,1,0.673228,0.697441,0,"#ffb3ff"
14873669,KathrynTomasek,49,1,0,1,0.349917,0.463891,0,"#ff7007"
14884486,BrownUniversity,57,1,0,1,0.7031,0.541824,0,"#b66f7a"
14885557,nadlleli,3,2,1,3,0.469596,0.639442,0.000973,"#ffb3ff"
14892208,hhdd,22,1,0,1,0.498818,0.669783,0,"#00e8b2"
14909349,ricardespelt,22,1,0,1,0.659726,0.525062,0,"#00e8b2"
14919552,UOCuniversitat,14,4,3,7,0.578141,0.535503,0.002918,"#00eeff"
14920335,Biblioteca_US,1,2,1,3,0.468452,0.67662,0.000973,"#b6cb00"
14922017,ruthsofhia,13,0,1,1,0.410473,0.41331,0,"#3bec00"
14929987,jluisestrada,40,0,1,1,0.609185,0.033163,0,"#ff12a3"
14946691,AleBerbe,34,1,0,1,0.428465,0.435755,0,"#ff0d69"
14953788,peralt,14,0,2,2,0.725944,0.54642,0.000486,"#00eeff"
14960548,acorsin,22,11,3,14,0.568575,0.530961,0.006323,"#00e8b2"
14963436,tapiador,22,4,2,6,0.525535,0.55438,0.002432,"#00e8b2"
14976965,malumoraes,14,0,1,1,0.578376,0.47323,0,"#00eeff"
14983632,sahareli_mty,38,0,2,2,0.570382,0.443136,0.000486,"#662859"
14992915,ilazaro,22,0,6,6,0.623967,0.553579,0.002432,"#00e8b2"
14996297,Postdata,30,1,0,1,0.508308,0.61629,0,"#ff77ff"
15009197,desconcertos,48,0,1,1,0.240446,0.704536,0,"#ff7a78"
15039663,eitb,22,5,0,5,0.573713,0.768068,0.001946,"#00e8b2"
15043045,marmosette,6,0,1,1,0.341176,0.754566,0,"#a67800"
15055888,emilio,34,0,1,1,0.390176,0.464495,0,"#ff0d69"
15057943,MuseumModernArt,13,4,0,4,0.473087,0.49938,0.001459,"#3bec00"
15070567,alexandrelopez,31,0,3,3,0.572625,0.494172,0.000973,"#3e93ff"
15096045,oluaces,22,0,1,1,0.651425,0.465201,0,"#00e8b2"
15108897,kajsaha,49,3,0,3,0.393483,0.516187,0.000973,"#ff7007"
15114794,Evazqupu,14,0,3,3,0.577365,0.558127,0.000973,"#00eeff"
15118387,sociologiac,7,4,1,5,0.718483,0.547045,0.001946,"#ffb800"
15119514,e_j_hayes,13,0,1,1,0.503883,0.394882,0,"#3bec00"
15120497,selecters75,49,1,0,1,0.369613,0.680645,0,"#ff7007"
15121709,c0nsaf0s,34,0,6,6,0.414501,0.431891,0.002432,"#ff0d69"
15125585,edge,3,2,0,2,0.452991,0.627153,0.000486,"#ffb3ff"
15135596,tarciziosilva,36,10,11,21,0.487234,0.309048,0.009728,"#825403"
15145256,armartinell,13,24,58,82,0.47612,0.483145,0.039397,"#3bec00"
15169290,LibraryJournal,31,1,0,1,0.787546,0.36992,0,"#3e93ff"
15175262,scholarslab,34,2,7,9,0.428823,0.454306,0.003891,"#ff0d69"
15181766,marmenes,10,17,8,25,0.394329,0.486254,0.011673,"#52d7c0"
15190905,AlbertGarlo,15,0,2,2,0.655,0.425978,0.000486,"#008ebb"
15195678,verbavolant,1,0,2,2,0.464229,0.696066,0.000486,"#b6cb00"
15200482,dalareo,22,0,4,4,0.597044,0.560526,0.001459,"#00e8b2"
15211031,Coatl_S,3,5,5,10,0.481841,0.574956,0.004377,"#ffb3ff"
15232111,CinematecaBta,38,6,2,8,0.818103,0.459108,0.003405,"#662859"
15233333,inactinique,7,9,0,9,0.505502,0.486911,0.003891,"#ffb800"
15240227,tifis,38,1,0,1,0.529576,0.320874,0,"#662859"
15240265,gquimbayo,38,0,3,3,0.535251,0.427035,0.000973,"#662859"
15242983,rmunoz,14,0,3,3,0.56335,0.618632,0.000973,"#00eeff"
15252007,PanamaTipicoCom,30,1,0,1,0.508439,0.620405,0,"#ff77ff"
15257730,lachamba,14,0,6,6,0.508774,0.523347,0.002432,"#00eeff"
15258078,jesusangelpardo,0,2,3,5,0.632719,0.63506,0.001946,"#8ecfec"
15263388,eRomanMe,1,0,1,1,0.431187,0.792699,0,"#b6cb00"
15272863,toririo,13,4,2,6,0.443563,0.421621,0.002432,"#3bec00"
15283118,colfreepress,49,0,19,19,0.470835,0.50892,0.008755,"#ff7007"
15287607,nandanamihindu,22,0,6,6,0.557187,0.640944,0.002432,"#00e8b2"
15294618,stakats,15,1,0,1,0.520184,0.72611,0,"#008ebb"
15301410,eltonpacheco,36,0,1,1,0.539762,0.241232,0,"#825403"
15304474,noalsilencio,38,0,2,2,0.543553,0.324983,0.000486,"#662859"
15306156,elisayuste,14,1,1,2,0.633524,0.547386,0.000486,"#00eeff"
15308809,Hadro,36,0,2,2,0.461191,0.318051,0.000486,"#825403"
15318025,jamescummings,49,1,9,10,0.471806,0.492933,0.004377,"#ff7007"
15318585,HackeMate,13,0,1,1,0.453836,0.390423,0,"#3bec00"
15323284,kenderi,8,0,2,2,0.388284,0.44798,0.000486,"#00ed5d"
15330272,kenami,6,0,1,1,0.340324,0.75077,0,"#a67800"
15343494,ztante,13,1,4,5,0.471385,0.463948,0.001946,"#3bec00"
15345797,arieltorres,49,1,0,1,0.36895,0.615909,0,"#ff7007"
15347454,glasserman,10,0,3,3,0.412933,0.47779,0.000973,"#52d7c0"
15363774,albertdiazmota,14,1,0,1,0.666363,0.592764,0,"#00eeff"
15374134,luxexmachina,38,0,1,1,0.549711,0.405939,0,"#662859"
15374854,aulablog21,14,0,1,1,0.677212,0.496754,0,"#00eeff"
15378599,manlopez,58,5,5,10,0.63329,0.603329,0.004377,"#005076"
15378611,FGV,36,13,0,13,0.478658,0.34604,0.005837,"#825403"
15383357,Ricard_Ramon,31,7,7,14,0.592494,0.480831,0.006323,"#3e93ff"
15389679,turra2,13,0,3,3,0.293385,0.508639,0.000973,"#3bec00"
15392976,robertotheron,14,4,0,4,0.460189,0.635402,0.001459,"#00eeff"
15395246,paregorios,22,1,1,2,0.510817,0.651288,0.000486,"#00e8b2"
15403412,Otello_,22,0,1,1,0.40603,0.613041,0,"#00e8b2"
15404821,mincultura,38,32,1,33,0.578698,0.434361,0.015564,"#662859"
15409967,MujeresHistoria,19,1,0,1,0.680344,0.765714,0,"#00d3ff"
15420213,msoriaro,30,0,2,2,0.592916,0.599916,0.000486,"#ff77ff"
15422393,ancara,36,0,1,1,0.469519,0.289034,0,"#825403"
15424281,xaviercima,49,1,0,1,0.405706,0.646533,0,"#ff7007"
15432179,raulpacheco,4,3,9,12,0.58784,0.360052,0.00535,"#f4c8cf"
15441987,mariecestmoi,13,1,0,1,0.456127,0.397127,0,"#3bec00"
15442630,elcorreo_com,15,1,0,1,0.619875,0.683937,0,"#008ebb"
15449070,brettbobley,30,7,1,8,0.474889,0.510439,0.003405,"#ff77ff"
15460048,MIT,8,11,0,11,0.579843,0.436245,0.004864,"#00ed5d"
15468302,danidominguez,22,5,0,5,0.651396,0.53594,0.001946,"#00e8b2"
15468474,UNED,30,249,11,260,0.521191,0.564723,0.125973,"#ff77ff"
15475282,gregniemeyer,14,5,4,9,0.54661,0.508091,0.003891,"#00eeff"
15480206,CathyNDavidson,0,1,0,1,0.522533,0.403709,0,"#8ecfec"
15513055,FlyT,13,0,3,3,0.488053,0.444877,0.000973,"#3bec00"
15516583,yrochat,1,3,0,3,0.461832,0.466415,0.000973,"#b6cb00"
15518914,franciscox,49,1,0,1,0.392343,0.639957,0,"#ff7007"
15521401,DonRudi,49,0,2,2,0.421172,0.553926,0.000486,"#ff7007"
15529585,pacorevuelta,31,0,2,2,0.608697,0.489744,0.000486,"#3e93ff"
15546712,espinozo,21,0,2,2,0.254984,0.21638,0.000486,"#c6cc85"
15573186,comunidadUPN,38,1,1,2,0.636521,0.383047,0.000486,"#662859"
15577394,anneclinio,49,3,0,3,0.472943,0.457934,0.000973,"#ff7007"
15579368,qazcona,14,0,2,2,0.642833,0.448264,0.000486,"#00eeff"
15581283,heraldoes,14,4,1,5,0.371558,0.581407,0.001946,"#00eeff"
15585350,univmiami,55,3,0,3,0.526808,0.570928,0.000973,"#cb3f32"
15593588,WikiCFP,36,2,0,2,0.556483,0.428934,0.000486,"#825403"
15602614,ColoresMari,38,1,0,1,0.54817,0.378461,0,"#662859"
15614824,amycsc,34,0,1,1,0.327169,0.428296,0,"#ff0d69"
15635191,FILGuadalajara,0,16,0,16,0.452662,0.491932,0.007296,"#8ecfec"
15637375,UTAustin,13,8,0,8,0.466867,0.503915,0.003405,"#3bec00"
15639057,cotecumplido,21,0,2,2,0.358335,0.377332,0.000486,"#c6cc85"
15655137,gwijthoff,34,31,0,31,0.480527,0.45903,0.014591,"#ff0d69"
15661113,marionlame,36,2,2,4,0.588981,0.45698,0.001459,"#825403"
15670515,Windows,13,2,0,2,0.524317,0.432989,0.000486,"#3bec00"
15673245,ArtiumVitoria,14,0,2,2,0.650713,0.682102,0.000486,"#00eeff"
15695712,JoseCarlosTecno,38,6,0,6,0.629623,0.384244,0.002432,"#662859"
15714104,marianarra_,13,0,3,3,0.454364,0.476216,0.000973,"#3bec00"
15724618,KMH_nowinVA,30,0,2,2,0.533971,0.589167,0.000486,"#ff77ff"
15725794,planetanews,34,3,1,4,0.502248,0.441547,0.001459,"#ff0d69"
15728446,sugus_182,37,0,1,1,0.703663,0.590991,0,"#006032"
15748437,obrero,19,1,0,1,0.624633,0.798143,0,"#00d3ff"
15762276,scott_bot,34,38,17,55,0.483505,0.472969,0.026265,"#ff0d69"
15764544,istolgasound,38,0,1,1,0.801214,0.636246,0,"#662859"
15777344,ivanvladimir,13,1,5,6,0.484696,0.440055,0.002432,"#3bec00"
15808647,techreview,15,2,0,2,0.478836,0.563356,0.000486,"#008ebb"
15809911,el_poli_pueta,37,0,2,2,0.457367,0.3702,0.000486,"#006032"
15811951,jmessias,36,0,2,2,0.48945,0.252655,0.000486,"#825403"
15817447,femme_magenta,38,0,1,1,0.675542,0.349544,0,"#662859"
15837147,sigridth,31,0,4,4,0.573743,0.512082,0.001459,"#3e93ff"
15840886,amateurdancer,38,0,2,2,0.559948,0.469805,0.000486,"#662859"
15869696,Jonathangp,13,24,60,84,0.48715,0.461546,0.04037,"#3bec00"
15873953,Kongriov,22,0,1,1,0.385071,0.602616,0,"#00e8b2"
15881603,internautas,22,1,0,1,0.50203,0.672043,0,"#00e8b2"
15899435,anibalzorrilla,37,0,2,2,0.429198,0.670826,0.000486,"#006032"
15901999,fundacionTef,0,106,15,121,0.449836,0.53794,0.058366,"#8ecfec"
15915569,krenecito,0,0,1,1,0.365726,0.555589,0,"#8ecfec"
15923348,edramagor,7,0,1,1,0.39764,0.206012,0,"#ffb800"
15928537,jocilesferrer,30,0,1,1,0.170816,0.542499,0,"#ff77ff"
15929200,linagato,34,0,2,2,0.553102,0.354059,0.000486,"#ff0d69"
15934360,yuiso,49,1,0,1,0.304475,0.648957,0,"#ff7007"
15947173,unisalle,3,2,0,2,0.278024,0.608576,0.000486,"#ffb3ff"
15960595,palaeofuturist,22,1,0,1,0.515942,0.679405,0,"#00e8b2"
15981350,rkokayokay,36,0,2,2,0.541618,0.296936,0.000486,"#825403"
15988093,INEHRM,5,19,0,19,0.577933,0.365432,0.008755,"#b2dd44"
15993641,arey,22,8,6,14,0.607595,0.536117,0.006323,"#00e8b2"
15997828,vVvA,34,7,13,20,0.496407,0.449309,0.009241,"#ff0d69"
16009158,undars2,13,8,0,8,0.507976,0.467047,0.003405,"#3bec00"
16029366,muziejus,36,2,0,2,0.445731,0.403675,0.000486,"#825403"
16040246,josir,49,5,4,9,0.480692,0.465897,0.003891,"#ff7007"
16041373,rpastorvargas,30,0,5,5,0.562352,0.573185,0.001946,"#ff77ff"
16070146,dcasacuberta,14,9,4,13,0.627947,0.487106,0.005837,"#00eeff"
16085411,danielescandell,30,43,18,61,0.491712,0.529868,0.029183,"#ff77ff"
16126366,UOCuniversidad,14,5,5,10,0.558489,0.528727,0.004377,"#00eeff"
16129880,UofMaryland,37,3,0,3,0.456792,0.49663,0.000973,"#006032"
16132544,IthacaCollege,34,5,0,5,0.433137,0.429637,0.001946,"#ff0d69"
16132791,Esri,1,2,0,2,0.47756,0.65183,0.000486,"#b6cb00"
16138618,bibliofaunlp,49,1,0,1,0.383346,0.613266,0,"#ff7007"
16143105,OKFN,34,2,2,4,0.471357,0.430685,0.001459,"#ff0d69"
16147032,clarabermudez,22,0,1,1,0.365921,0.205107,0,"#00e8b2"
16149989,trevormunoz,34,16,5,21,0.410576,0.454732,0.009728,"#ff0d69"
16158117,C18AH,36,0,2,2,0.469751,0.369865,0.000486,"#825403"
16161060,pgala,49,1,0,1,0.369033,0.646866,0,"#ff7007"
16212403,ivanabentes,36,2,1,3,0.614149,0.383753,0.000973,"#825403"
16212914,NataliaMazotte,36,0,1,1,0.77102,0.611705,0,"#825403"
16221156,QueremosNacer,49,0,3,3,0.431837,0.565387,0.000973,"#ff7007"
16240799,jaheppler,14,3,0,3,0.533768,0.540723,0.000973,"#00eeff"
16248551,RominaGironP,13,0,4,4,0.450526,0.415975,0.001459,"#3bec00"
16255019,cibervoluntario,15,1,1,2,0.665924,0.430717,0.000486,"#008ebb"
16263018,lynnemthomas,34,0,1,1,0.341039,0.428363,0,"#ff0d69"
16267722,hcayless,49,1,3,4,0.391646,0.506333,0.001459,"#ff7007"
16272776,laurenbgood,34,0,2,2,0.380773,0.42149,0.000486,"#ff0d69"
16279554,rhemalinder,36,0,5,5,0.459297,0.506207,0.001946,"#825403"
16282089,tejaKrasek,13,0,1,1,0.584527,0.404541,0,"#3bec00"
16286962,stargould,30,0,3,3,0.47832,0.551632,0.000973,"#ff77ff"
16287595,leoba,36,0,6,6,0.437475,0.431065,0.002432,"#825403"
16296612,Vanfunfun,14,0,2,2,0.569416,0.510537,0.000486,"#00eeff"
16309512,Rebolico,36,0,2,2,0.574736,0.435472,0.000486,"#825403"
16325035,anitaconchita,34,0,3,3,0.377247,0.426674,0.000973,"#ff0d69"
16330469,citfic,14,0,1,1,0.447813,0.499685,0,"#00eeff"
16337414,jujox,30,11,6,17,0.480804,0.54562,0.007782,"#ff77ff"
16392202,Educacion2020,31,1,0,1,0.558967,0.250386,0,"#3e93ff"
16422908,leormoz,38,0,6,6,0.543527,0.483156,0.002432,"#662859"
16438655,EmoryUniversity,10,1,0,1,0.292384,0.53501,0,"#52d7c0"
16474279,kallewesterling,34,0,2,2,0.458277,0.386543,0.000486,"#ff0d69"
16492235,amzoss,36,0,1,1,0.379264,0.478838,0,"#825403"
16509913,AdrianSantuario,6,6,0,6,0.365622,0.691714,0.002432,"#a67800"
16511311,fluipe,37,0,5,5,0.523684,0.309518,0.001946,"#006032"
16518702,olicas,0,0,1,1,0.377606,0.544199,0,"#8ecfec"
16530643,albertsierra_re,22,1,3,4,0.514039,0.594682,0.001459,"#00e8b2"
16556575,ferbautista,49,0,2,2,0.414082,0.525393,0.000486,"#ff7007"
16569045,PCMagalhaes,36,3,0,3,0.527146,0.375933,0.000973,"#825403"
16571064,epriani,13,318,274,592,0.497178,0.468776,0.287451,"#3bec00"
16576356,museodelprado,30,10,0,10,0.414329,0.521018,0.004377,"#ff77ff"
16579721,elpce,19,3,0,3,0.629679,0.694854,0.000973,"#00d3ff"
16589494,Panschop,21,0,1,1,0.203964,0.242241,0,"#c6cc85"
16590605,pedro_jordano,30,4,1,5,0.554106,0.546247,0.001946,"#ff77ff"
16609980,gaviot,49,1,0,1,0.385348,0.578465,0,"#ff7007"
16616217,TimHitchcock,34,0,9,9,0.497361,0.45206,0.003891,"#ff0d69"
16627003,jordi_a,14,4,2,6,0.477072,0.494156,0.002432,"#00eeff"
16656420,sarahsimpkin,34,40,0,40,0.47885,0.45924,0.018969,"#ff0d69"
16673390,tfeliz,30,0,6,6,0.496118,0.568578,0.002432,"#ff77ff"
16676396,El_Universal_Mx,17,54,1,55,0.787539,0.276567,0.026265,"#ff9cc7"
16694896,ricardfaura,14,0,2,2,0.617332,0.584078,0.000486,"#00eeff"
16698907,Goah,49,1,0,1,0.343941,0.652697,0,"#ff7007"
16708593,fendt,13,5,0,5,0.485738,0.479031,0.001946,"#3bec00"
16738082,Emirodgar,49,1,0,1,0.356128,0.620813,0,"#ff7007"
16754312,kristamccracken,13,0,1,1,0.342765,0.438458,0,"#3bec00"
16784012,rguareschi,3,15,9,24,0.470697,0.58697,0.011187,"#ffb3ff"
16797246,madelagon,55,0,2,2,0.641719,0.651852,0.000486,"#cb3f32"
16808626,bbva,14,15,1,16,0.561848,0.530636,0.007296,"#00eeff"
16825188,IEuniversity,37,2,0,2,0.42484,0.558982,0.000486,"#006032"
16841386,praymurray,49,2,0,2,0.392823,0.422922,0.000486,"#ff7007"
16866476,jmospina,3,0,2,2,0.4833,0.66943,0.000486,"#ffb3ff"
16875010,AgusPiedrabuena,8,1,0,1,0.701499,0.256059,0,"#00ed5d"
16876237,netasceta,49,0,2,2,0.427772,0.521817,0.000486,"#ff7007"
16891963,icorreassosa,2,0,2,2,0.655809,0.721678,0.000486,"#ffa64e"
16897352,rogueclassicist,19,1,1,2,0.585002,0.644038,0.000486,"#00d3ff"
16909665,borjaramon,36,0,1,1,0.611594,0.245928,0,"#825403"
16918470,SILEM,14,1,0,1,0.577695,0.509497,0,"#00eeff"
16959531,MaluOliveira,0,0,1,1,0.42701,0.393386,0,"#8ecfec"
16962763,easl294,49,1,0,1,0.355707,0.657563,0,"#ff7007"
16997143,alefalletti,49,0,2,2,0.38726,0.423611,0.000486,"#ff7007"
16998308,comunicarte,14,0,1,1,0.671037,0.491287,0,"#00eeff"
17002127,Siedrix,13,0,1,1,0.461756,0.391942,0,"#3bec00"
17008347,orientweet,37,1,0,1,0.621106,0.341847,0,"#006032"
17008781,Cindy_Conaway,34,0,1,1,0.34212,0.403037,0,"#ff0d69"
17010312,macalara,3,1,1,2,0.465528,0.635828,0.000486,"#ffb3ff"
17012188,s3jones,34,1,0,1,0.329521,0.402592,0,"#ff0d69"
17014891,arqueodigital,37,1,0,1,0.641673,0.343674,0,"#006032"
17025362,cristobalcobo,8,23,2,25,0.430427,0.520829,0.011673,"#00ed5d"
17025735,txescu,22,1,36,37,0.52796,0.564296,0.01751,"#00e8b2"
17030865,BenFranklinMX,7,0,1,1,0.404547,0.356901,0,"#ffb800"
17046947,isain,49,1,0,1,0.341109,0.627136,0,"#ff7007"
17067609,ReneAguiluz,34,0,2,2,0.521578,0.338594,0.000486,"#ff0d69"
17083111,rafa_sluagh,30,0,2,2,0.554891,0.538936,0.000486,"#ff77ff"
17087024,RobertSzymczak,58,0,1,1,0.482066,0.658574,0,"#005076"
17089319,apisanty,13,3,0,3,0.490084,0.391333,0.000973,"#3bec00"
17106158,Piamonte,30,0,4,4,0.587084,0.52201,0.001459,"#ff77ff"
17124028,ftapia,22,0,1,1,0.594751,0.625347,0,"#00e8b2"
17129020,panino5001,49,0,1,1,0.374467,0.528814,0,"#ff7007"
17129253,scorullon,30,0,2,2,0.31302,0.486555,0.000486,"#ff77ff"
17152842,unav,1,89,0,89,0.600094,0.479227,0.042802,"#b6cb00"
17153306,ana_adi,30,7,0,7,0.784371,0.642462,0.002918,"#ff77ff"
17154248,jaimecores,0,0,1,1,0.830604,0.438624,0,"#8ecfec"
17158016,vlahebo,38,0,4,4,0.540522,0.495827,0.001459,"#662859"
17159147,UTiSchool,34,3,0,3,0.429857,0.459123,0.000973,"#ff0d69"
17166309,Lobointhedesert,5,0,1,1,0.639834,0.296535,0,"#b2dd44"
17166773,tuitdeliz,34,0,1,1,0.556591,0.340001,0,"#ff0d69"
17168087,jguallar,22,13,11,24,0.558067,0.547155,0.011187,"#00e8b2"
17168291,RobertoCastillo,21,0,2,2,0.21639,0.331101,0.000486,"#c6cc85"
17177403,plevy,9,13,6,19,0.608086,0.461015,0.008755,"#008f7b"
17185732,sredondoi,14,0,3,3,0.564511,0.626674,0.000973,"#00eeff"
17199281,hurukuta,31,1,3,4,0.534837,0.471512,0.001459,"#3e93ff"
17207483,EnglishNerd,13,0,2,2,0.52797,0.439767,0.000486,"#3bec00"
17214331,gaceta_es,22,3,0,3,0.518704,0.596599,0.000973,"#00e8b2"
17217370,IreneTorres,13,1,0,1,0.347929,0.52283,0,"#3bec00"
17230018,Spotify,49,1,0,1,0.345503,0.551136,0,"#ff7007"
17231726,NaTransversal,36,0,11,11,0.505955,0.36737,0.004864,"#825403"
17233135,FDescubre,1,3,0,3,0.432348,0.63494,0.000973,"#b6cb00"
17234108,rodriguezamorin,37,1,2,3,0.530121,0.633559,0.000973,"#006032"
17247774,jesuslau,49,0,4,4,0.445878,0.540889,0.001459,"#ff7007"
17257544,valenzine,22,1,1,2,0.361855,0.527849,0.000486,"#00e8b2"
17261562,pollyanaferrari,36,1,0,1,0.422625,0.216646,0,"#825403"
17278005,CarlosSanzDiaz,30,4,0,4,0.544971,0.595627,0.001459,"#ff77ff"
17283343,FernanSQL,49,1,0,1,0.401375,0.627908,0,"#ff7007"
17286082,emartinmonje,30,0,3,3,0.511208,0.598073,0.000973,"#ff77ff"
17292986,FBN,36,2,0,2,0.478601,0.351391,0.000486,"#825403"
17293859,pacobac,45,0,1,1,0.675509,0.192788,0,"#00e8ff"
17300374,amcollier,36,2,0,2,0.440323,0.405884,0.000486,"#825403"
17315836,archivesnext,7,1,2,3,0.44115,0.413032,0.000973,"#ffb800"
17330960,radiotica,49,1,0,1,0.387543,0.63804,0,"#ff7007"
17339327,ginocingolani,49,1,1,2,0.462606,0.591486,0.000486,"#ff7007"
17343953,NormaDra,0,0,2,2,0.610588,0.539603,0.000486,"#8ecfec"
17373305,kix2902,14,0,1,1,0.578836,0.577061,0,"#00eeff"
17424057,pppedritus,49,1,0,1,0.334831,0.663857,0,"#ff7007"
17440110,biblioteca_uc3m,31,19,10,29,0.548057,0.600919,0.013619,"#3e93ff"
17441030,Dan_Abadie,49,1,0,1,0.339248,0.645806,0,"#ff7007"
17443500,ivoox,22,1,0,1,0.559893,0.635821,0,"#00e8b2"
17462723,creativecommons,13,3,0,3,0.536246,0.522052,0.000973,"#3bec00"
17465506,PesquisaFapesp,36,4,0,4,0.682398,0.53105,0.001459,"#825403"
17471538,redHD,13,10,0,10,0.531131,0.460625,0.004377,"#3bec00"
17471979,NatGeo,1,1,0,1,0.497305,0.785676,0,"#b6cb00"
17483805,Davidpati,1,0,3,3,0.470905,0.566739,0.000973,"#b6cb00"
17487971,adriankohan,37,0,1,1,0.22229,0.428241,0,"#006032"
17488277,sergioibanez,8,0,1,1,0.284799,0.268818,0,"#00ed5d"
17490510,juandoming,3,3,9,12,0.540488,0.555167,0.00535,"#ffb3ff"
17500500,Yourmung,38,0,2,2,0.585327,0.443323,0.000486,"#662859"
17508247,alafuente,22,65,51,116,0.582185,0.519786,0.055934,"#00e8b2"
17511685,docum3nt,49,0,1,1,0.341519,0.467808,0,"#ff7007"
17525491,entretic,58,2,6,8,0.545843,0.552326,0.003405,"#005076"
17534607,richardrogers,10,17,2,19,0.428925,0.525297,0.008755,"#52d7c0"
17538765,PerezLatre,1,0,4,4,0.630536,0.536848,0.001459,"#b6cb00"
17540667,janaremy,30,0,1,1,0.513766,0.634946,0,"#ff77ff"
17544803,nypl,34,1,0,1,0.33244,0.418996,0,"#ff0d69"
17548465,CuyoNoticias,36,0,2,2,0.77495,0.61899,0.000486,"#825403"
17563531,mdrechsler,9,1,3,4,0.558045,0.519533,0.001459,"#008f7b"
17566134,ada_lso,4,0,1,1,0.851845,0.252125,0,"#f4c8cf"
17572957,MauricioJaramil,38,5,37,42,0.605171,0.498384,0.019942,"#662859"
17584736,manuelbaquedano,49,1,0,1,0.321927,0.622008,0,"#ff7007"
17589454,ehcg,11,0,5,5,0.487281,0.086995,0.001946,"#3a8724"
17597133,Prigon,49,1,0,1,0.380908,0.516798,0,"#ff7007"
17599814,gloriamoya,31,0,1,1,0.555625,0.256269,0,"#3e93ff"
17603106,quiquesr,0,5,1,6,0.844622,0.420361,0.002432,"#8ecfec"
17618056,pparagon,16,0,2,2,0.944834,0.682659,0.000486,"#c42c63"
17623016,leifuss,49,8,0,8,0.474909,0.501749,0.003405,"#ff7007"
17631406,DialogoUPR,23,4,1,5,0.203264,0.502975,0.001946,"#005455"
17643079,Marce_Vargas88,35,2,1,3,0.372005,0.474305,0.000973,"#00faff"
17651925,NuFdzTor,30,5,8,13,0.488437,0.529331,0.005837,"#ff77ff"
17653849,lettertoaugusta,48,0,1,1,0.21752,0.704557,0,"#ff7a78"
17670914,pablolinares,30,0,1,1,0.558321,0.448821,0,"#ff77ff"
17688219,andresgattinoni,34,1,5,6,0.495057,0.443055,0.002432,"#ff0d69"
17688537,uah,37,1,0,1,0.62968,0.345897,0,"#006032"
17714656,tgacebo,1,0,2,2,0.653659,0.443654,0.000486,"#b6cb00"
17716598,EducaThyssen,31,1,0,1,0.643633,0.488294,0,"#3e93ff"
17722542,jmcest,36,0,1,1,0.613996,0.445314,0,"#825403"
17751281,aburbano,34,2,3,5,0.551929,0.431849,0.001946,"#ff0d69"
17752454,esdi,8,5,0,5,0.684709,0.268802,0.001946,"#00ed5d"
17772404,medialabMM,30,0,3,3,0.555633,0.587615,0.000973,"#ff77ff"
17776642,fabiana_salerno,49,0,2,2,0.443858,0.602092,0.000486,"#ff7007"
17777882,urjc,15,10,0,10,0.544951,0.494716,0.004377,"#008ebb"
17777943,rebamex,49,1,0,1,0.387541,0.52089,0,"#ff7007"
17784426,misspicuaza,7,0,1,1,0.818154,0.56119,0,"#ffb800"
17812687,willameee,36,2,0,2,0.496003,0.350401,0.000486,"#825403"
17814938,Storify,12,3,0,3,0.784226,0.678607,0.000973,"#00a04a"
17817374,veralaporta,49,1,0,1,0.405665,0.640319,0,"#ff7007"
17838941,fboteroj,34,1,0,1,0.539806,0.383706,0,"#ff0d69"
17846352,estudosdemidia,36,6,0,6,0.518124,0.361416,0.002432,"#825403"
17872758,unican,22,19,3,22,0.550294,0.592822,0.010214,"#00e8b2"
17874544,TwitterSupport,49,1,0,1,0.423519,0.73403,0,"#ff7007"
17925320,openstreetmap,55,1,0,1,0.611618,0.565446,0,"#cb3f32"
17926269,CarlosGonzalesG,3,0,1,1,0.586601,0.719036,0,"#ffb3ff"
17929987,tropicalia115,13,1,0,1,0.576498,0.433576,0,"#3bec00"
17932010,espiritucalato,17,0,1,1,0.82908,0.244962,0,"#ff9cc7"
17933741,Clionautica,14,0,2,2,0.540098,0.510703,0.000486,"#00eeff"
17973773,Markotom,13,12,10,22,0.457217,0.489457,0.010214,"#3bec00"
17974411,PepeMe,8,2,0,2,0.57831,0.383534,0.000486,"#00ed5d"
17993899,SamHoustonState,34,1,0,1,0.321632,0.411074,0,"#ff0d69"
18004144,London_Lady,49,0,1,1,0.323928,0.691216,0,"#ff7007"
18020949,eventosutpl,30,0,1,1,0.610713,0.483309,0,"#ff77ff"
18036441,Stanford,1,5,0,5,0.538709,0.562401,0.001946,"#b6cb00"
18045145,mkdirecto,1,1,0,1,0.500736,0.787714,0,"#b6cb00"
18047541,0TRANADA,14,0,4,4,0.634894,0.552343,0.001459,"#00eeff"
18059285,ernestopriego,13,128,46,174,0.489753,0.449628,0.084144,"#3bec00"
18064963,miguelariza,38,0,1,1,0.530642,0.316993,0,"#662859"
18065266,mcgillu,13,3,0,3,0.505022,0.493388,0.000973,"#3bec00"
18068444,ainaradego,30,0,1,1,0.620314,0.659536,0,"#ff77ff"
18080969,TEDx,34,1,0,1,0.40953,0.445876,0,"#ff0d69"
18093292,underwatermaya,13,0,1,1,0.38148,0.498213,0,"#3bec00"
18097796,mavmedel,30,1,0,1,0.473108,0.618564,0,"#ff77ff"
18102873,futuroslibro,14,42,5,47,0.602348,0.509578,0.022374,"#00eeff"
18116148,denobisipsis,22,3,5,8,0.484301,0.641255,0.003405,"#00e8b2"
18129652,wragge,34,0,5,5,0.459543,0.455414,0.001946,"#ff0d69"
18139026,galecengage,13,7,0,7,0.466688,0.39815,0.002918,"#3bec00"
18139672,tebot,0,0,1,1,0.427286,0.38518,0,"#8ecfec"
18151042,josegarrido,21,0,1,1,0.200156,0.222456,0,"#c6cc85"
18151918,liliasaul,13,1,2,3,0.439487,0.314417,0.000973,"#3bec00"
18156854,arroyito,17,0,1,1,0.915896,0.367099,0,"#ff9cc7"
18166005,laurarosillo,8,0,1,1,0.260619,0.251016,0,"#00ed5d"
18197477,sbonet,0,0,2,2,0.257146,0.70456,0.000486,"#8ecfec"
18200400,xataka,22,5,0,5,0.491552,0.642526,0.001946,"#00e8b2"
18214541,ProQuest,31,3,0,3,0.620539,0.485121,0.000973,"#3e93ff"
18220017,Supranauta,31,0,3,3,0.619494,0.491426,0.000973,"#3e93ff"
18242628,kyrey,13,8,4,12,0.458455,0.384112,0.00535,"#3bec00"
18245049,thaispereira,36,2,3,5,0.46448,0.301058,0.001946,"#825403"
18306444,machtHBR,8,1,0,1,0.697254,0.250412,0,"#00ed5d"
18330892,IvanHerCaz,30,2,15,17,0.487586,0.543802,0.007782,"#ff77ff"
18334557,arthurocrates,13,0,6,6,0.433207,0.42914,0.002432,"#3bec00"
18342865,tonapou,14,2,5,7,0.543706,0.656107,0.002918,"#00eeff"
18348646,santirg_87,49,1,0,1,0.38697,0.660649,0,"#ff7007"
18358699,cscolari,3,30,10,40,0.507881,0.58074,0.018969,"#ffb3ff"
18359333,paulorfreitas,49,0,2,2,0.528955,0.433422,0.000486,"#ff7007"
18364008,lorenaflag,13,0,1,1,0.424886,0.409027,0,"#3bec00"
18368910,fgallardo,49,1,0,1,0.373856,0.690039,0,"#ff7007"
18373946,fleming77,34,0,2,2,0.475657,0.407505,0.000486,"#ff0d69"
18379914,Pharsiffal,14,0,5,5,0.483868,0.49214,0.001946,"#00eeff"
18384016,agenciaorbita,49,1,0,1,0.351096,0.627335,0,"#ff7007"
18392761,madvivacious,13,1,0,1,0.391692,0.409283,0,"#3bec00"
18397625,wilkinspeter,13,0,1,1,0.479772,0.372559,0,"#3bec00"
18400034,gazambuja,49,1,0,1,0.386101,0.632692,0,"#ff7007"
18447918,mosabou,34,1,0,1,0.41258,0.439837,0,"#ff0d69"
18453134,aitorgrandes,2,0,2,2,0.636155,0.65889,0.000486,"#ffa64e"
18466289,beatrizemar,37,1,0,1,0.449238,0.349968,0,"#006032"
18510558,el_BID,31,20,0,20,0.737058,0.8816,0.009241,"#3e93ff"
18512377,ealmirall,8,5,0,5,0.661878,0.329695,0.001946,"#00ed5d"
18513495,rama_miguel,0,0,1,1,0.657764,0.633091,0,"#8ecfec"
18539194,marcelamomberg,14,1,6,7,0.489434,0.572444,0.002918,"#00eeff"
18546898,lizlosh,50,1,0,1,0.5946,0.253723,0,"#ff76c3"
18550980,aitorcalero,1,0,2,2,0.691009,0.469454,0.000486,"#b6cb00"
18554241,chrismurillomx,13,0,1,1,0.41962,0.380598,0,"#3bec00"
18588154,indierod,38,2,4,6,0.441082,0.274268,0.002432,"#662859"
18616891,LeonardDini,19,0,1,1,0.713204,0.661936,0,"#00d3ff"
18617095,julia_flanders,34,7,0,7,0.424527,0.447032,0.002918,"#ff0d69"
18631980,jhcordeiro,36,0,2,2,0.193356,0.62416,0.000486,"#825403"
18688121,wmmna,36,0,2,2,0.822095,0.287331,0.000486,"#825403"
18688573,MatiasVlahusic,49,0,2,2,0.476596,0.543183,0.000486,"#ff7007"
18690355,Milhaud,14,2,0,2,0.563029,0.649662,0.000486,"#00eeff"
18730942,luisinclan,7,0,1,1,0.392963,0.359385,0,"#ffb800"
18746993,AgenteTruffaut,7,1,0,1,0.192695,0.390995,0,"#ffb800"
18797492,lluisrecoder,8,1,0,1,0.667486,0.243577,0,"#00ed5d"
18802804,eugeca,49,0,1,1,0.250413,0.6766,0,"#ff7007"
18812168,alejandragm,55,0,1,1,0.665052,0.555992,0,"#cb3f32"
18815747,schopfel,13,0,1,1,0.480239,0.363131,0,"#3bec00"
18828843,pedrosaliba,36,1,3,4,0.485061,0.38154,0.001459,"#825403"
18896364,TrinkerMedia,4,1,2,3,0.477286,0.419424,0.000973,"#f4c8cf"
18903739,LivUni,38,1,0,1,0.373184,0.290729,0,"#662859"
18908676,MirrorFinish,49,1,0,1,0.341661,0.657559,0,"#ff7007"
18935802,repubblica,15,1,0,1,0.643786,0.712248,0,"#008ebb"
18938704,JamesRoy,0,0,1,1,0.521122,0.403216,0,"#8ecfec"
18956146,gaby_arguedas,30,1,0,1,0.739522,0.541605,0,"#ff77ff"
18957805,internetarchive,30,1,0,1,0.71969,0.646587,0,"#ff77ff"
18973052,josetoran,49,1,0,1,0.409867,0.681403,0,"#ff7007"
18979543,yvonnenobis,13,0,1,1,0.497315,0.367945,0,"#3bec00"
18979947,AlbaSanta,31,0,2,2,0.577676,0.516498,0.000486,"#3e93ff"
18981239,postgradoUPO,1,17,3,20,0.452914,0.531234,0.009241,"#b6cb00"
19000141,ProjectMUSE,37,6,2,8,0.507086,0.452902,0.003405,"#006032"
19002571,LauraBorras,15,33,19,52,0.570962,0.526564,0.024805,"#008ebb"
19024543,kyraneth,36,3,0,3,0.468241,0.345703,0.000973,"#825403"
19025138,Elimelech_Ring,49,1,0,1,0.41045,0.666921,0,"#ff7007"
19027994,estebanllorens,0,12,8,20,0.770059,0.455243,0.009241,"#8ecfec"
19029316,1iversoDiscreto,36,1,0,1,0.501832,0.251384,0,"#825403"
19032807,mjcalvimontes,38,0,1,1,0.651739,0.41541,0,"#662859"
19055255,racso_1982,38,0,2,2,0.575115,0.360042,0.000486,"#662859"
19105768,alarranz,2,0,2,2,0.639469,0.726183,0.000486,"#ffa64e"
19116339,angelalvarez,0,0,6,6,0.467205,0.566127,0.002432,"#8ecfec"
19129696,alezetab,56,0,1,1,0.386129,0.090932,0,"#384205"
19132700,igallupd,13,0,1,1,0.348817,0.444593,0,"#3bec00"
19136693,micahvandegrift,0,1,0,1,0.543531,0.405561,0,"#8ecfec"
19143849,raivenra,55,0,3,3,0.585895,0.490903,0.000973,"#cb3f32"
19164943,Alejandral,49,2,0,2,0.405031,0.624488,0.000486,"#ff7007"
19170951,delyhtor,22,0,1,1,0.602184,0.62709,0,"#00e8b2"
19180122,GuillemRecolons,14,2,0,2,0.682595,0.492172,0.000486,"#00eeff"
19193598,ullyot,49,7,2,9,0.457206,0.537682,0.003891,"#ff7007"
19224803,barrogante,55,2,0,2,0.706432,0.517346,0.000486,"#cb3f32"
19236074,CaracolRadio,13,2,0,2,0.549057,0.412467,0.000486,"#3bec00"
19272796,RutgersU,14,1,0,1,0.594967,0.546684,0,"#00eeff"
19283039,juancarjc,30,0,1,1,0.412501,0.632247,0,"#ff77ff"
19285636,zooml,38,0,1,1,0.432851,0.760297,0,"#662859"
19320609,tebenas,36,0,2,2,0.570617,0.40441,0.000486,"#825403"
19324783,annamiracle,0,0,2,2,0.396462,0.559498,0.000486,"#8ecfec"
19332396,elancis,49,1,0,1,0.327187,0.645769,0,"#ff7007"
19349825,malerey_,49,2,0,2,0.427828,0.569922,0.000486,"#ff7007"
19350237,robsongfreire,36,2,3,5,0.712344,0.344629,0.001946,"#825403"
19374202,cenfoto_udp,49,2,3,5,0.408786,0.454436,0.001946,"#ff7007"
19389043,omenendez,22,1,0,1,0.527607,0.672342,0,"#00e8b2"
19392745,danielrruf,22,84,98,182,0.51124,0.587795,0.088035,"#00e8b2"
19408645,JoseCarlosBMota,22,1,0,1,0.667833,0.522351,0,"#00e8b2"
19467248,cgutierh,49,2,0,2,0.353193,0.492975,0.000486,"#ff7007"
19531716,fgouveia,49,3,2,5,0.497334,0.401878,0.001946,"#ff7007"
19537216,30dientes,38,38,26,64,0.511364,0.405292,0.030642,"#662859"
19550027,existdb,49,3,0,3,0.395439,0.508533,0.000973,"#ff7007"
19559024,AYALAMELGAREJO,38,0,5,5,0.210238,0.535879,0.001946,"#662859"
19602540,Peru21pe,31,1,0,1,0.633531,0.505369,0,"#3e93ff"
19607259,mtenaespinoza,13,7,11,18,0.490721,0.50098,0.008268,"#3bec00"
19622890,jmaquino,38,0,1,1,0.135716,0.799594,0,"#662859"
19637288,europeanhistory,19,1,0,1,0.609039,0.800147,0,"#00d3ff"
19648460,marcosuch,34,0,1,1,0.41991,0.47816,0,"#ff0d69"
19681801,marcusfernandez,55,1,0,1,0.632091,0.551834,0,"#cb3f32"
19705196,UCC,30,16,0,16,0.516618,0.470333,0.007296,"#ff77ff"
19706254,TimUnwin,49,1,12,13,0.514293,0.472183,0.005837,"#ff7007"
19712523,FCGulbenkian,36,4,0,4,0.536259,0.420519,0.001459,"#825403"
19717612,_PBo_,37,0,2,2,0.653043,0.288834,0.000486,"#006032"
19717756,Huhezi,18,12,7,19,0.670141,0.587191,0.008755,"#5456a6"
19726230,ucatolica,21,20,1,21,0.309301,0.28825,0.009728,"#c6cc85"
19737465,antoniosg6,58,0,2,2,0.629018,0.312382,0.000486,"#005076"
19770809,theklaneh,22,4,4,8,0.596571,0.85881,0.003405,"#00e8b2"
19773713,MetalHammer,13,1,0,1,0.472426,0.389383,0,"#3bec00"
19777678,Yllo,14,2,0,2,0.612624,0.562761,0.000486,"#00eeff"
19787371,lorenaeffe,31,0,2,2,0.6304,0.496175,0.000486,"#3e93ff"
19791890,amywells06,34,0,1,1,0.53394,0.391197,0,"#ff0d69"
19795808,Cat_Gat,22,0,1,1,0.533508,0.650675,0,"#00e8b2"
19809471,USC,2,2,0,2,0.496258,0.612403,0.000486,"#ffa64e"
19814678,lubar,7,0,2,2,0.437873,0.409341,0.000486,"#ffb800"
19817390,eprats,31,0,1,1,0.423786,0.629102,0,"#3e93ff"
19826509,openculture,1,2,0,2,0.498974,0.79083,0.000486,"#b6cb00"
19858626,edgarbarroso,13,0,1,1,0.40177,0.395823,0,"#3bec00"
19864285,museoreinasofia,30,1,0,1,0.479654,0.652039,0,"#ff77ff"
19869771,aprender,49,1,0,1,0.433404,0.612333,0,"#ff7007"
19878963,MDaviip,13,0,1,1,0.554285,0.394622,0,"#3bec00"
19883419,sitesmais,34,1,1,2,0.498603,0.380321,0.000486,"#ff0d69"
19890438,misaito,49,1,5,6,0.428907,0.440617,0.002432,"#ff7007"
19907166,nolauren,34,26,5,31,0.482959,0.472378,0.014591,"#ff0d69"
19919242,esenabre,22,10,0,10,0.595785,0.556646,0.004377,"#00e8b2"
19923515,abc_es,31,4,0,4,0.57374,0.555044,0.001459,"#3e93ff"
19969207,jzino,31,0,1,1,0.64003,0.508027,0,"#3e93ff"
20004210,TatianaMa,36,0,1,1,0.557715,0.30818,0,"#825403"
20006693,JhonRojas,38,0,1,1,0.792899,0.649171,0,"#662859"
20024751,zerojuls,3,0,5,5,0.471583,0.614234,0.001946,"#ffb3ff"
20030963,DigitalHumanity,22,1,0,1,0.481725,0.593018,0,"#00e8b2"
20034656,politonaiz,13,39,88,127,0.501462,0.496995,0.061284,"#3bec00"
20045580,fiocruz,36,7,2,9,0.549366,0.266755,0.003891,"#825403"
20058795,campuspartyco,38,4,0,4,0.601613,0.459066,0.001459,"#662859"
20067093,bluebeta,48,0,1,1,0.234032,0.723762,0,"#ff7a78"
20073175,karolbraun,36,0,1,1,0.378644,0.345977,0,"#825403"
20073834,paulacarina,36,1,4,5,0.52556,0.349305,0.001946,"#825403"
20080117,gajodeluz,13,0,21,21,0.491119,0.458384,0.009728,"#3bec00"
20156540,data__coso,13,0,4,4,0.53865,0.648128,0.001459,"#3bec00"
20172480,artepublico,34,17,7,24,0.418281,0.456685,0.011187,"#ff0d69"
20175733,fcampal,30,1,4,5,0.499677,0.544224,0.001946,"#ff77ff"
20188125,LatAmPeriodismo,36,0,2,2,0.765749,0.621284,0.000486,"#825403"
20190072,fesabid,49,3,4,7,0.494866,0.585077,0.002918,"#ff7007"
20197362,LatAmJornalismo,36,0,1,1,0.765962,0.614127,0,"#825403"
20198321,angelramon,49,1,0,1,0.350195,0.615587,0,"#ff7007"
20213004,timathom,13,2,10,12,0.468615,0.49254,0.00535,"#3bec00"
20227101,RGarciadelPoyo,22,1,1,2,0.644859,0.455899,0.000486,"#00e8b2"
20292293,LaClau,37,0,1,1,0.5228,0.380941,0,"#006032"
20298671,RickyPo,13,0,1,1,0.503264,0.365815,0,"#3bec00"
20328003,cosasvistas,13,0,2,2,0.528048,0.444649,0.000486,"#3bec00"
20381917,kathch,36,2,0,2,0.465493,0.335369,0.000486,"#825403"
20413264,_EIIa,0,0,2,2,0.436393,0.383473,0.000486,"#8ecfec"
20413749,alisonmr,34,0,2,2,0.356072,0.414646,0.000486,"#ff0d69"
20430497,webisblog,13,0,8,8,0.460067,0.505906,0.003405,"#3bec00"
20431901,mia_out,13,0,1,1,0.338972,0.437762,0,"#3bec00"
20445845,madrepora,30,1,1,2,0.510719,0.595635,0.000486,"#ff77ff"
20448792,DiarioSUR,14,5,3,8,0.60448,0.590849,0.003405,"#00eeff"
20449367,fabiomalini,36,6,3,9,0.487649,0.312723,0.003891,"#825403"
20486814,saraycg,31,0,3,3,0.577821,0.460894,0.000973,"#3e93ff"
20501310,incipy,49,1,0,1,0.358497,0.644393,0,"#ff7007"
20507551,alucchesi,36,11,0,11,0.503597,0.408819,0.004864,"#825403"
20509689,populares,16,36,0,36,0.918242,0.663369,0.017023,"#c42c63"
20521678,IAPHpatrimonio,14,16,3,19,0.561508,0.554224,0.008755,"#00eeff"
20529230,UHClearLake,34,2,0,2,0.385265,0.418299,0.000486,"#ff0d69"
20534938,JohnGMcNutt,34,0,2,2,0.394161,0.453742,0.000486,"#ff0d69"
20561324,bloodyarthur,36,1,0,1,0.508098,0.257173,0,"#825403"
20573532,kunstmacher_,38,0,1,1,0.128003,0.797129,0,"#662859"
20601500,WesternU,38,2,0,2,0.617885,0.452177,0.000486,"#662859"
20660144,UmeaUniversity,14,4,0,4,0.532373,0.47579,0.001459,"#00eeff"
20667709,jwerthein,36,0,2,2,0.08447,0.716161,0.000486,"#825403"
20674258,paulacpereira,36,5,0,5,0.494462,0.336871,0.001946,"#825403"
20701090,domaley,13,0,1,1,0.388438,0.437367,0,"#3bec00"
20702471,aetenae,21,0,1,1,0.19511,0.224996,0,"#c6cc85"
20723862,elmenjivar,3,1,0,1,0.622937,0.573733,0,"#ffb3ff"
20724267,DiggingIntoData,4,2,2,4,0.454608,0.436183,0.001459,"#f4c8cf"
20733366,costisd,30,0,4,4,0.462679,0.537485,0.001459,"#ff77ff"
20760565,kpeiro,8,1,0,1,0.686974,0.245313,0,"#00ed5d"
20774514,mitpress,36,1,5,6,0.463718,0.518294,0.002432,"#825403"
20785197,lisagoddard,36,4,0,4,0.464217,0.387933,0.001459,"#825403"
20838936,robertosaezm,49,1,0,1,0.346629,0.687961,0,"#ff7007"
20924285,sorenipsum,38,0,1,1,0.558168,0.413181,0,"#662859"
20927447,jjaramillo,49,1,0,1,0.369341,0.693925,0,"#ff7007"
20929566,nmolano,37,0,3,3,0.446217,0.327878,0.000973,"#006032"
20945781,NataliaBaquero,38,0,2,2,0.547283,0.608478,0.000486,"#662859"
20946362,nopaula,21,0,1,1,0.319958,0.440043,0,"#c6cc85"
20953990,maolibrarian,49,12,10,22,0.489744,0.559948,0.010214,"#ff7007"
20979797,UEuropea,14,2,0,2,0.658656,0.53095,0.000486,"#00eeff"
21000110,SussexUni,36,4,0,4,0.51846,0.395528,0.001459,"#825403"
21069219,viniciusmarquet,13,0,3,3,0.458885,0.434972,0.000973,"#3bec00"
21083017,alexandrematos,36,0,2,2,0.562876,0.326854,0.000486,"#825403"
21095041,charojph,20,0,1,1,0.393415,0.067798,0,"#f0be45"
21096079,UEvora,36,6,0,6,0.503239,0.434175,0.002432,"#825403"
21106209,iqvpress,49,1,0,1,0.374901,0.659717,0,"#ff7007"
21112632,eumiramc,13,1,0,1,0.391834,0.415817,0,"#3bec00"
21155258,fernandonaranjo,22,0,3,3,0.54589,0.61821,0.000973,"#00e8b2"
21174297,jicito,13,1,0,1,0.475777,0.29712,0,"#3bec00"
21189671,quasemarcio,36,0,1,1,0.561459,0.288976,0,"#825403"
21217118,UEuropeia,36,1,0,1,0.566786,0.423927,0,"#825403"
21246104,alfuente,22,2,0,2,0.573346,0.597462,0.000486,"#00e8b2"
21272101,amusser22,49,1,0,1,0.376214,0.523769,0,"#ff7007"
21296177,CCPE,49,1,0,1,0.401765,0.510257,0,"#ff7007"
21342934,Sayda_contreras,42,0,2,2,0.708763,0.429254,0.000486,"#66e087"
21353702,keithroughton,58,0,1,1,0.610939,0.177174,0,"#005076"
21355267,vjhermida,58,0,3,3,0.458188,0.61411,0.000973,"#005076"
21381934,medejean,38,10,11,21,0.51898,0.50036,0.009728,"#662859"
21416877,LatinSpots,49,1,0,1,0.317928,0.636597,0,"#ff7007"
21423768,mmdelc,10,0,2,2,0.404549,0.298872,0.000486,"#52d7c0"
21446117,gonetil,49,1,5,6,0.505022,0.464376,0.002432,"#ff7007"
21460089,elbauldj,49,1,0,1,0.361263,0.67594,0,"#ff7007"
21549704,cforeroo,38,1,0,1,0.444394,0.32806,0,"#662859"
21557232,arketipo,22,1,0,1,0.61357,0.643302,0,"#00e8b2"
21633561,mferres,8,0,6,6,0.624632,0.376604,0.002432,"#00ed5d"
21744554,britishlibrary,7,4,0,4,0.497786,0.436552,0.001459,"#ffb800"
21748374,joantp,14,0,1,1,0.302341,0.445476,0,"#00eeff"
21762800,mikecosgrave,49,1,8,9,0.488844,0.522268,0.003891,"#ff7007"
21764132,DianeJakacki,31,2,4,6,0.499522,0.506944,0.002432,"#3e93ff"
21769288,ignaciofernandz,49,1,0,1,0.377772,0.630278,0,"#ff7007"
21849152,PacoLopezH,31,0,2,2,0.586496,0.612779,0.000486,"#3e93ff"
21861435,ehonorio,34,2,3,5,0.548626,0.508339,0.001946,"#ff0d69"
21874416,superHH,34,10,6,16,0.445909,0.300726,0.007296,"#ff0d69"
21880973,xabuci,15,17,36,53,0.52318,0.574599,0.025292,"#008ebb"
21902947,enortee,36,0,2,2,0.484532,0.498959,0.000486,"#825403"
21921696,davidwacks,58,0,2,2,0.507463,0.594533,0.000486,"#005076"
21926182,ma_vargas_rubio,40,0,1,1,0.619451,0.02843,0,"#ff12a3"
21926369,jaimealejandro,13,2,22,24,0.539011,0.494574,0.011187,"#3bec00"
21989893,fcs_la,2,0,2,2,0.67331,0.661542,0.000486,"#ffa64e"
21995812,eugeniasiapera,14,1,2,3,0.545777,0.476337,0.000973,"#00eeff"
22028879,ferzun,38,1,0,1,0.683822,0.483046,0,"#662859"
22031185,vmkern,49,1,1,2,0.515195,0.393749,0.000486,"#ff7007"
22078875,pucp,49,10,0,10,0.476195,0.485953,0.004377,"#ff7007"
22111580,AlejandroServin,35,1,0,1,0.36069,0.505497,0,"#00faff"
22169444,Eleder_,37,0,1,1,0.604236,0.631057,0,"#006032"
22198190,jennytnichols,34,0,2,2,0.372166,0.407308,0.000486,"#ff0d69"
22226817,lizziparks,34,0,2,2,0.351277,0.425678,0.000486,"#ff0d69"
22262052,maryreyes76,38,0,1,1,0.335333,0.186575,0,"#662859"
22265710,luahtomas,48,0,1,1,0.210518,0.723771,0,"#ff7a78"
22283889,nestorandres,38,0,1,1,0.234043,0.577116,0,"#662859"
22284213,jmaculet,14,0,2,2,0.590474,0.515426,0.000486,"#00eeff"
22288099,unam,7,5,0,5,0.430518,0.447839,0.001946,"#ffb800"
22363271,Techtulia,0,0,2,2,0.569564,0.542969,0.000486,"#8ecfec"
22383241,donofrionist,3,0,2,2,0.464451,0.641369,0.000486,"#ffb3ff"
22411767,anonimah,38,0,3,3,0.582557,0.440588,0.000973,"#662859"
22460946,alejandrotello,7,0,1,1,0.343793,0.587681,0,"#ffb800"
22463885,DariusAryaDigs,22,3,0,3,0.643429,0.571267,0.000973,"#00e8b2"
22465414,LoboWerewolf,22,0,1,1,0.705395,0.471084,0,"#00e8b2"
22472124,gbstringer,4,0,1,1,0.503149,0.370385,0,"#f4c8cf"
22492391,Miciudadreal_es,1,1,0,1,0.326078,0.544653,0,"#b6cb00"
22509510,monikajung,30,0,1,1,0.305244,0.554234,0,"#ff77ff"
22538557,maggiehm,34,0,3,3,0.494588,0.423762,0.000973,"#ff0d69"
22554860,gabinfantemx,17,0,7,7,0.695517,0.234681,0.002918,"#ff9cc7"
22555984,Medievalists,22,1,0,1,0.607612,0.645616,0,"#00e8b2"
22574671,laultima,13,0,1,1,0.499594,0.401255,0,"#3bec00"
22585224,epiragauta,38,0,1,1,0.335707,0.173077,0,"#662859"
22602295,rockestatal,19,2,0,2,0.651671,0.750712,0.000486,"#00d3ff"
22609105,amarois,34,0,3,3,0.495067,0.414929,0.000973,"#ff0d69"
22641054,Crissalazarp,3,0,2,2,0.629345,0.725968,0.000486,"#ffb3ff"
22667306,ccalisalegria,37,1,2,3,0.548904,0.484507,0.000973,"#006032"
22677647,mwidner,34,0,2,2,0.363723,0.40067,0.000486,"#ff0d69"
22735257,lourdesresendiz,3,0,2,2,0.453763,0.623255,0.000486,"#ffb3ff"
22749856,Gephi,36,5,0,5,0.511844,0.422981,0.001946,"#825403"
22756377,MUnibertsitatea,18,25,15,40,0.697722,0.602695,0.018969,"#5456a6"
22767646,_ofge,13,0,1,1,0.397615,0.403594,0,"#3bec00"
22807612,sucaritos,36,0,2,2,0.511137,0.29601,0.000486,"#825403"
22809165,academia,19,59,0,59,0.544319,0.494063,0.02821,"#00d3ff"
22847403,karuvf,49,1,11,12,0.340521,0.535819,0.00535,"#ff7007"
22905117,inma_610,14,0,2,2,0.558292,0.442617,0.000486,"#00eeff"
22905278,foroalfa,22,1,0,1,0.53827,0.653832,0,"#00e8b2"
22919009,gpalacios,38,0,1,1,0.66148,0.416914,0,"#662859"
22940460,OpenEditionActu,34,2,3,5,0.497323,0.460023,0.001946,"#ff0d69"
22957133,joaoqueiroz,31,0,1,1,0.616727,0.462191,0,"#3e93ff"
22963112,MsPhelps,49,1,0,1,0.386739,0.524564,0,"#ff7007"
22967014,MITGameLab,34,6,0,6,0.579204,0.386806,0.002432,"#ff0d69"
22999086,mvov,7,0,1,1,0.395016,0.320732,0,"#ffb800"
23009730,Troskiller,38,4,0,4,0.478377,0.487507,0.001459,"#662859"
23061724,NoticiasNavarra,1,3,1,4,0.67557,0.447911,0.001459,"#b6cb00"
23117521,nabolom,7,4,4,8,0.461099,0.437975,0.003405,"#ffb800"
23128421,fredgibbs,34,25,0,25,0.503776,0.466254,0.011673,"#ff0d69"
23207063,brunodesouza,36,0,5,5,0.479068,0.43004,0.001946,"#825403"
23224159,Ibero909FM,13,0,1,1,0.43167,0.307803,0,"#3bec00"
23228590,ruizmateos,0,1,1,2,0.668055,0.624444,0.000486,"#8ecfec"
23248260,lupicinio,0,1,5,6,0.486386,0.414505,0.002432,"#8ecfec"
23265246,WalterScheidel,31,19,0,19,0.562421,0.495862,0.008755,"#3e93ff"
23301226,yvescarmeille,3,0,1,1,0.699507,0.648501,0,"#ffb3ff"
23316910,dcaraban,58,4,2,6,0.554722,0.555722,0.002432,"#005076"
23322761,macariomx,34,1,1,2,0.44591,0.346483,0.000486,"#ff0d69"
23426889,EdinburghUni,31,2,0,2,0.612423,0.600287,0.000486,"#3e93ff"
23447403,Middlebury,30,1,0,1,0.670456,0.600701,0,"#ff77ff"
23520740,evanmcdead,13,0,2,2,0.461775,0.395747,0.000486,"#3bec00"
23539848,paolabon,49,3,0,3,0.444219,0.579332,0.000973,"#ff7007"
23545920,adrianadesala,23,0,2,2,0.195255,0.500455,0.000486,"#005455"
23583338,jguerra18,1,0,1,1,0.498913,0.687664,0,"#b6cb00"
23597456,mellydollred,36,0,1,1,0.385353,0.477891,0,"#825403"
23617197,Javpa1_alien,30,0,4,4,0.405534,0.433198,0.001459,"#ff77ff"
23655477,N_Sobrevilla,38,1,0,1,0.551247,0.374218,0,"#662859"
23683605,pedrofrpereira,36,0,1,1,0.568005,0.387128,0,"#825403"
23728233,orientalhotel,49,0,1,1,0.398,0.417204,0,"#ff7007"
23743511,bordalejo,14,2,9,11,0.501514,0.510116,0.004864,"#00eeff"
23761309,ruyhliu,36,0,1,1,0.559008,0.317015,0,"#825403"
23792365,ComputerHistory,36,1,0,1,0.443999,0.324425,0,"#825403"
23838891,ArtesVisualesMC,38,0,1,1,0.616785,0.351681,0,"#662859"
23855116,vburgos,22,0,2,2,0.502653,0.522984,0.000486,"#00e8b2"
23865342,jerielizabeth,34,0,2,2,0.472021,0.424057,0.000486,"#ff0d69"
24048220,frankcifaldi,36,2,0,2,0.495282,0.321488,0.000486,"#825403"
24075855,roopikarisam,13,9,13,22,0.434237,0.457058,0.010214,"#3bec00"
24084721,igorsooares,36,0,1,1,0.470084,0.21913,0,"#825403"
24176576,aprestamo,34,0,4,4,0.439479,0.233477,0.001459,"#ff0d69"
24241923,usponline,36,2,0,2,0.550797,0.387348,0.000486,"#825403"
24257681,juanime,10,0,3,3,0.50292,0.618616,0.000973,"#52d7c0"
24265049,jcarlosmartin_,0,0,2,2,0.38734,0.5809,0.000486,"#8ecfec"
24277421,clausoltm,21,0,1,1,0.191533,0.248932,0,"#c6cc85"
24313692,brondi,14,0,1,1,0.634228,0.580035,0,"#00eeff"
24376343,lasillavacia,38,1,0,1,0.555636,0.371389,0,"#662859"
24384795,antorecio,34,0,2,2,0.448049,0.415193,0.000486,"#ff0d69"
24389472,jimccasey1,34,0,5,5,0.402975,0.452621,0.001946,"#ff0d69"
24468288,Darlyka,3,0,1,1,0.45415,0.75882,0,"#ffb3ff"
24502293,stouraitis,34,0,2,2,0.468185,0.405281,0.000486,"#ff0d69"
24539732,webnucleo,34,8,21,29,0.496853,0.432764,0.013619,"#ff0d69"
24582500,jvrodrigu3s,36,0,2,2,0.51497,0.341281,0.000486,"#825403"
24585797,Jthiele,22,3,0,3,0.564063,0.588515,0.000973,"#00e8b2"
24588537,CarlesCuerva,49,1,0,1,0.337838,0.598719,0,"#ff7007"
24603962,eagirre,34,0,4,4,0.484444,0.511621,0.001459,"#ff0d69"
24606773,aleguevara,4,0,1,1,0.866437,0.240149,0,"#f4c8cf"
24625697,maestroluis,13,0,4,4,0.454516,0.454108,0.001459,"#3bec00"
24646767,skarnio,36,2,0,2,0.393448,0.452535,0.000486,"#825403"
24698937,aojrgeo,36,0,3,3,0.489332,0.285917,0.000973,"#825403"
24771194,ColoradoCollege,34,2,0,2,0.411194,0.442534,0.000486,"#ff0d69"
24804844,brunonoronha,36,1,0,1,0.582031,0.395318,0,"#825403"
24873432,mjuanro,3,1,5,6,0.467506,0.613058,0.002432,"#ffb3ff"
24924727,epageperron,49,0,1,1,0.398725,0.417906,0,"#ff7007"
24925621,juliawants,36,0,9,9,0.445757,0.486699,0.003891,"#825403"
24929809,sergiosaldi,15,0,1,1,0.548814,0.724675,0,"#008ebb"
24930033,JertZee,13,0,1,1,0.489565,0.39105,0,"#3bec00"
24950746,nachazo,19,0,1,1,0.655217,0.769913,0,"#00d3ff"
24969337,Milenio,17,1,0,1,0.806626,0.193566,0,"#ff9cc7"
24982727,FranklinCordero,3,0,2,2,0.580836,0.565271,0.000486,"#ffb3ff"
24987119,senorcito,22,0,2,2,0.539367,0.324017,0.000486,"#00e8b2"
25010560,ufba,36,3,0,3,0.513379,0.33948,0.000973,"#825403"
25033260,RiqueSampaio,36,2,0,2,0.486685,0.319343,0.000486,"#825403"
25051454,jomirife,36,1,0,1,0.451941,0.33905,0,"#825403"
25066392,fabianscabuzzo,49,1,0,1,0.344161,0.688979,0,"#ff7007"
25107342,ThinkingHeads,49,1,0,1,0.295326,0.636002,0,"#ff7007"
25113723,JAHerguera,37,0,2,2,0.637301,0.574259,0.000486,"#006032"
25229015,valdecirsimao,36,1,0,1,0.4454,0.340129,0,"#825403"
25297234,KIKAOS,38,0,1,1,0.363979,0.246417,0,"#662859"
25305363,cuadratin_es,30,0,1,1,0.510741,0.627753,0,"#ff77ff"
25425404,MartinOre,49,1,0,1,0.394639,0.676756,0,"#ff7007"
25521930,LancasterUni,4,7,0,7,0.523394,0.477904,0.002918,"#f4c8cf"
25542214,sorais,37,0,1,1,0.314709,0.314371,0,"#006032"
25543248,PoeticsHeretic,30,0,1,1,0.568444,0.463837,0,"#ff77ff"
25548535,Cafehistoria,36,5,0,5,0.602335,0.383623,0.001946,"#825403"
25597820,edunisalle,3,2,3,5,0.397071,0.529965,0.001946,"#ffb3ff"
25603611,lusemacento,31,0,2,2,0.601027,0.547859,0.000486,"#3e93ff"
25627316,Z_Bosch,26,1,0,1,0.406315,0.104885,0,"#a7d4ff"
25680509,leticialves,49,0,1,1,0.434591,0.440958,0,"#ff7007"
25702344,luiy,13,4,13,17,0.509407,0.471475,0.007782,"#3bec00"
25710548,revista_EPI,22,15,3,18,0.55101,0.542016,0.008268,"#00e8b2"
25769092,emeziegler,42,1,6,7,0.626307,0.428099,0.002918,"#66e087"
25817888,thaiskisuki,36,0,1,1,0.491539,0.218119,0,"#825403"
25826270,francastillo,22,0,3,3,0.616061,0.554848,0.000973,"#00e8b2"
25832593,llmunro,13,3,3,6,0.454085,0.405471,0.002432,"#3bec00"
25833630,graciela71,36,0,1,1,0.541206,0.315296,0,"#825403"
25838001,UNR_Argentina,30,1,0,1,0.631183,0.605371,0,"#ff77ff"
25848964,lu_claudio,49,0,1,1,0.484854,0.356115,0,"#ff7007"
25901650,LilyTroia,13,0,3,3,0.424795,0.424608,0.000973,"#3bec00"
25977048,Patinunez,30,0,3,3,0.605342,0.583312,0.000973,"#ff77ff"
26017598,pixelvolley,34,0,3,3,0.37072,0.432001,0.000973,"#ff0d69"
26087033,Eckosbios,4,0,1,1,0.872696,0.248768,0,"#f4c8cf"
26089319,readingmadrid,49,6,0,6,0.414201,0.488284,0.002432,"#ff7007"
26124443,esteladomiha67,49,15,16,31,0.476903,0.558733,0.014591,"#ff7007"
26142590,claudiaun,49,1,0,1,0.400956,0.665428,0,"#ff7007"
26161340,valink,13,0,5,5,0.469947,0.452324,0.001946,"#3bec00"
26187589,uanl,7,2,0,2,0.433316,0.393224,0.000486,"#ffb800"
26254810,laufertuits,10,1,1,2,0.422217,0.576469,0.000486,"#52d7c0"
26273134,whotookmynick,49,1,0,1,0.376495,0.650458,0,"#ff7007"
26277867,manuelramirez,30,78,31,109,0.523933,0.563175,0.052529,"#ff77ff"
26308712,linhd,30,5,0,5,0.516421,0.529918,0.001946,"#ff77ff"
26315699,PacoLuisGRX,31,0,1,1,0.670031,0.536001,0,"#3e93ff"
26347355,favareja,8,0,1,1,0.344128,0.508855,0,"#00ed5d"
26494059,CCCBmediacio,22,0,2,2,0.552553,0.514757,0.000486,"#00e8b2"
26555061,jinesca,21,0,1,1,0.319754,0.44254,0,"#c6cc85"
26578291,chloe_vicente,49,0,1,1,0.409876,0.521968,0,"#ff7007"
26590999,nataliafrcr,38,2,1,3,0.595415,0.413934,0.000973,"#662859"
26623537,vitormussa,36,12,6,18,0.499519,0.389275,0.008268,"#825403"
26726848,patymurrieta,4,53,27,80,0.496846,0.452063,0.038424,"#f4c8cf"
26729931,rtve,8,6,0,6,0.650731,0.5075,0.002432,"#00ed5d"
26764481,CanadianRichard,34,0,2,2,0.451741,0.433468,0.000486,"#ff0d69"
26785044,upennlib,36,2,0,2,0.460756,0.347423,0.000486,"#825403"
26785429,gtvtavo,37,0,1,1,0.45942,0.284769,0,"#006032"
26836588,camilovedia,49,0,1,1,0.761943,0.822715,0,"#ff7007"
26892221,eracilada,48,0,1,1,0.229034,0.713828,0,"#ff7a78"
26929099,nadiaaguiar,36,1,2,3,0.46168,0.328245,0.000973,"#825403"
26968974,iureamicorum,53,0,3,3,0.549074,0.544526,0.000973,"#008bdd"
26969693,MarioJPC,22,0,1,1,0.391684,0.593333,0,"#00e8b2"
26970987,bibliovirtual,30,0,1,1,0.521723,0.664794,0,"#ff77ff"
26976229,imateriel,36,0,1,1,0.556504,0.360587,0,"#825403"
26987904,villares,36,1,2,3,0.50169,0.32357,0.000973,"#825403"
26988360,gabysued,3,262,27,289,0.471311,0.684645,0.140078,"#ffb3ff"
27001464,paolalorenzana,49,4,0,4,0.429685,0.632238,0.001459,"#ff7007"
27015304,avvelasquez,20,0,1,1,0.399446,0.074361,0,"#f0be45"
27015594,soni_sandeep,36,8,0,8,0.489125,0.386431,0.003405,"#825403"
27059638,el_lector,30,0,1,1,0.597208,0.671677,0,"#ff77ff"
27152529,alvaroramis,21,0,1,1,0.490916,0.956599,0,"#c6cc85"
27153426,wasonlyakiss,13,0,1,1,0.620021,0.987528,0,"#3bec00"
27199483,efsacco,34,0,2,2,0.371428,0.414039,0.000486,"#ff0d69"
27212267,emiliomh,31,0,2,2,0.617627,0.511608,0.000486,"#3e93ff"
27236126,amaralalexandro,30,0,2,2,0.555578,0.638225,0.000486,"#ff77ff"
27243992,uaemex,17,0,1,1,0.839793,0.233087,0,"#ff9cc7"
27249999,fernandoredondo,49,1,2,3,0.281209,0.639975,0.000973,"#ff7007"
27255323,corinakoolen,30,6,3,9,0.473386,0.528125,0.003891,"#ff77ff"
27278799,Ceci_0503,21,0,1,1,0.19887,0.211064,0,"#c6cc85"
27324793,danieloso,31,0,1,1,0.633096,0.518946,0,"#3e93ff"
27326447,maesperanzarojo,1,0,3,3,0.465931,0.604317,0.000973,"#b6cb00"
27352077,LondonAlumni,36,1,0,1,0.537711,0.354826,0,"#825403"
27366760,fernandolv,38,0,1,1,0.542525,0.389604,0,"#662859"
27475926,yoshuacas,38,1,0,1,0.687251,0.487017,0,"#662859"
27530178,Pocket,31,2,0,2,0.557643,0.485741,0.000486,"#3e93ff"
27582945,ColumbiaSpec,30,1,0,1,0.551855,0.589719,0,"#ff77ff"
27605738,ullsglaucs,14,0,1,1,0.678768,0.531931,0,"#00eeff"
27611466,repositorium,36,2,0,2,0.520533,0.37388,0.000486,"#825403"
27615696,pipwillcox,49,0,1,1,0.384162,0.534241,0,"#ff7007"
27633444,adr_ba,36,1,1,2,0.524221,0.341083,0.000486,"#825403"
27692165,JSTOR,36,2,0,2,0.494817,0.439819,0.000486,"#825403"
27705450,Giba01,30,0,1,1,0.586352,0.673243,0,"#ff77ff"
27724657,lenofortal,36,0,5,5,0.513982,0.393748,0.001946,"#825403"
27805363,lavivipineda,38,11,0,11,0.530448,0.376407,0.004864,"#662859"
27807595,utpl,20,15,0,15,0.416851,0.137782,0.006809,"#f0be45"
27838943,mpmorillo,30,0,10,10,0.521609,0.522606,0.004377,"#ff77ff"
27878846,AlexisMpul,30,0,3,3,0.558323,0.617325,0.000973,"#ff77ff"
27896022,LuisMilanesi,36,1,0,1,0.611009,0.191046,0,"#825403"
27914352,rutx,14,0,1,1,0.703761,0.469195,0,"#00eeff"
27919737,elcorreogallego,55,2,2,4,0.616101,0.544634,0.001459,"#cb3f32"
28096651,JCSura,49,1,0,1,0.401001,0.641709,0,"#ff7007"
28129090,MadSostenible,30,0,1,1,0.587476,0.664281,0,"#ff77ff"
28142136,rosavalle,37,0,1,1,0.459877,0.28868,0,"#006032"
28152475,hauntologist,34,0,3,3,0.375223,0.426549,0.000973,"#ff0d69"
28152663,SevillaActual,1,1,0,1,0.494046,0.795387,0,"#b6cb00"
28153252,LaPensativa99,3,0,1,1,0.504441,0.758833,0,"#ffb3ff"
28162462,villanelle_,49,0,4,4,0.437474,0.542646,0.001459,"#ff7007"
28184579,patdiaz,38,0,1,1,0.593974,0.354978,0,"#662859"
28195037,Tatiana_Lima,36,0,1,1,0.472758,0.21484,0,"#825403"
28217357,UFSC,49,4,0,4,0.48159,0.358807,0.001459,"#ff7007"
28218576,mariavlachou_pt,36,1,0,1,0.568679,0.42027,0,"#825403"
28300172,EprintsELIS,36,3,1,4,0.634125,0.289493,0.001459,"#825403"
28313090,UDEP,9,9,0,9,0.671355,0.65474,0.003891,"#008f7b"
28330102,Iturbide,1,0,15,15,0.542949,0.547194,0.006809,"#b6cb00"
28335066,Nancydiana,30,6,9,15,0.494675,0.535839,0.006809,"#ff77ff"
28372650,lcborges,30,1,6,7,0.532877,0.487086,0.002918,"#ff77ff"
28376238,ErikaTamaura,13,0,3,3,0.490888,0.424561,0.000973,"#3bec00"
28412145,Carlouuus,13,2,0,2,0.519265,0.431271,0.000486,"#3bec00"
28416229,marcos_fgs,36,0,2,2,0.525098,0.336104,0.000486,"#825403"
28436138,_Ylim__,30,0,1,1,0.686344,0.61237,0,"#ff77ff"
28446659,LauRpo1,34,0,1,1,0.595456,0.326209,0,"#ff0d69"
28453440,UBC,36,1,0,1,0.529519,0.247641,0,"#825403"
28456376,aeryn_thrace,49,0,3,3,0.413113,0.501269,0.000973,"#ff7007"
28484902,DISNNET,38,1,0,1,0.162566,0.573727,0,"#662859"
28502645,naxhelli,3,0,1,1,0.327353,0.515653,0,"#ffb3ff"
28523101,tagblatt_ch,36,2,0,2,0.469944,0.331506,0.000486,"#825403"
28528850,perezparedes,31,0,3,3,0.538617,0.615422,0.000973,"#3e93ff"
28643856,oxygenxml,30,2,0,2,0.479007,0.500884,0.000486,"#ff77ff"
28652983,germanome,38,0,3,3,0.619154,0.414823,0.000973,"#662859"
28678767,luciasantaella,36,2,0,2,0.512113,0.384861,0.000486,"#825403"
28690738,Mar_pecosa,30,1,14,15,0.525334,0.513244,0.006809,"#ff77ff"
28723750,katushyop,13,1,1,2,0.463477,0.429239,0.000486,"#3bec00"
28775585,gualbertomb,13,0,1,1,0.535803,0.3996,0,"#3bec00"
28805880,ElReventao,49,1,0,1,0.497017,0.206777,0,"#ff7007"
28980450,BegoCamblor,14,0,15,15,0.465283,0.532692,0.006809,"#00eeff"
28981078,cuds,56,1,0,1,0.385638,0.095422,0,"#384205"
28992857,anneperez,34,1,2,3,0.376774,0.447336,0.000973,"#ff0d69"
29002450,missohlaura,14,3,0,3,0.332117,0.559492,0.000973,"#00eeff"
29018793,titayna,49,0,3,3,0.37332,0.503751,0.000973,"#ff7007"
29060728,walter_cnrs,30,0,3,3,0.55371,0.593843,0.000973,"#ff77ff"
29069971,lilimelgar,2,4,0,4,0.463376,0.648229,0.001459,"#ffa64e"
29094116,catahoyosv93,38,0,1,1,0.323889,0.174078,0,"#662859"
29094299,josemp,14,0,1,1,0.659745,0.501897,0,"#00eeff"
29099545,Luis_SR,13,0,2,2,0.475121,0.428875,0.000486,"#3bec00"
29107948,carogruffat,49,10,5,15,0.459894,0.548359,0.006809,"#ff7007"
29144052,g_toro,22,0,11,11,0.494359,0.560369,0.004864,"#00e8b2"
29173500,apermar,0,2,9,11,0.602201,0.529284,0.004864,"#8ecfec"
29175728,mjordano,30,0,8,8,0.506157,0.599562,0.003405,"#ff77ff"
29184702,Albertorum_,30,0,1,1,0.499711,0.634226,0,"#ff77ff"
29210528,estherrodriguez,22,0,1,1,0.609588,0.589931,0,"#00e8b2"
29230621,ttasovac,30,10,2,12,0.51445,0.4806,0.00535,"#ff77ff"
29233382,arslua,15,0,2,2,0.601762,0.558219,0.000486,"#008ebb"
29233900,eddyunderground,41,0,1,1,0.337722,0.392999,0,"#697b00"
29260789,KevinBGunn,30,0,2,2,0.535763,0.58975,0.000486,"#ff77ff"
29271281,deborahcampana,30,0,2,2,0.543306,0.532406,0.000486,"#ff77ff"
29280555,pwlarthur,49,1,0,1,0.369103,0.49388,0,"#ff7007"
29357401,matg20,37,0,2,2,0.535255,0.41143,0.000486,"#006032"
29360785,simon_mahony,36,0,1,1,0.439504,0.596999,0,"#825403"
29369262,cfolch,49,1,0,1,0.345752,0.622532,0,"#ff7007"
29373256,vivoz,13,0,3,3,0.463456,0.409862,0.000973,"#3bec00"
29420610,ARdelasH,0,47,7,54,0.587596,0.579552,0.025778,"#8ecfec"
29472803,NASAWebb,4,1,0,1,0.926138,0.23359,0,"#f4c8cf"
29497240,c_magro,31,5,9,14,0.532117,0.537142,0.006323,"#3e93ff"
29500483,jccahuana,13,0,8,8,0.44756,0.449372,0.003405,"#3bec00"
29511494,uclermont1,15,1,0,1,0.550138,0.649958,0,"#008ebb"
29529194,marialejandrau,38,0,1,1,0.353862,0.172982,0,"#662859"
29551924,Libertas_Brasil,36,0,1,1,0.771799,0.331218,0,"#825403"
29562607,1andresmr,34,0,1,1,0.564124,0.333387,0,"#ff0d69"
29577894,DianaEsther,17,0,2,2,0.776138,0.507585,0.000486,"#ff9cc7"
29615171,lhumanoide,38,0,1,1,0.619445,0.36179,0,"#662859"
29653515,tuBraunschweig,34,1,0,1,0.365934,0.387449,0,"#ff0d69"
29682534,vsasc,13,0,1,1,0.467029,0.386876,0,"#3bec00"
29719950,edo1410,21,0,1,1,0.240795,0.190444,0,"#c6cc85"
29750732,lululorena,49,5,5,10,0.421892,0.383632,0.004377,"#ff7007"
29815389,juliagiannella,36,9,4,13,0.477945,0.368075,0.005837,"#825403"
29823416,johannaberg,34,0,3,3,0.469147,0.431819,0.000973,"#ff0d69"
29921343,JajRK,36,0,1,1,0.390161,0.480372,0,"#825403"
29956706,diraquel,36,0,5,5,0.512601,0.467664,0.001946,"#825403"
29959702,rrsouza,49,1,0,1,0.507578,0.378071,0,"#ff7007"
29977367,rne,8,1,0,1,0.803468,0.597336,0,"#00ed5d"
30023095,dhinym,49,0,1,1,0.422983,0.460888,0,"#ff7007"
30066306,uaq,13,1,0,1,0.364446,0.496228,0,"#3bec00"
30133387,laomsceiich,7,0,2,2,0.416279,0.368864,0.000486,"#ffb800"
30183377,_Quimi_,30,0,1,1,0.500641,0.626649,0,"#ff77ff"
30223203,ramon3434,3,23,0,23,0.637609,0.611448,0.0107,"#ffb3ff"
30245481,soraialima,36,0,1,1,0.525095,0.198014,0,"#825403"
30267068,xaragay,18,0,2,2,0.755873,0.625534,0.000486,"#5456a6"
30343920,silvia_paola,21,0,2,2,0.228934,0.240327,0.000486,"#c6cc85"
30359308,FerFrias,14,3,0,3,0.535031,0.691078,0.000973,"#00eeff"
30377228,guichactis,49,0,1,1,0.378956,0.533859,0,"#ff7007"
30480666,CarlosRF,2,0,1,1,0.658863,0.642708,0,"#ffa64e"
30506437,rosapintado,0,0,1,1,0.285177,0.573605,0,"#8ecfec"
30507888,rousfc,19,0,3,3,0.64759,0.759462,0.000973,"#00d3ff"
30697822,radio3_rne,15,4,0,4,0.527163,0.594732,0.001459,"#008ebb"
30734932,ItsBabielas,37,1,0,1,0.578138,0.377166,0,"#006032"
30844489,miguelmcorreia,36,1,0,1,0.572175,0.420252,0,"#825403"
30920372,CharroTaurino,4,0,1,1,0.87944,0.22621,0,"#f4c8cf"
30980493,tonisolano,0,3,0,3,0.698642,0.477891,0.000973,"#8ecfec"
30985870,sergiomiranda,13,0,2,2,0.445289,0.42196,0.000486,"#3bec00"
30996535,Reactor105,13,1,1,2,0.392785,0.341425,0.000486,"#3bec00"
31027231,VetustoRho,13,0,1,1,0.450293,0.306931,0,"#3bec00"
31035700,cundurraga,13,1,5,6,0.335214,0.497895,0.002432,"#3bec00"
31110533,bonaramis,13,0,1,1,0.486331,0.370419,0,"#3bec00"
31130143,ozmosi,49,0,4,4,0.510156,0.360366,0.001459,"#ff7007"
31137276,bioBlogia,21,0,1,1,0.019015,0.639919,0,"#c6cc85"
31138604,CarlosZarateV,21,0,1,1,0.216787,0.224432,0,"#c6cc85"
31162623,juanmanuelgalan,34,0,2,2,0.5467,0.356417,0.000486,"#ff0d69"
31187155,rhondaneu,49,0,2,2,0.438325,0.560951,0.000486,"#ff7007"
31200660,Elektronz,36,0,1,1,0.501155,0.217739,0,"#825403"
31213848,ceted,13,0,1,1,0.411669,0.345375,0,"#3bec00"
31311757,googlemaps,11,1,0,1,0.495653,0.025717,0,"#3a8724"
31414587,anestraat,8,0,1,1,0.285896,0.257572,0,"#00ed5d"
31433650,BettyRbl,34,0,2,2,0.352142,0.412446,0.000486,"#ff0d69"
31487056,lujoyglamour,31,0,4,4,0.612226,0.531114,0.001459,"#3e93ff"
31534964,rolandosimon,41,0,1,1,0.345515,0.379508,0,"#697b00"
31553733,Lalikitita,21,0,2,2,0.22175,0.248707,0.000486,"#c6cc85"
31627413,Kadidjah,36,0,1,1,0.562512,0.243752,0,"#825403"
31650488,lcodina,31,3,4,7,0.510117,0.557233,0.002918,"#3e93ff"
31653862,vahidm,13,0,4,4,0.5127,0.489102,0.001459,"#3bec00"
31676814,JordiJubany,8,4,1,5,0.692072,0.238454,0.001946,"#00ed5d"
31731533,UAM_Madrid,37,44,4,48,0.571442,0.508767,0.02286,"#006032"
31792190,jaime_oe,22,1,1,2,0.473528,0.641592,0.000486,"#00e8b2"
31805620,seinecle,36,2,0,2,0.405136,0.361439,0.000486,"#825403"
31897405,veronica_soares,36,0,1,1,0.516711,0.207045,0,"#825403"
31907535,Nervion_KMIZA,21,0,1,1,0.209908,0.20986,0,"#c6cc85"
31947242,UnivOfKansas,18,2,0,2,0.409571,0.546771,0.000486,"#5456a6"
32027153,faraondemetal,37,1,3,4,0.535599,0.474114,0.001459,"#006032"
32040057,Alex1kenobi,49,1,0,1,0.319643,0.600893,0,"#ff7007"
32125591,GustavoCoronel,3,0,1,1,0.697656,0.713036,0,"#ffb3ff"
32136778,univgirona,14,6,0,6,0.571906,0.547246,0.002432,"#00eeff"
32158784,sergiobranco,36,2,0,2,0.477732,0.402912,0.000486,"#825403"
32202798,Xim_ena,13,9,14,23,0.467586,0.405496,0.0107,"#3bec00"
32241929,WUCastillo,3,0,1,1,0.626559,0.578728,0,"#ffb3ff"
32254788,reformacultura,13,8,2,10,0.415865,0.43506,0.004377,"#3bec00"
32286868,melissa_bp,49,0,2,2,0.408933,0.593779,0.000486,"#ff7007"
32288036,alcarlop,3,0,3,3,0.459353,0.566601,0.000973,"#ffb3ff"
32331821,Candora_,49,0,1,1,0.406154,0.589169,0,"#ff7007"
32356917,bixhiribarren,38,0,1,1,0.728327,0.458522,0,"#662859"
32443401,istecnico,36,1,0,1,0.526419,0.356321,0,"#825403"
32484323,fdmejia,14,0,2,2,0.444141,0.531755,0.000486,"#00eeff"
32496255,MarthaGroMills,13,1,12,13,0.454053,0.498946,0.005837,"#3bec00"
32509562,yalelibrary,30,1,0,1,0.501333,0.652098,0,"#ff77ff"
32519755,restofworld,36,2,0,2,0.509414,0.363515,0.000486,"#825403"
32583014,jonhz,13,2,1,3,0.388815,0.363129,0.000973,"#3bec00"
32661217,bitecacom,22,0,1,1,0.602966,0.624983,0,"#00e8b2"
32748965,JuanpVasque2,38,0,1,1,0.412541,0.75858,0,"#662859"
32855102,Eo_Stark,21,0,2,2,0.244635,0.224646,0.000486,"#c6cc85"
32875779,luiscfhenriques,22,0,1,1,0.550031,0.654002,0,"#00e8b2"
32926265,JoaquimPinheiro,30,0,5,5,0.591297,0.540609,0.001946,"#ff77ff"
32965038,Msuareztangil,30,0,1,1,0.549896,0.642372,0,"#ff77ff"
32989534,ech_humanidades,37,1,0,1,0.53628,0.767402,0,"#006032"
33005033,rissito,21,0,1,1,0.205019,0.201798,0,"#c6cc85"
33022248,Andreakomio,13,0,3,3,0.515426,0.453621,0.000973,"#3bec00"
33101982,MiltonLaufer,13,0,1,1,0.385429,0.496034,0,"#3bec00"
33116258,linaporras,30,3,0,3,0.544194,0.524226,0.000973,"#ff77ff"
33157646,DanzadanceOrg,22,0,3,3,0.608604,0.520165,0.000973,"#00e8b2"
33214605,UIMP,22,18,3,21,0.564596,0.54488,0.009728,"#00e8b2"
33239572,estefania001_,21,0,1,1,0.211086,0.21481,0,"#c6cc85"
33310796,JohnPostill,49,2,4,6,0.44703,0.532989,0.002432,"#ff7007"
33320088,ccabezas,0,0,3,3,0.431037,0.436981,0.000973,"#8ecfec"
33370074,RenataFM,36,1,3,4,0.501316,0.338759,0.001459,"#825403"
33382387,esterfvb,37,1,0,1,0.545919,0.271243,0,"#006032"
33383694,amaliasl,13,22,15,37,0.415478,0.461882,0.01751,"#3bec00"
33454508,ecarrascobe,19,0,2,2,0.593834,0.540277,0.000486,"#00d3ff"
33473920,thePHPfactory,34,0,1,1,0.475622,0.356488,0,"#ff0d69"
33474655,Cambridge_Uni,22,3,0,3,0.574273,0.625376,0.000973,"#00e8b2"
33486421,julia_10br,36,0,2,2,0.552175,0.316619,0.000486,"#825403"
33519076,EvaBreton,1,0,1,1,0.724247,0.442875,0,"#b6cb00"
33533513,bnovoa,31,0,1,1,0.730967,0.539342,0,"#3e93ff"
33535466,univgroningen,38,3,0,3,0.349957,0.546367,0.000973,"#662859"
33538043,ransomcenter,13,1,0,1,0.552716,0.407823,0,"#3bec00"
33567456,jcordon,49,4,0,4,0.519974,0.597085,0.001459,"#ff7007"
33577232,veracruzenred,17,0,1,1,0.833937,0.239047,0,"#ff9cc7"
33582207,Aleizquierdo,21,0,1,1,0.782751,0.528892,0,"#c6cc85"
33593435,cgainza,21,96,46,142,0.395963,0.462902,0.06858,"#c6cc85"
33632713,BlueBoxTraveler,34,0,4,4,0.466824,0.432513,0.001459,"#ff0d69"
33636080,MaryVillam,21,3,2,5,0.369963,0.464723,0.001946,"#c6cc85"
33638456,Makiabelica,3,0,1,1,0.302769,0.607913,0,"#ffb3ff"
33650538,jimmy_medeiros,36,15,15,30,0.502569,0.404052,0.014105,"#825403"
33667453,AlfredoNarvaez,13,0,11,11,0.494361,0.379339,0.004864,"#3bec00"
33698078,caleroje,22,1,2,3,0.644668,0.437723,0.000973,"#00e8b2"
33706309,museoimaginario,13,0,2,2,0.433357,0.433475,0.000486,"#3bec00"
33747454,leilavieira_31,7,5,5,10,0.405744,0.471621,0.004377,"#ffb800"
33750002,LiteraturaUDP,21,1,0,1,0.576244,0.312777,0,"#c6cc85"
33805424,javiervale,14,0,2,2,0.600305,0.468045,0.000486,"#00eeff"
33820442,luisenelias,1,32,3,35,0.462717,0.707841,0.016537,"#b6cb00"
33832669,jalonsoarevalo,22,206,3,209,0.549179,0.55757,0.101167,"#00e8b2"
33838201,GoogleAI,22,1,0,1,0.503978,0.675296,0,"#00e8b2"
33934550,CricaValle,36,0,1,1,0.554305,0.28929,0,"#825403"
33947371,FreeBlackTX,34,24,2,26,0.410798,0.438986,0.01216,"#ff0d69"
33954663,SargentoGarcia,36,0,1,1,0.566578,0.280405,0,"#825403"
33972897,utlibraries,34,5,0,5,0.429816,0.431909,0.001946,"#ff0d69"
33981124,elarequi,34,1,0,1,0.390405,0.5412,0,"#ff0d69"
33984575,armidaes,13,0,1,1,0.533911,0.401836,0,"#3bec00"
33989170,LANACION,31,2,0,2,0.624141,0.512637,0.000486,"#3e93ff"
34047397,jorgedoprado,14,1,1,2,0.531554,0.470626,0.000486,"#00eeff"
34051298,dkrou,53,0,1,1,0.58426,0.761573,0,"#008bdd"
34083048,o_gabsferreira,36,3,0,3,0.518945,0.365142,0.000973,"#825403"
34182129,zpendiuz,13,0,2,2,0.420255,0.43356,0.000486,"#3bec00"
34227622,geoplace,49,2,0,2,0.523978,0.418822,0.000486,"#ff7007"
34231129,mmalgarra,15,2,0,2,0.604584,0.620665,0.000486,"#008ebb"
34238668,diariosevilla,1,1,0,1,0.482114,0.609539,0,"#b6cb00"
34255829,AlbertoCairo,36,4,0,4,0.446265,0.544537,0.001459,"#825403"
34273242,TaniaLu,31,0,1,1,0.588929,0.475538,0,"#3e93ff"
34285948,Mastermania,1,1,0,1,0.401956,0.539859,0,"#b6cb00"
34355936,JenniferCabral,14,0,1,1,0.559941,0.426316,0,"#00eeff"
34386588,pauolivarespr,7,0,2,2,0.337674,0.31066,0.000486,"#ffb800"
34397766,chazconcitoweon,21,0,1,1,0.16037,0.227152,0,"#c6cc85"
34412803,RanulfoParanhos,36,0,2,2,0.532064,0.258895,0.000486,"#825403"
34425620,jessicammoran,13,0,2,2,0.389141,0.440145,0.000486,"#3bec00"
34456353,francine18pr,41,0,1,1,0.344685,0.340506,0,"#697b00"
34464407,Macquarie_Uni,2,1,0,1,0.40301,0.548164,0,"#ffa64e"
34542223,marielardilla,21,0,3,3,0.303226,0.2909,0.000973,"#c6cc85"
34570084,pedrocanario,30,0,1,1,0.531126,0.630218,0,"#ff77ff"
34585224,LuisRubio_,8,0,2,2,0.678837,0.255434,0.000486,"#00ed5d"
34586817,emirsader,25,1,0,1,0.586126,0.097598,0,"#f4a2ff"
34587778,Bookess,19,4,0,4,0.594375,0.498822,0.001459,"#00d3ff"
34588566,sergenoiret,38,2,2,4,0.533256,0.500186,0.001459,"#662859"
34606262,ULPGC,30,30,7,37,0.550533,0.580822,0.01751,"#ff77ff"
34607715,HASTAC,34,40,6,46,0.40779,0.434205,0.021887,"#ff0d69"
34627820,leandronsp,36,2,0,2,0.477564,0.336455,0.000486,"#825403"
34645943,gerardo_romero,34,0,2,2,0.553476,0.411704,0.000486,"#ff0d69"
34647364,ITESO,13,2,0,2,0.484124,0.407255,0.000486,"#3bec00"
34647568,OscarMP,21,0,2,2,0.264822,0.24256,0.000486,"#c6cc85"
34670137,fresi_a,21,0,1,1,0.190445,0.231804,0,"#c6cc85"
34675251,patcasep,30,1,2,3,0.531277,0.582973,0.000973,"#ff77ff"
34693617,pablomirandaque,7,0,1,1,0.435936,0.321943,0,"#ffb800"
34861757,marisaescribano,13,1,0,1,0.298405,0.40251,0,"#3bec00"
34908882,RLorcaSoto,31,0,3,3,0.589298,0.544527,0.000973,"#3e93ff"
34935938,nuriapiera,49,1,0,1,0.429938,0.66188,0,"#ff7007"
34944407,mszurmuk,36,1,0,1,0.496504,0.281458,0,"#825403"
34978624,oitiagoi,36,0,1,1,0.487419,0.227098,0,"#825403"
34997892,oalcoba,8,5,0,5,0.67045,0.327972,0.001946,"#00ed5d"
34998963,Rosa152,42,13,18,31,0.713101,0.449884,0.014591,"#66e087"
35017628,WSarai,36,0,1,1,0.569479,0.290181,0,"#825403"
35020796,zeziga,36,3,0,3,0.448764,0.275946,0.000973,"#825403"
35026068,pinchecopito,21,0,1,1,0.18979,0.240912,0,"#c6cc85"
35027559,porfirioh,22,0,1,1,0.690776,0.568711,0,"#00e8b2"
35032869,placasa,37,7,5,12,0.580453,0.465285,0.00535,"#006032"
35035282,skuntzficker,7,4,0,4,0.438847,0.358048,0.001459,"#ffb800"
35043821,followlori,36,25,13,38,0.493382,0.300603,0.017996,"#825403"
35065341,CSUC,14,1,0,1,0.632735,0.580665,0,"#00eeff"
35106845,opheliarossetti,6,0,1,1,0.335047,0.748473,0,"#a67800"
35107781,9HelterSkelter9,21,0,1,1,0.222288,0.215464,0,"#c6cc85"
35134832,connygv,38,1,1,2,0.289706,0.549844,0.000486,"#662859"
35201891,pluraleemsite,36,1,6,7,0.442318,0.284102,0.002918,"#825403"
35269694,alvaro_qc,13,1,0,1,0.381843,0.369856,0,"#3bec00"
35339345,omercado,13,0,1,1,0.458259,0.39326,0,"#3bec00"
35343252,phelima,13,1,7,8,0.426098,0.454523,0.003405,"#3bec00"
35369178,amilanese,37,0,2,2,0.251748,0.4614,0.000486,"#006032"
35370982,FreeLanceloth,10,0,1,1,0.689346,0.793371,0,"#52d7c0"
35403297,thomasgpadilla,34,32,12,44,0.436103,0.490777,0.020914,"#ff0d69"
35423789,mikeasencio,34,1,5,6,0.440889,0.250655,0.002432,"#ff0d69"
35455125,lucianaviter,22,1,2,3,0.507907,0.6652,0.000973,"#00e8b2"
35460324,benistofeles,7,1,0,1,0.138618,0.593699,0,"#ffb800"
35477547,danielbonilla,14,0,1,1,0.416119,0.628067,0,"#00eeff"
35571624,vamal,36,0,2,2,0.55007,0.29888,0.000486,"#825403"
35577001,NestorMazatl,49,0,3,3,0.425692,0.543033,0.000973,"#ff7007"
35594954,soyjlromo,7,0,4,4,0.508916,0.531377,0.001459,"#ffb800"
35619075,almaldo2,34,2,5,7,0.486307,0.432321,0.002918,"#ff0d69"
35669324,iniciador_grx,31,0,4,4,0.62497,0.5465,0.001459,"#3e93ff"
35710574,vanessairvinedd,13,0,2,2,0.434328,0.452405,0.000486,"#3bec00"
35716729,Bibliotecas_IC,2,29,8,37,0.508843,0.579928,0.01751,"#ffa64e"
35752351,IAMCRtweets,31,1,0,1,0.591678,0.470013,0,"#3e93ff"
35768256,mayeli_007,10,0,2,2,0.368398,0.513072,0.000486,"#52d7c0"
35804229,jenguiliano,34,22,5,27,0.404006,0.451965,0.012646,"#ff0d69"
35807391,behatriztejada,30,17,6,23,0.521865,0.559743,0.0107,"#ff77ff"
35810013,ilanoXVI,34,0,3,3,0.510569,0.423335,0.000973,"#ff0d69"
35815680,_barbara_castro,36,2,0,2,0.403199,0.330666,0.000486,"#825403"
35893435,kittieromance,13,0,1,1,0.473859,0.396417,0,"#3bec00"
35910512,diegocraig,49,1,14,15,0.458437,0.574505,0.006809,"#ff7007"
35914963,Yoinfluyo,49,1,0,1,0.328164,0.626485,0,"#ff7007"
35915291,marianolegname,3,3,1,4,0.479043,0.616552,0.001459,"#ffb3ff"
35946720,Lizmat,34,0,2,2,0.47682,0.421931,0.000486,"#ff0d69"
35950442,_seraph1,49,1,0,1,0.326375,0.642308,0,"#ff7007"
35954417,Lunadaa,49,1,0,1,0.432351,0.640655,0,"#ff7007"
35997657,Celeste_Box,49,0,1,1,0.391093,0.531693,0,"#ff7007"
36020111,aprensamadrid,0,3,1,4,0.838547,0.690821,0.001459,"#8ecfec"
36047319,gislenefh,36,1,1,2,0.478176,0.329449,0.000486,"#825403"
36107561,Abriluz,13,0,4,4,0.460299,0.444442,0.001459,"#3bec00"
36245461,cardososampaio,36,2,0,2,0.482238,0.322594,0.000486,"#825403"
36251223,UdeSA,49,1,0,1,0.761264,0.824763,0,"#ff7007"
36253197,Juangobeta,14,0,1,1,0.66986,0.51726,0,"#00eeff"
36323374,radioeuskadi,22,4,0,4,0.604876,0.895353,0.001459,"#00e8b2"
36334268,rafa150,49,0,1,1,0.196959,0.545316,0,"#ff7007"
36335110,isidromarin,20,0,2,2,0.433952,0.148505,0.000486,"#f0be45"
36339778,interneteando,30,0,1,1,0.594699,0.495827,0,"#ff77ff"
36363334,jfarenas,22,0,1,1,0.503017,0.726173,0,"#00e8b2"
36377974,doblezzeta,38,0,1,1,0.588083,0.274588,0,"#662859"
36397274,CincoDiascom,30,1,0,1,0.4732,0.645913,0,"#ff77ff"
36574766,lbros,41,5,0,5,0.369283,0.428747,0.001946,"#697b00"
36584651,eliterature,34,1,4,5,0.445093,0.483566,0.001946,"#ff0d69"
36596919,ThaianeOliveira,36,12,9,21,0.515378,0.376739,0.009728,"#825403"
36609284,rfagoaga,13,22,51,73,0.473702,0.438427,0.035019,"#3bec00"
36643462,claupacia,3,0,1,1,0.496059,0.757817,0,"#ffb3ff"
36656007,aglb66,38,0,2,2,0.589375,0.524215,0.000486,"#662859"
36749161,vuelvolar,21,0,1,1,0.216844,0.234466,0,"#c6cc85"
36752249,rlameiro,36,0,1,1,0.525745,0.245627,0,"#825403"
36794896,Saltamentes,49,0,1,1,0.34483,0.490958,0,"#ff7007"
36841223,sidurti,13,0,7,7,0.508086,0.417699,0.002918,"#3bec00"
36880984,JorgeContrerasN,49,1,0,1,0.382298,0.627784,0,"#ff7007"
36901763,adrianaosantos,36,0,2,2,0.55615,0.20714,0.000486,"#825403"
36918338,enriquemuriel,49,2,3,5,0.507381,0.48309,0.001946,"#ff7007"
37226526,julibergmann,49,10,19,29,0.494153,0.482603,0.013619,"#ff7007"
37239804,sdevincenzo,22,0,1,1,0.591771,0.610592,0,"#00e8b2"
37244784,juanfermejia,13,8,31,39,0.527717,0.476301,0.018482,"#3bec00"
37255347,Abuela_Viajera,49,0,13,13,0.460219,0.540407,0.005837,"#ff7007"
37255419,jorvitali,14,3,2,5,0.545454,0.573342,0.001946,"#00eeff"
37283473,jaiderog,49,11,8,19,0.473043,0.561878,0.008755,"#ff7007"
37343073,JorgeMahecha,34,0,2,2,0.516598,0.392769,0.000486,"#ff0d69"
37383783,Desormais_,13,1,2,3,0.449316,0.395247,0.000973,"#3bec00"
37412336,tavosmm,36,3,0,3,0.49133,0.323475,0.000973,"#825403"
37561938,shimoarika,21,1,0,1,0.653783,0.164742,0,"#c6cc85"
37571068,lenguaaldia,49,3,3,6,0.446387,0.648154,0.002432,"#ff7007"
37636497,davidam9,30,0,1,1,0.501188,0.618106,0,"#ff77ff"
37714285,fer_herranzm,22,0,1,1,0.685922,0.529488,0,"#00e8b2"
37724931,yopalinuro,13,0,1,1,0.417592,0.40778,0,"#3bec00"
37725165,escrutador,34,0,1,1,0.482706,0.259636,0,"#ff0d69"
37736834,albertovski,36,2,0,2,0.501977,0.361046,0.000486,"#825403"
37743703,PPMelilla,16,0,2,2,0.925308,0.66889,0.000486,"#c42c63"
37774798,Surfwolf_,21,0,1,1,0.191559,0.224015,0,"#c6cc85"
37807660,marfossatti,55,0,2,2,0.612117,0.516737,0.000486,"#cb3f32"
37811953,victorrogelio,49,0,1,1,0.311741,0.48776,0,"#ff7007"
37835750,BonzoPiriz,40,0,1,1,0.616534,0.02129,0,"#ff12a3"
37864753,evasander,7,4,8,12,0.392275,0.379499,0.00535,"#ffb800"
37883400,fanetin,31,0,2,2,0.571167,0.598068,0.000486,"#3e93ff"
37884272,WageIndicator,34,1,0,1,0.290478,0.381888,0,"#ff0d69"
37919713,pcgomes,36,1,0,1,0.488714,0.298187,0,"#825403"
37932326,renatagames,36,0,1,1,0.463977,0.22455,0,"#825403"
37940750,RicardoChew,7,6,1,7,0.44597,0.367436,0.002918,"#ffb800"
37944019,Varinec,49,0,1,1,0.345379,0.486634,0,"#ff7007"
37986582,dieguintosh,30,2,1,3,0.530516,0.515599,0.000973,"#ff77ff"
37989814,EBSCO,1,2,0,2,0.487156,0.607205,0.000486,"#b6cb00"
38044427,NiaOrozco,40,0,1,1,0.596938,0.023953,0,"#ff12a3"
38108627,SusanaFord,40,0,1,1,0.578001,0.027335,0,"#ff12a3"
38149945,listenn,37,1,0,1,0.723577,0.622622,0,"#006032"
38169381,nrobinsongarcia,31,0,1,1,0.592928,0.473205,0,"#3e93ff"
38183984,corre_Castle,7,0,2,2,0.421206,0.337313,0.000486,"#ffb800"
38209474,Rodrigo_Diez_10,7,0,1,1,0.411094,0.323864,0,"#ffb800"
38248242,nanavaes,36,0,2,2,0.468207,0.249242,0.000486,"#825403"
38282454,EmilyDreyfuss,13,1,5,6,0.455565,0.480275,0.002432,"#3bec00"
38291639,leonoticias_,55,1,0,1,0.741169,0.47062,0,"#cb3f32"
38366169,sartreVV,13,0,2,2,0.49373,0.403461,0.000486,"#3bec00"
38391917,PepeQuintanilla,10,0,3,3,0.423097,0.486072,0.000973,"#52d7c0"
38394750,AlvaroOlmo,58,3,0,3,0.553247,0.579553,0.000973,"#005076"
38458793,StarWlog,21,0,1,1,0.200496,0.240292,0,"#c6cc85"
38463874,intiqueiroz,36,0,2,2,0.544553,0.376897,0.000486,"#825403"
38471570,christianlamb,49,11,11,22,0.44481,0.475224,0.010214,"#ff7007"
38487101,leonace_twitts,55,0,1,1,0.334267,0.537713,0,"#cb3f32"
38526096,sandralorenzano,3,2,0,2,0.448426,0.623138,0.000486,"#ffb3ff"
38536208,librosyletras,38,2,0,2,0.565896,0.643034,0.000486,"#662859"
38558340,carlioti,13,0,3,3,0.439267,0.459057,0.000973,"#3bec00"
38562659,leo_elo_ole,34,0,11,11,0.41259,0.4884,0.004864,"#ff0d69"
38573199,heartsupergirl,49,1,0,1,0.401923,0.6282,0,"#ff7007"
38583938,FerVal100,30,0,2,2,0.437019,0.634011,0.000486,"#ff77ff"
38607794,_O_r_l_a_n_d_o_,1,0,1,1,0.371638,0.746601,0,"#b6cb00"
38640768,lavozdegalicia,55,4,0,4,0.569787,0.455334,0.001459,"#cb3f32"
38640989,PRCanfranc,0,1,10,11,0.455379,0.541854,0.004864,"#8ecfec"
38668074,javiergpatino,22,0,3,3,0.649459,0.533407,0.000973,"#00e8b2"
38701532,mujeresycia,30,3,4,7,0.581088,0.611078,0.002918,"#ff77ff"
38722156,gersonbeltran,55,4,4,8,0.592994,0.507483,0.003405,"#cb3f32"
38733808,ufrj,36,1,0,1,0.423397,0.214114,0,"#825403"
38749782,HistoryLink,13,1,0,1,0.471684,0.636616,0,"#3bec00"
38762370,nomuynormal,13,0,1,1,0.633303,0.990762,0,"#3bec00"
38785249,uvalpochile,14,1,0,1,0.583427,0.454724,0,"#00eeff"
38829940,miss_celanica,4,1,3,4,0.503861,0.490027,0.001459,"#f4c8cf"
39033058,DavidNemer,36,8,0,8,0.504939,0.307806,0.003405,"#825403"
39052618,Manejaco,36,1,0,1,0.509042,0.226008,0,"#825403"
39075275,virginiog,8,73,0,73,0.316875,0.29052,0.035019,"#00ed5d"
39079874,AliciaPomares,22,0,8,8,0.638609,0.56543,0.003405,"#00e8b2"
39098763,IC_FormaELE,1,1,4,5,0.458544,0.684484,0.001946,"#b6cb00"
39114551,yaledailynews,30,1,0,1,0.499158,0.650351,0,"#ff77ff"
39134945,Giyuela,49,6,0,6,0.477132,0.533386,0.002432,"#ff7007"
39146356,ElianaCarlin,37,0,1,1,0.467743,0.281744,0,"#006032"
39170141,rbnrmz,13,4,0,4,0.531068,0.273226,0.001459,"#3bec00"
39212286,ebdonamayor,2,0,1,1,0.394601,0.550744,0,"#ffa64e"
39258677,metafuncion,21,0,1,1,0.19915,0.208073,0,"#c6cc85"
39260772,Julieyeye,38,0,1,1,0.4482,0.775397,0,"#662859"
39296194,eliasbitencourt,36,8,10,18,0.503877,0.391019,0.008268,"#825403"
39306293,USouthFlorida,2,8,0,8,0.518875,0.565224,0.003405,"#ffa64e"
39329152,IrisCB,49,1,0,1,0.411005,0.642711,0,"#ff7007"
39374416,adriesc,49,0,1,1,0.413655,0.597452,0,"#ff7007"
39429546,LibrodeNotas,22,0,3,3,0.603349,0.556152,0.000973,"#00e8b2"
39444200,cantodegrillos,13,1,1,2,0.394751,0.371236,0.000486,"#3bec00"
39462470,torcuataTK,22,1,6,7,0.577697,0.495623,0.002918,"#00e8b2"
39518155,drdianis,20,7,4,11,0.440611,0.231294,0.004864,"#f0be45"
39520766,todoele,1,4,0,4,0.512732,0.638063,0.001459,"#b6cb00"
39521800,mapus,3,0,1,1,0.29974,0.605845,0,"#ffb3ff"
39546264,imoreirasalles,36,2,0,2,0.511055,0.352722,0.000486,"#825403"
39565333,mariaclaraps,14,0,1,1,0.561103,0.422636,0,"#00eeff"
39585367,Harvard,31,8,0,8,0.520499,0.501053,0.003405,"#3e93ff"
39587698,uazlibraries,36,12,0,12,0.435658,0.445885,0.00535,"#825403"
39609552,TheChronotope,36,2,1,3,0.449053,0.419439,0.000973,"#825403"
39619991,CreativeDynamix,36,0,1,1,0.417511,0.584423,0,"#825403"
39698057,nadirchs,30,0,1,1,0.613671,0.608455,0,"#ff77ff"
39727960,ComisionEuropea,15,1,0,1,0.737401,0.602389,0,"#008ebb"
39765594,Ucen,49,10,1,11,0.427502,0.488341,0.004864,"#ff7007"
39776107,AgendaLisboa,36,3,0,3,0.536849,0.387986,0.000973,"#825403"
39807911,pollitaconpapos,13,0,1,1,0.390996,0.39438,0,"#3bec00"
39817290,abelgn,8,0,1,1,0.340335,0.516639,0,"#00ed5d"
39840554,Loly_bs_as,49,0,1,1,0.261183,0.691372,0,"#ff7007"
39894323,gregory_palermo,36,0,1,1,0.39567,0.473091,0,"#825403"
39895840,matitos,38,0,1,1,0.527993,0.32464,0,"#662859"
40004228,escarpulli,17,0,1,1,0.910601,0.364646,0,"#ff9cc7"
40010685,bibliotecasbuap,13,2,1,3,0.457854,0.446812,0.000973,"#3bec00"
40047903,trecet,8,1,0,1,0.653656,0.241784,0,"#00ed5d"
40090034,U_ElClaustro,37,27,4,31,0.418165,0.384994,0.014591,"#006032"
40097592,karinatelurica,51,0,1,1,0.361125,0.184229,0,"#c44aac"
40102769,Frusciante90,22,0,1,1,0.398158,0.610975,0,"#00e8b2"
40119197,Madeitstrange,7,0,1,1,0.818327,0.556771,0,"#ffb800"
40137706,blogdeLaBruja,49,1,0,1,0.307988,0.666312,0,"#ff7007"
40208238,dsobrino,30,0,1,1,0.500071,0.622071,0,"#ff77ff"
40212757,cececebe,14,1,1,2,0.631692,0.480502,0.000486,"#00eeff"
40247884,smartbotero,34,0,2,2,0.567161,0.44055,0.000486,"#ff0d69"
40251274,rossi_claudia,31,0,1,1,0.680864,0.564212,0,"#3e93ff"
40266370,montserratboix,0,1,1,2,0.724839,0.579858,0.000486,"#8ecfec"
40291830,rosguga,38,0,4,4,0.505513,0.442247,0.001459,"#662859"
40329047,silvrib,48,0,3,3,0.226597,0.665606,0.000973,"#ff7a78"
40393591,p00k4,13,0,1,1,0.496661,0.392918,0,"#3bec00"
40409319,Kaerf1,34,0,2,2,0.358318,0.404439,0.000486,"#ff0d69"
40425262,ITU,30,1,0,1,0.722154,0.482136,0,"#ff77ff"
40469615,MapXII,15,0,1,1,0.549767,0.740919,0,"#008ebb"
40536109,M_M_aguiar,36,0,1,1,0.548755,0.280384,0,"#825403"
40551273,lctabata,36,0,2,2,0.413345,0.46205,0.000486,"#825403"
40558279,AnyBru,30,0,1,1,0.552508,0.643216,0,"#ff77ff"
40577613,_eidoscognitio_,42,0,1,1,0.695657,0.447634,0,"#66e087"
40611055,karlamotte,13,3,7,10,0.475292,0.484194,0.004377,"#3bec00"
40643519,carobotero,38,3,7,10,0.562263,0.441132,0.004377,"#662859"
40753142,claudiomendez,21,0,2,2,0.239217,0.252811,0.000486,"#c6cc85"
40764813,PetrusAngelorum,13,0,1,1,0.405883,0.419506,0,"#3bec00"
40830172,aibcde,30,0,2,2,0.491582,0.60197,0.000486,"#ff77ff"
40849855,Monwilca,1,0,1,1,0.351633,0.740091,0,"#b6cb00"
40942340,Malcolm_tc,38,0,1,1,0.303656,0.189855,0,"#662859"
40953076,dustfruit,13,24,12,36,0.460387,0.458175,0.017023,"#3bec00"
40988451,JuanDavidAristi,38,0,2,2,0.538529,0.358547,0.000486,"#662859"
41013595,Emnk,36,0,1,1,0.419662,0.584283,0,"#825403"
41015541,__Carolita_,21,1,0,1,0.573898,0.320276,0,"#c6cc85"
41043162,Giorgioromero,7,0,2,2,0.430601,0.367532,0.000486,"#ffb800"
41176329,merlovega,58,0,3,3,0.480411,0.622844,0.000973,"#005076"
41190229,alestolk,42,2,2,4,0.576446,0.410532,0.001459,"#66e087"
41230160,RadioEducacion,7,18,1,19,0.433565,0.648576,0.008755,"#ffb800"
41248554,BestsongB,13,0,1,1,0.314366,0.469423,0,"#3bec00"
41274437,frioconbotas,49,5,3,8,0.421495,0.547559,0.003405,"#ff7007"
41277309,escuchaelviento,21,0,1,1,0.259097,0.200691,0,"#c6cc85"
41284620,dighumanities,14,1,0,1,0.625684,0.562403,0,"#00eeff"
41305559,nidia_b,49,1,0,1,0.41614,0.385433,0,"#ff7007"
41329328,euskaltelebista,22,0,4,4,0.592827,0.856822,0.001459,"#00e8b2"
41346792,michiganstateu,13,5,0,5,0.50516,0.454365,0.001946,"#3bec00"
41355964,juancalder,2,0,1,1,0.657963,0.651838,0,"#ffa64e"
41371853,Argensola,13,10,51,61,0.486444,0.489172,0.029183,"#3bec00"
41374052,JPsosa,13,0,1,1,0.36573,0.489062,0,"#3bec00"
41383077,CFPD_UDGVirtual,3,0,2,2,0.483424,0.672729,0.000486,"#ffb3ff"
41393785,YoALaOctava,13,0,1,1,0.414558,0.417739,0,"#3bec00"
41424326,villaronrubia,31,0,2,2,0.624494,0.516449,0.000486,"#3e93ff"
41428334,sylvia_brito,19,0,1,1,0.646975,0.636464,0,"#00d3ff"
41430015,jiesot,13,0,4,4,0.450023,0.421436,0.001459,"#3bec00"
41511685,milirispa,3,0,1,1,0.480423,0.779113,0,"#ffb3ff"
41521845,durazzo,36,0,1,1,0.531331,0.303297,0,"#825403"
41548681,jcbugallo,3,0,3,3,0.476537,0.599369,0.000973,"#ffb3ff"
41549042,_sugarplumfairy,21,0,1,1,0.29959,0.436293,0,"#c6cc85"
41558482,annaispascual,1,1,2,3,0.493668,0.55902,0.000973,"#b6cb00"
41565430,aracorbo,30,1,0,1,0.640736,0.704534,0,"#ff77ff"
41569514,elisabeleta,22,1,10,11,0.526056,0.536007,0.004864,"#00e8b2"
41609477,pamelalopezr,3,0,1,1,0.333128,0.50875,0,"#ffb3ff"
41649711,ricvargasmed,49,5,0,5,0.443389,0.55317,0.001946,"#ff7007"
41665131,starpy,31,0,1,1,0.642571,0.499823,0,"#3e93ff"
41758160,mcastex,30,0,1,1,0.363162,0.510195,0,"#ff77ff"
41824898,laurenfklein,36,12,4,16,0.477431,0.395514,0.007296,"#825403"
41830883,limboctante,22,10,0,10,0.593966,0.557532,0.004377,"#00e8b2"
41851448,nexosmexico,10,26,0,26,0.6228,0.745696,0.01216,"#52d7c0"
41880374,RaulChoque,31,0,1,1,0.640507,0.511839,0,"#3e93ff"
41883780,womenslink,19,1,0,1,0.639586,0.784222,0,"#00d3ff"
41889241,AdrianaTostadoB,49,2,0,2,0.405745,0.561401,0.000486,"#ff7007"
41894916,subraga,22,0,1,1,0.606065,0.625218,0,"#00e8b2"
41923656,Danizamira,49,0,2,2,0.386259,0.510197,0.000486,"#ff7007"
41965769,DanielPaulOD,49,20,8,28,0.442366,0.497596,0.013132,"#ff7007"
42048922,visualantro,2,0,2,2,0.575444,0.563582,0.000486,"#ffa64e"
42064840,edotom,38,0,1,1,0.677487,0.45419,0,"#662859"
42066676,ABCiber,36,2,0,2,0.526187,0.32959,0.000486,"#825403"
42070947,jgob,34,33,31,64,0.445185,0.465389,0.030642,"#ff0d69"
42120654,iara_mouse,36,1,0,1,0.550692,0.314194,0,"#825403"
42137252,dqandrade,36,3,2,5,0.780079,0.404961,0.001946,"#825403"
42185722,ontoart,19,0,2,2,0.662454,0.505775,0.000486,"#00d3ff"
42211691,Laeimy,1,0,1,1,0.466949,0.606698,0,"#b6cb00"
42250022,jorgejimra,13,0,1,1,0.486391,0.393476,0,"#3bec00"
42297487,LKMazaki,9,0,1,1,0.789504,0.40917,0,"#008f7b"
42349828,unamorsa,38,0,2,2,0.243443,0.504922,0.000486,"#662859"
42365574,javiersanchezbo,22,0,1,1,0.581553,0.686673,0,"#00e8b2"
42382306,Lexur,31,0,1,1,0.702299,0.492744,0,"#3e93ff"
42384079,JulianMarquina,49,2,0,2,0.409131,0.748076,0.000486,"#ff7007"
42399225,AgenciaFAPESP,36,6,3,9,0.494822,0.259461,0.003891,"#825403"
42416418,lorediueikt,31,0,1,1,0.637699,0.49775,0,"#3e93ff"
42438918,juliapennlert,36,0,2,2,0.443867,0.49346,0.000486,"#825403"
42465727,radical_michael,13,0,1,1,0.349055,0.507378,0,"#3bec00"
42526495,alioshak,49,0,1,1,0.426324,0.715886,0,"#ff7007"
42594986,AselaVit,14,0,2,2,0.61735,0.524353,0.000486,"#00eeff"
42639451,SGolfomitsou,14,0,2,2,0.513421,0.658735,0.000486,"#00eeff"
42648852,yierva,13,172,222,394,0.50052,0.471188,0.191148,"#3bec00"
42664928,elcolef,41,7,2,9,0.418678,0.436044,0.003891,"#697b00"
42705538,_elfaro_,49,1,0,1,0.300276,0.651835,0,"#ff7007"
42707736,elpeluzo23,13,0,1,1,0.585406,0.3855,0,"#3bec00"
42786926,viloja,13,0,1,1,0.399245,0.37154,0,"#3bec00"
42847878,huronferret,13,0,3,3,0.436871,0.485755,0.000973,"#3bec00"
42859613,susanadn,30,0,1,1,0.615628,0.660368,0,"#ff77ff"
42899986,LeaderSummaries,30,1,0,1,0.583219,0.442868,0,"#ff77ff"
42911935,pfcelism,38,0,1,1,0.617279,0.397938,0,"#662859"
42921168,fundalafuente,21,0,2,2,0.226852,0.260528,0.000486,"#c6cc85"
42929553,unirio,36,1,0,1,0.566688,0.308688,0,"#825403"
43152919,marciialuiisa,48,0,1,1,0.196936,0.711281,0,"#ff7a78"
43167222,zeroig,36,7,1,8,0.594445,0.395808,0.003405,"#825403"
43262326,AAHD,49,11,0,11,0.486545,0.558838,0.004864,"#ff7007"
43284695,Alleergic,34,0,1,1,0.541232,0.343491,0,"#ff0d69"
43323995,albertmeronyo,34,0,5,5,0.519314,0.469474,0.001946,"#ff0d69"
43339022,abc_mundo,30,1,0,1,0.58357,0.574428,0,"#ff77ff"
43339914,Sabersinfin,27,4,1,5,0.289679,0.61809,0.001946,"#7e8b76"
43372273,museonacionalco,38,9,3,12,0.533337,0.431259,0.00535,"#662859"
43379739,mariajoafana,34,300,131,431,0.501969,0.458607,0.209144,"#ff0d69"
43382846,itlide,7,0,1,1,0.352554,0.175243,0,"#ffb800"
43384003,kristaewhite,36,0,1,1,0.423889,0.58253,0,"#825403"
43395368,jmjafrx,36,0,1,1,0.380509,0.485652,0,"#825403"
43438049,NichoAlAjillo,38,2,0,2,0.576558,0.438385,0.000486,"#662859"
43516704,rosanamontes,31,0,2,2,0.678936,0.527381,0.000486,"#3e93ff"
43553659,fpecastro,30,1,2,3,0.51142,0.5023,0.000973,"#ff77ff"
43577976,xamaxo,51,0,2,2,0.406975,0.272238,0.000486,"#c44aac"
43664690,CCCBLab,14,87,17,104,0.595066,0.513989,0.050097,"#00eeff"
43705133,ailatandias,36,0,1,1,0.489078,0.211191,0,"#825403"
43720617,joseragas,4,12,8,20,0.440064,0.447317,0.009241,"#f4c8cf"
43744273,PublicaHistoria,13,2,27,29,0.521521,0.421011,0.013619,"#3bec00"
43767028,alirachelpearl,34,0,2,2,0.365644,0.402704,0.000486,"#ff0d69"
43767936,niedbarr,48,0,1,1,0.207996,0.706786,0,"#ff7a78"
43859745,IntroIberica,37,0,1,1,0.745816,0.662533,0,"#006032"
43897160,angelespedro,49,4,2,6,0.310413,0.598632,0.002432,"#ff7007"
43973342,Letralia,49,2,0,2,0.418847,0.617228,0.000486,"#ff7007"
43980188,edtroi,49,1,0,1,0.371853,0.632385,0,"#ff7007"
43982259,redliteraria,13,1,0,1,0.405411,0.448144,0,"#3bec00"
44029921,zybor2000,3,0,1,1,0.471154,0.77363,0,"#ffb3ff"
44046272,blros,41,32,23,55,0.397171,0.437604,0.026265,"#697b00"
44077581,DX_Esau,13,0,8,8,0.526145,0.502586,0.003405,"#3bec00"
44151017,Uniandes,34,165,4,169,0.526565,0.420448,0.081712,"#ff0d69"
44152774,dataprix,37,0,1,1,0.441174,0.614848,0,"#006032"
44318238,mediamusea,14,15,5,20,0.604945,0.551707,0.009241,"#00eeff"
44336458,btoasaver,34,0,1,1,0.49096,0.375048,0,"#ff0d69"
44340473,vroddon,22,0,1,1,0.577669,0.730829,0,"#00e8b2"
44350722,aquimonroy,14,1,0,1,0.334976,0.43528,0,"#00eeff"
44379247,michellerserra,0,2,3,5,0.717779,0.508334,0.001946,"#8ecfec"
44383146,TransitCultura,14,0,1,1,0.782902,0.453488,0,"#00eeff"
44408843,pvierth,36,1,2,3,0.530163,0.55154,0.000973,"#825403"
44410209,JuanSteyn,13,0,8,8,0.492991,0.463234,0.003405,"#3bec00"
44433111,pedrolenhard,36,0,1,1,0.519829,0.343495,0,"#825403"
44503482,felipe1027,21,0,1,1,0.214273,0.225926,0,"#c6cc85"
44550135,JavierPerezCaro,49,1,0,1,0.408839,0.629995,0,"#ff7007"
44577543,LAEL_LU,55,1,0,1,0.696989,0.519699,0,"#cb3f32"
44585286,QuoRevista,49,1,0,1,0.413871,0.638406,0,"#ff7007"
44645190,equihua_sm,49,1,3,4,0.46423,0.525164,0.001459,"#ff7007"
44656990,NoloDz,13,1,6,7,0.492395,0.438064,0.002918,"#3bec00"
44679084,bvmc,22,1,0,1,0.592986,0.691976,0,"#00e8b2"
44716447,gpuntovilarinho,55,2,1,3,0.566946,0.557486,0.000973,"#cb3f32"
44732763,daniel_edutic,13,0,5,5,0.521172,0.463024,0.001946,"#3bec00"
44946138,ScienceSergio,13,0,10,10,0.519472,0.50766,0.004377,"#3bec00"
44953355,ocorcho,22,3,3,6,0.571852,0.608919,0.002432,"#00e8b2"
45007380,eseiuvigo,30,1,0,1,0.577732,0.699374,0,"#ff77ff"
45073138,JOstosF,49,1,0,1,0.37241,0.634456,0,"#ff7007"
45237084,colmich,34,1,0,1,0.494764,0.399149,0,"#ff0d69"
45262818,grupobaratz,49,6,1,7,0.489822,0.594546,0.002918,"#ff7007"
45365418,Luna_Dee,49,0,2,2,0.413256,0.493036,0.000486,"#ff7007"
45411173,soncalumnias,36,0,1,1,0.552692,0.098665,0,"#825403"
45444668,pazpena,21,0,1,1,0.320926,0.43753,0,"#c6cc85"
45447020,xicosa,25,2,0,2,0.574078,0.091546,0.000486,"#f4a2ff"
45518743,florasanz,30,0,4,4,0.534292,0.585049,0.001459,"#ff77ff"
45554558,morenomulas,58,3,13,16,0.493194,0.576498,0.007296,"#005076"
45599578,manuelfherrador,14,0,3,3,0.510315,0.562702,0.000973,"#00eeff"
45601546,sebastianliera,51,0,1,1,0.360195,0.179773,0,"#c44aac"
45649298,andres_serrano,3,0,2,2,0.621166,0.687105,0.000486,"#ffb3ff"
45673248,mahiguerag,38,0,1,1,0.327525,0.184179,0,"#662859"
45816279,octsi,30,0,5,5,0.572894,0.647703,0.001946,"#ff77ff"
45825302,bibliotecaaxarq,58,2,5,7,0.507517,0.567912,0.002918,"#005076"
45832102,sgsinclair,13,2,0,2,0.455383,0.424445,0.000486,"#3bec00"
45840741,Aglaia_Berlutti,13,1,0,1,0.41418,0.466161,0,"#3bec00"
45841081,hgfernan,36,2,0,2,0.468572,0.322677,0.000486,"#825403"
45874114,rikirraka,3,1,0,1,0.630913,0.572616,0,"#ffb3ff"
45886738,albinogoncalves,0,1,1,2,0.405872,0.585479,0.000486,"#8ecfec"
45891631,amgserrano,30,14,0,14,0.553345,0.565926,0.006323,"#ff77ff"
46025986,Yellow_Cat86,21,0,1,1,0.204717,0.236657,0,"#c6cc85"
46106863,Nanakazgz,13,0,1,1,0.406575,0.481736,0,"#3bec00"
46141332,TECcampusMTY,10,5,2,7,0.380754,0.476646,0.002918,"#52d7c0"
46149708,rshoff,14,0,2,2,0.619951,0.526802,0.000486,"#00eeff"
46216541,andrespastor,30,0,1,1,0.479012,0.6275,0,"#ff77ff"
46229100,Jasblleidy,31,0,1,1,0.610704,0.476044,0,"#3e93ff"
46244467,elJabberwocky,13,49,36,85,0.463285,0.462865,0.040856,"#3bec00"
46247496,pacastillo,31,2,4,6,0.625559,0.521131,0.002432,"#3e93ff"
46260308,cunyGClibrary,34,5,0,5,0.452972,0.410019,0.001946,"#ff0d69"
46296735,tomasebm,37,0,1,1,0.238868,0.432235,0,"#006032"
46331882,ateneodemanilau,15,1,0,1,0.561775,0.650956,0,"#008ebb"
46419199,cronopabs,14,0,1,1,0.664547,0.406908,0,"#00eeff"
46444482,artstuffmatters,34,0,1,1,0.318299,0.4271,0,"#ff0d69"
46471572,WalterOrlando,3,0,1,1,0.52366,0.759737,0,"#ffb3ff"
46474848,jonabril,14,0,2,2,0.603222,0.693593,0.000486,"#00eeff"
46491185,profcardoso,36,0,1,1,0.488125,0.185932,0,"#825403"
46508173,caruri20,30,1,0,1,0.601884,0.446144,0,"#ff77ff"
46530078,jaivirdi,22,1,0,1,0.819863,0.704499,0,"#00e8b2"
46531131,andydlbm,13,1,0,1,0.374211,0.386259,0,"#3bec00"
46542802,haticos,3,0,1,1,0.682706,0.707742,0,"#ffb3ff"
46542813,mariestarc,49,0,1,1,0.401494,0.5207,0,"#ff7007"
46606449,psalaburu,0,1,2,3,0.558569,0.425899,0.000973,"#8ecfec"
46612502,carmeartigas,37,3,0,3,0.707982,0.526552,0.000973,"#006032"
46667480,raffazizzi,49,55,9,64,0.460002,0.499759,0.030642,"#ff7007"
46678824,CityofNewarkNJ,34,1,0,1,0.594345,0.410899,0,"#ff0d69"
46680156,asungomezperez,22,4,1,5,0.558635,0.645492,0.001946,"#00e8b2"
46681796,louverture1984,36,3,0,3,0.511087,0.37196,0.000973,"#825403"
46684832,ylarri,3,1,5,6,0.47314,0.61391,0.002432,"#ffb3ff"
46700541,ciespal,22,11,0,11,0.540687,0.732007,0.004864,"#00e8b2"
46735154,INAImexico,7,9,1,10,0.405762,0.409189,0.004377,"#ffb800"
46744125,ArteAlameda,13,1,0,1,0.505087,0.399633,0,"#3bec00"
46777393,nineveth,31,0,1,1,0.667719,0.541589,0,"#3e93ff"
46781859,peruinforma,49,1,0,1,0.393295,0.700998,0,"#ff7007"
46803977,edipas,49,1,0,1,0.375737,0.633548,0,"#ff7007"
46891045,ddianasalazar,34,0,3,3,0.551157,0.394824,0.000973,"#ff0d69"
46923782,JasonBerger1,22,0,1,1,0.40017,0.609056,0,"#00e8b2"
46954783,AndreiaDomings,36,0,1,1,0.823291,0.444938,0,"#825403"
46968095,camikant,22,0,4,4,0.645638,0.553152,0.001459,"#00e8b2"
46992646,jorgeedomejia,38,0,1,1,0.417389,0.768087,0,"#662859"
47062815,IrinaNanu,36,9,1,10,0.437058,0.437585,0.004377,"#825403"
47104846,adagi,49,1,0,1,0.379234,0.639164,0,"#ff7007"
47106557,diegokehrle,36,0,1,1,0.481752,0.217354,0,"#825403"
47172488,RubenAguilar,10,0,1,1,0.688781,0.801905,0,"#52d7c0"
47197615,majulicarvajal,38,1,0,1,0.554914,0.404508,0,"#662859"
47200654,MehniG,13,0,2,2,0.485126,0.404431,0.000486,"#3bec00"
47229725,Robson1983,36,0,2,2,0.449024,0.347954,0.000486,"#825403"
47302211,jobinindia,49,0,1,1,0.340342,0.325786,0,"#ff7007"
47334263,JohannesvV,34,0,7,7,0.472158,0.465672,0.002918,"#ff0d69"
47345551,rolpalacios,3,0,1,1,0.467631,0.668657,0,"#ffb3ff"
47452040,OpenMediaOrg,0,0,2,2,0.438174,0.390783,0.000486,"#8ecfec"
47523773,refresco_,13,0,1,1,0.419864,0.408307,0,"#3bec00"
47558070,Uli_T,13,0,7,7,0.493688,0.491016,0.002918,"#3bec00"
47625685,Fcococo,21,0,1,1,0.311423,0.440691,0,"#c6cc85"
47641660,revmello,36,0,2,2,0.788959,0.64504,0.000486,"#825403"
47777004,Alexa828,13,2,22,24,0.477104,0.48797,0.011187,"#3bec00"
47789228,michacardenas,34,0,2,2,0.363704,0.419308,0.000486,"#ff0d69"
47807426,eugeniofarias,21,0,1,1,0.204607,0.1928,0,"#c6cc85"
47893228,docassar,36,2,10,12,0.463265,0.415549,0.00535,"#825403"
47897751,schallierw,49,7,25,32,0.445149,0.486167,0.015078,"#ff7007"
47898401,titusplattner,36,0,1,1,0.382893,0.58734,0,"#825403"
47927725,colepower,2,0,1,1,0.767534,0.691691,0,"#ffa64e"
47950496,jfcerisier,38,1,1,2,0.645555,0.421484,0.000486,"#662859"
47960062,angelmones,34,0,1,1,0.625986,0.440808,0,"#ff0d69"
47970718,kapahe,21,0,1,1,0.182564,0.247453,0,"#c6cc85"
48015638,juanmanfredi,15,1,7,8,0.560238,0.572304,0.003405,"#008ebb"
48018389,alexisolivo,13,0,1,1,0.493013,0.339109,0,"#3bec00"
48037107,la_car,21,0,1,1,0.478104,0.95022,0,"#c6cc85"
48060949,mariasvlina,50,0,1,1,0.550506,0.019575,0,"#ff76c3"
48098239,PrietoBallester,2,0,1,1,0.653585,0.649759,0,"#ffa64e"
48132342,teoretico,34,0,7,7,0.469709,0.492292,0.002918,"#ff0d69"
48144146,laopinioncucuta,38,4,0,4,0.59841,0.410237,0.001459,"#662859"
48149362,leoperiodista,42,12,0,12,0.684734,0.441176,0.00535,"#66e087"
48182808,takayamamartha,42,0,1,1,0.794752,0.423017,0,"#66e087"
48186728,jceleming,2,0,1,1,0.397104,0.545847,0,"#ffa64e"
48207688,oscarbl,3,0,1,1,0.472049,0.753773,0,"#ffb3ff"
48228743,samlosada,38,0,1,1,0.72418,0.322468,0,"#662859"
48289662,UniofOxford,36,3,0,3,0.441595,0.351432,0.000973,"#825403"
48301445,cutuchiqueno,30,0,4,4,0.463409,0.47837,0.001459,"#ff77ff"
48319058,luisensap,37,0,1,1,0.445423,0.289205,0,"#006032"
48321062,usalbiomedica,58,0,1,1,0.49116,0.66074,0,"#005076"
48334690,domenicuus,49,1,0,1,0.350032,0.687062,0,"#ff7007"
48356019,mambre61,37,0,10,10,0.526831,0.447764,0.004377,"#006032"
48357126,uprrp,23,5,5,10,0.25252,0.501171,0.004377,"#005455"
48360568,dianaharsanyi8,38,0,12,12,0.505816,0.454542,0.00535,"#662859"
48381039,HERMEGISTO,7,0,1,1,0.823512,0.565529,0,"#ffb800"
48383699,Caeli77,13,0,1,1,0.399971,0.393849,0,"#3bec00"
48388985,araceletorres,34,8,0,8,0.490967,0.415899,0.003405,"#ff0d69"
48418636,cliocaribe,30,3,1,4,0.484359,0.587026,0.001459,"#ff77ff"
48453141,sesavan,34,0,1,1,0.327041,0.410835,0,"#ff0d69"
48459313,CiudadLibroz,3,0,1,1,0.451486,0.751252,0,"#ffb3ff"
48487229,jcvmillan,3,0,2,2,0.330867,0.535324,0.000486,"#ffb3ff"
48490801,ChicaKosmica,7,1,0,1,0.193885,0.3887,0,"#ffb800"
48505632,Merca20,49,7,0,7,0.447203,0.616981,0.002918,"#ff7007"
48509947,INMAFIGUEROA,30,3,7,10,0.504813,0.56834,0.004377,"#ff77ff"
48526666,EstrellaRivas_,7,0,1,1,0.406664,0.73404,0,"#ffb800"
48541548,BibliotecaCIDE,4,0,2,2,0.621766,0.286471,0.000486,"#f4c8cf"
48541904,Chicago_IC,2,0,1,1,0.469617,0.654164,0,"#ffa64e"
48550551,Bonsylicious,38,0,1,1,0.612059,0.367063,0,"#662859"
48638769,inghilt,30,0,1,1,0.682174,0.628266,0,"#ff77ff"
48685993,Txaumell,49,1,0,1,0.368852,0.693719,0,"#ff7007"
48718481,ramonmalave,49,1,0,1,0.396631,0.662529,0,"#ff7007"
48793589,thiagobraga2,36,0,1,1,0.555192,0.28281,0,"#825403"
48808600,KState,0,3,0,3,0.918678,0.704326,0.000973,"#8ecfec"
48818510,PabGonzalo,0,0,4,4,0.440908,0.570037,0.001459,"#8ecfec"
48846089,pbongio,49,2,0,2,0.423415,0.526769,0.000486,"#ff7007"
48870122,CarlosRuz_F,49,20,15,35,0.479319,0.467977,0.016537,"#ff7007"
49005215,santiagopinzong,38,2,1,3,0.628082,0.454381,0.000973,"#662859"
49005252,benclarkpoeta,30,0,3,3,0.483247,0.583409,0.000973,"#ff77ff"
49016534,NekoKain,37,0,1,1,0.463072,0.311572,0,"#006032"
49041045,luisfanlo,0,0,1,1,0.438175,0.38746,0,"#8ecfec"
49102651,NIKITALY_FM,49,1,0,1,0.345741,0.640438,0,"#ff7007"
49155585,cohuertam,7,0,2,2,0.420514,0.369131,0.000486,"#ffb800"
49284567,RodrigoBalleste,58,0,1,1,0.556278,0.18319,0,"#005076"
49351587,Van_Saskia,49,0,2,2,0.423849,0.642527,0.000486,"#ff7007"
49351651,biaaccioly,36,2,0,2,0.504037,0.351469,0.000486,"#825403"
49383011,aluciernogena,21,0,1,1,0.184064,0.255962,0,"#c6cc85"
49383406,ESU_DH_CT,15,1,0,1,0.576337,0.610254,0,"#008ebb"
49383897,Jan_Rybicki,13,1,0,1,0.370471,0.514164,0,"#3bec00"
49385541,nicholasbirns,13,0,1,1,0.379745,0.43531,0,"#3bec00"
49386593,oeide,13,1,4,5,0.49843,0.479983,0.001946,"#3bec00"
49429570,giodiros,15,6,0,6,0.557951,0.566409,0.002432,"#008ebb"
49442134,FelipeSanchezB,34,0,2,2,0.47729,0.411241,0.000486,"#ff0d69"
49448258,MiguelTobias,31,0,1,1,0.661775,0.555741,0,"#3e93ff"
49468393,queerpoetics,30,0,1,1,0.505759,0.47477,0,"#ff77ff"
49507898,cwellmon,7,2,2,4,0.548459,0.524483,0.001459,"#ffb800"
49508220,nzerik,30,0,8,8,0.477751,0.492524,0.003405,"#ff77ff"
49524592,rafaelmendezro,37,1,3,4,0.450074,0.224115,0.001459,"#006032"
49541564,morenamariah,36,7,2,9,0.493635,0.203049,0.003891,"#825403"
49542176,kell_hernandez,31,0,2,2,0.599831,0.586617,0.000486,"#3e93ff"
49625758,albaevmiranda,13,0,2,2,0.458052,0.424397,0.000486,"#3bec00"
49631501,aloestcuz,37,0,4,4,0.465697,0.360799,0.001459,"#006032"
49637119,CEOEValladolid,22,0,2,2,0.208631,0.574193,0.000486,"#00e8b2"
49692876,heyohleetsgo,36,0,1,1,0.436301,0.145613,0,"#825403"
49695027,segasi,34,0,3,3,0.481136,0.420516,0.000973,"#ff0d69"
49724372,NiwanSk,13,0,12,12,0.506511,0.504502,0.00535,"#3bec00"
49758266,CulturaUNAM,13,5,0,5,0.53974,0.486207,0.001946,"#3bec00"
49799758,POLITHANO,38,0,1,1,0.408579,0.383318,0,"#662859"
49896014,cesarmty,45,0,2,2,0.66149,0.183337,0.000486,"#00e8ff"
49949460,olivianeta,36,6,0,6,0.49103,0.391157,0.002432,"#825403"
49959907,herediamantis,14,0,1,1,0.514116,0.641322,0,"#00eeff"
49960538,amandalicastro,31,3,0,3,0.543423,0.53984,0.000973,"#3e93ff"
49976458,oiioxford,22,2,0,2,0.368917,0.501433,0.000486,"#00e8b2"
50014991,angeldnieves,49,1,0,1,0.335625,0.41679,0,"#ff7007"
50022680,susanirenebrown,36,1,4,5,0.474426,0.531021,0.001946,"#825403"
50080991,FiloBlogia,30,0,5,5,0.496501,0.559759,0.001946,"#ff77ff"
50098848,Alacranita,34,0,10,10,0.396871,0.43505,0.004377,"#ff0d69"
50122046,melissaterras,13,1,1,2,0.509845,0.406426,0.000486,"#3bec00"
50131859,Kitsune_Amare_,13,1,4,5,0.464545,0.478086,0.001946,"#3bec00"
50135464,PedroDCMonteiro,36,0,1,1,0.492859,0.235507,0,"#825403"
50154608,avatar1488,49,0,2,2,0.398227,0.420444,0.000486,"#ff7007"
50156045,metanoverde,36,0,1,1,0.728728,0.598242,0,"#825403"
50165747,CPerdomo28,42,1,0,1,0.772298,0.435138,0,"#66e087"
50182356,mesinatra,36,0,1,1,0.392135,0.482605,0,"#825403"
50241304,Wolters_Kluwer,22,1,0,1,0.581858,0.627203,0,"#00e8b2"
50242007,Kathycastillo,38,0,2,2,0.568946,0.44707,0.000486,"#662859"
50257296,LlorenteyCuenca,7,1,0,1,0.291875,0.271629,0,"#ffb800"
50257759,MuseuNac_Cat,14,2,0,2,0.544672,0.479765,0.000486,"#00eeff"
50282689,Richardics,37,0,1,1,0.609845,0.55739,0,"#006032"
50322606,javmallo,30,0,1,1,0.518425,0.660165,0,"#ff77ff"
50335019,AlexBurrfoot,37,0,2,2,0.494424,0.591783,0.000486,"#006032"
50345463,MarciaChavez,40,0,1,1,0.603892,0.01692,0,"#ff12a3"
50347559,antropomemoria,49,3,6,9,0.449407,0.637206,0.003891,"#ff7007"
50354243,morenobarber,31,1,0,1,0.624522,0.538858,0,"#3e93ff"
50366308,enlaucab,35,2,1,3,0.670906,0.426526,0.000973,"#00faff"
50382193,litamarch,14,0,1,1,0.671794,0.524988,0,"#00eeff"
50429897,ana_josefa,21,0,2,2,0.233344,0.238007,0.000486,"#c6cc85"
50472273,linarobleslujan,38,0,2,2,0.684004,0.414916,0.000486,"#662859"
50503766,luizaveado,0,0,2,2,0.437199,0.387449,0.000486,"#8ecfec"
50510658,fletcherdurant,34,0,2,2,0.44684,0.229295,0.000486,"#ff0d69"
50513654,LuiGiRod,0,6,2,8,0.492038,0.458118,0.003405,"#8ecfec"
50518937,eldardo,49,6,1,7,0.449058,0.599129,0.002918,"#ff7007"
50529521,dannymr,49,1,0,1,0.356133,0.665798,0,"#ff7007"
50554050,kaadych,7,0,2,2,0.420741,0.365917,0.000486,"#ffb800"
50566800,pedroboardsetal,36,0,2,2,0.444561,0.351713,0.000486,"#825403"
50613002,Saodionisio,36,0,3,3,0.553182,0.382588,0.000973,"#825403"
50626996,UNAM_MX,7,120,1,121,0.41698,0.422478,0.058366,"#ffb800"
50664636,4_nibal,21,0,2,2,0.233446,0.247322,0.000486,"#c6cc85"
50677691,margaisaza,37,0,2,2,0.252916,0.49619,0.000486,"#006032"
50708783,cocorobles,3,0,1,1,0.478462,0.764314,0,"#ffb3ff"
50726062,mad_gcc,14,0,3,3,0.587253,0.511878,0.000973,"#00eeff"
50736346,copdeb,31,0,1,1,0.601573,0.478324,0,"#3e93ff"
50778562,jcrettaz,14,0,2,2,0.535288,0.629109,0.000486,"#00eeff"
50876987,DanielReynoso,49,0,1,1,0.713164,0.380765,0,"#ff7007"
50881457,lucarponif,13,0,1,1,0.62726,0.992831,0,"#3bec00"
51005579,apacx,49,0,2,2,0.385923,0.499206,0.000486,"#ff7007"
51025341,joserovira,58,17,52,69,0.521262,0.572615,0.033074,"#005076"
51071935,Dereckb,38,1,0,1,0.41806,0.860653,0,"#662859"
51076371,katiasilveira,36,0,1,1,0.436291,0.266377,0,"#825403"
51081327,EndairaForever,36,2,5,7,0.509335,0.337551,0.002918,"#825403"
51103331,breviaria,49,1,0,1,0.417041,0.697826,0,"#ff7007"
51105554,la_geofeminista,49,0,1,1,0.439637,0.611221,0,"#ff7007"
51127623,lachina_chile,21,0,2,2,0.197344,0.261627,0.000486,"#c6cc85"
51138022,itacablog,40,0,1,1,0.591009,0.016936,0,"#ff12a3"
51143631,jvolpi,7,0,1,1,0.353603,0.327234,0,"#ffb800"
51233056,beatle53,34,0,1,1,0.406409,0.44468,0,"#ff0d69"
51245897,LeneMarinho,36,0,1,1,0.491816,0.092911,0,"#825403"
51408642,omarsanz,14,0,1,1,0.656026,0.579719,0,"#00eeff"
51467025,Oscarns,49,1,0,1,0.3344,0.647725,0,"#ff7007"
51488257,jmejiat67,22,1,1,2,0.632941,0.566964,0.000486,"#00e8b2"
51495133,cintabellmunt,37,0,2,2,0.634855,0.40625,0.000486,"#006032"
51531924,timonette,13,3,0,3,0.457966,0.450226,0.000973,"#3bec00"
51580676,FlavioRocha1,36,2,13,15,0.500455,0.401385,0.006809,"#825403"
51604657,KarlitaRa,3,2,0,2,0.663615,0.595582,0.000486,"#ffb3ff"
51636767,RobertoPsyche,7,0,2,2,0.420229,0.37393,0.000486,"#ffb800"
51655709,jafetoide,7,0,1,1,0.836168,0.553914,0,"#ffb800"
51741655,FiestaLibro,38,9,2,11,0.446154,0.435088,0.004864,"#662859"
51760517,mjnavia,21,0,1,1,0.221038,0.205367,0,"#c6cc85"
51771849,memoriav,1,1,0,1,0.419667,0.473381,0,"#b6cb00"
51862212,noblecavalcante,36,10,6,16,0.495138,0.297291,0.007296,"#825403"
51912077,AlfaVinyl,13,3,8,11,0.457529,0.425517,0.004864,"#3bec00"
51987291,Wanafrica,49,1,0,1,0.385036,0.501429,0,"#ff7007"
52061806,MatthieuVernier,37,0,1,1,0.674175,0.317075,0,"#006032"
52093200,fredyramirez69,13,0,1,1,0.412578,0.470594,0,"#3bec00"
52150318,PalomaIbarra,13,0,1,1,0.43068,0.404739,0,"#3bec00"
52210899,outecran,14,1,6,7,0.526894,0.498422,0.002918,"#00eeff"
52213363,RosiePapergirl,3,0,2,2,0.440223,0.619341,0.000486,"#ffb3ff"
52349626,StabiHH,13,0,3,3,0.455299,0.494356,0.000973,"#3bec00"
52386954,Carloslunna,36,0,1,1,0.482046,0.214547,0,"#825403"
52392344,BernardoPajares,42,9,4,13,0.698152,0.465567,0.005837,"#66e087"
52422182,julioastillero,13,2,0,2,0.476813,0.36365,0.000486,"#3bec00"
52443287,KB_Nederland,31,1,0,1,0.615929,0.547958,0,"#3e93ff"
52456334,daisilla,36,1,1,2,0.380659,0.433297,0.000486,"#825403"
52523849,Javeriana919fm,13,2,1,3,0.651726,0.456354,0.000973,"#3bec00"
52524273,Statick_ds,20,0,4,4,0.425075,0.182162,0.001459,"#f0be45"
52558216,Nailahnv,36,0,3,3,0.51273,0.209681,0.000973,"#825403"
52568346,KondZilla,36,2,0,2,0.485903,0.334886,0.000486,"#825403"
52570211,erikue,13,1,2,3,0.462763,0.349536,0.000973,"#3bec00"
52605224,RobertoVelosoCL,49,1,0,1,0.311205,0.661135,0,"#ff7007"
52613498,pfaltay,36,6,3,9,0.485994,0.305272,0.003891,"#825403"
52634100,tais_so,36,11,8,19,0.522621,0.286104,0.008755,"#825403"
52682603,universitatURV,1,1,0,1,0.319995,0.744109,0,"#b6cb00"
52693210,erasmusuni,30,1,0,1,0.586265,0.514662,0,"#ff77ff"
52728166,Julian_Chappa,22,0,1,1,0.610985,0.606154,0,"#00e8b2"
52815526,Thalie_Ma,30,0,2,2,0.589641,0.60152,0.000486,"#ff77ff"
52851172,mexiqueancien,4,1,6,7,0.45837,0.359782,0.002918,"#f4c8cf"
52868425,nelsonbobadilla,3,0,1,1,0.500574,0.778347,0,"#ffb3ff"
52938254,RArenasCarter,54,0,1,1,0.333471,0.911769,0,"#ff332c"
52955574,maurohernandez,34,0,3,3,0.496748,0.42319,0.000973,"#ff0d69"
53022592,j_c_laviana,14,0,3,3,0.436218,0.562265,0.000973,"#00eeff"
53037224,HugoTortora,21,0,1,1,0.17247,0.181299,0,"#c6cc85"
53049381,codigocero,55,4,0,4,0.492441,0.546796,0.001459,"#cb3f32"
53072510,Clareeana,48,0,1,1,0.206253,0.725784,0,"#ff7a78"
53078989,oscarelia_,15,0,2,2,0.528753,0.715385,0.000486,"#008ebb"
53105820,crdepaula,36,0,1,1,0.43799,0.224314,0,"#825403"
53119397,eloy_vieira,36,1,0,1,0.462632,0.234256,0,"#825403"
53213450,tamarindoenflor,38,0,2,2,0.510594,0.322757,0.000486,"#662859"
53222110,agusberthet,13,0,1,1,0.61894,0.996063,0,"#3bec00"
53259668,repiresp,48,0,1,1,0.20849,0.72036,0,"#ff7a78"
53297697,tlacuachito_tox,13,0,1,1,0.434283,0.407089,0,"#3bec00"
53349508,Ramon_Mendez,38,33,0,33,0.745242,0.623276,0.015564,"#662859"
53349748,unimed_network,31,1,0,1,0.639654,0.52509,0,"#3e93ff"
53381352,veronicaacha,21,0,1,1,0.326421,0.442218,0,"#c6cc85"
53399897,stschiavetto,49,2,0,2,0.412441,0.387563,0.000486,"#ff7007"
53403847,BNChile,21,2,3,5,0.273162,0.286264,0.001946,"#c6cc85"
53407007,solorzaja,22,4,7,11,0.537071,0.594361,0.004864,"#00e8b2"
53412941,FGVCPDOC,36,1,0,1,0.554548,0.240648,0,"#825403"
53415231,Arturo_P,49,0,2,2,0.399402,0.51037,0.000486,"#ff7007"
53428285,lorenarebelo,36,2,0,2,0.497101,0.350841,0.000486,"#825403"
53457846,El_vasco03,49,1,0,1,0.383569,0.641911,0,"#ff7007"
53460891,fpopinigis,37,0,1,1,0.613123,0.261431,0,"#006032"
53480950,luisalvaz,13,8,6,14,0.550892,0.482289,0.006323,"#3bec00"
53518873,nigropatricia,31,0,5,5,0.523326,0.473378,0.001946,"#3e93ff"
53537881,aramirezgt,38,0,1,1,0.66209,0.413941,0,"#662859"
53543823,UVMMEXICO,13,1,0,1,0.317636,0.321757,0,"#3bec00"
53560219,openscience,49,0,1,1,0.390383,0.519609,0,"#ff7007"
53603841,donantazu,30,0,2,2,0.53966,0.530688,0.000486,"#ff77ff"
53621822,revollo,38,0,1,1,0.101634,0.809493,0,"#662859"
53683972,RedBibliotecas,38,7,3,10,0.521427,0.435048,0.004377,"#662859"
53691381,nealstimler,36,0,5,5,0.458848,0.502778,0.001946,"#825403"
53693381,juanferamirez,21,0,1,1,0.333766,0.448264,0,"#c6cc85"
53702910,logos24,38,0,2,2,0.523114,0.411014,0.000486,"#662859"
53715488,maprats,8,1,11,12,0.648787,0.329747,0.00535,"#00ed5d"
53742649,fraguando,13,0,1,1,0.625864,0.430894,0,"#3bec00"
53744529,temaga,30,1,0,1,0.469477,0.615455,0,"#ff77ff"
53813883,LupitaEbovure,42,0,1,1,0.702021,0.460357,0,"#66e087"
53840651,elekilla,31,0,5,5,0.550691,0.503215,0.001946,"#3e93ff"
53867651,Helizita,13,1,0,1,0.454204,0.39415,0,"#3bec00"
53913957,SgtPepperCDLM,0,0,1,1,0.367871,0.555288,0,"#8ecfec"
53959780,elcachaco,38,0,1,1,0.143607,0.820474,0,"#662859"
53963485,alvaradodeltoro,41,0,1,1,0.312834,0.391319,0,"#697b00"
54002739,josmel1,14,0,2,2,0.639833,0.568732,0.000486,"#00eeff"
54008247,paulafontaine,21,0,1,1,0.171251,0.220514,0,"#c6cc85"
54032881,mtvera09,15,0,2,2,0.409599,0.523538,0.000486,"#008ebb"
54044382,manuelvarzen,13,0,6,6,0.478042,0.568373,0.002432,"#3bec00"
54048396,NoraSagastume,30,0,3,3,0.571098,0.656208,0.000973,"#ff77ff"
54071453,zeknust,36,1,0,1,0.495334,0.151977,0,"#825403"
54086119,Paissordo,3,0,1,1,0.500965,0.771445,0,"#ffb3ff"
54226573,RonaldRRamon,38,0,1,1,0.345861,0.184346,0,"#662859"
54237742,neponita,0,45,0,45,0.450027,0.529293,0.021401,"#8ecfec"
54238309,cencos,49,1,0,1,0.300913,0.632649,0,"#ff7007"
54239374,leonellienlaf,21,0,2,2,0.220889,0.23187,0.000486,"#c6cc85"
54274039,wikimediaco,14,3,0,3,0.47705,0.506254,0.000973,"#00eeff"
54312118,SERGIO_ANGON,7,0,2,2,0.423543,0.369698,0.000486,"#ffb800"
54338577,alasuroboro,13,1,12,13,0.489324,0.399611,0.005837,"#3bec00"
54361405,CarlitaLincecum,13,0,1,1,0.415563,0.471119,0,"#3bec00"
54404368,UF_SpanPort,34,8,6,14,0.448626,0.303015,0.006323,"#ff0d69"
54415545,wdsanchez,3,0,1,1,0.6755,0.714305,0,"#ffb3ff"
54461352,Sandradefelipe,38,3,6,9,0.544677,0.448886,0.003891,"#662859"
54470366,andresfox,37,0,1,1,0.471183,0.146951,0,"#006032"
54483035,bculinary,18,2,0,2,0.742162,0.636854,0.000486,"#5456a6"
54488925,unito,58,1,0,1,0.4865,0.659447,0,"#005076"
54518307,UFJF_,30,1,0,1,0.444544,0.541554,0,"#ff77ff"
54520705,MRL57,36,0,1,1,0.396836,0.474242,0,"#825403"
54558718,FranciscoRamas,31,0,2,2,0.576747,0.516601,0.000486,"#3e93ff"
54568228,jorantoledo,49,0,2,2,0.401807,0.342044,0.000486,"#ff7007"
54586628,mabatalha,36,0,2,2,0.534736,0.435334,0.000486,"#825403"
54606488,FrancescLlorens,31,3,0,3,0.478138,0.585095,0.000973,"#3e93ff"
54658924,paoladel,3,2,2,4,0.587936,0.450349,0.001459,"#ffb3ff"
54687557,marcio_bandeira,36,0,1,1,0.550795,0.242915,0,"#825403"
54723211,LaBarrerita,34,0,3,3,0.563863,0.402351,0.000973,"#ff0d69"
54754708,davidvernonbr,0,0,4,4,0.569565,0.593733,0.001459,"#8ecfec"
54802666,lmanzor,49,2,0,2,0.413308,0.514109,0.000486,"#ff7007"
54863644,sfischerverlage,36,2,0,2,0.464895,0.339201,0.000486,"#825403"
54896145,leninperezperez,7,0,1,1,0.777187,0.622366,0,"#ffb800"
54910648,surreptitiousDI,38,0,1,1,0.549661,0.374529,0,"#662859"
54920394,AlexisPezoa,49,1,0,1,0.345052,0.632645,0,"#ff7007"
54951832,HMCBT,36,0,1,1,0.555892,0.385733,0,"#825403"
54960575,lilibeni,22,0,2,2,0.507309,0.556703,0.000486,"#00e8b2"
54961149,elpais_cultura,1,6,0,6,0.516229,0.633647,0.002432,"#b6cb00"
54990262,googlemexico,11,1,0,1,0.488095,0.028173,0,"#3a8724"
54991009,canelaflorez,38,0,2,2,0.428873,0.310879,0.000486,"#662859"
55002103,eduteka,31,1,0,1,0.576552,0.248331,0,"#3e93ff"
55026459,NewCollegeofFL,36,1,0,1,0.447828,0.272194,0,"#825403"
55043108,CristianeARosa,9,0,1,1,0.668909,0.432947,0,"#008f7b"
55114593,aztec_junglist,13,0,2,2,0.460367,0.3711,0.000486,"#3bec00"
55116487,Hakai_no_Hate,36,0,2,2,0.535531,0.260904,0.000486,"#825403"
55128017,MarceRuiz,14,0,2,2,0.556657,0.505143,0.000486,"#00eeff"
55211777,marrojo,14,0,1,1,0.680446,0.585252,0,"#00eeff"
55235631,ufg_oficial,36,1,0,1,0.554316,0.35904,0,"#825403"
55253492,museudavida,36,1,0,1,0.475552,0.332799,0,"#825403"
55295077,UVALibrary,34,0,2,2,0.398289,0.45579,0.000486,"#ff0d69"
55301495,vmperezm,30,0,3,3,0.697416,0.626922,0.000973,"#ff77ff"
55307037,waltermarellano,7,1,0,1,0.175944,0.745359,0,"#ffb800"
55355913,FabianCorredor,34,0,1,1,0.564534,0.322297,0,"#ff0d69"
55356093,cefuentesh,7,0,1,1,0.406569,0.347447,0,"#ffb800"
55389556,SpinozaNeo,42,2,2,4,1,0.361434,0.001459,"#66e087"
55393461,pedro__romero,14,0,1,1,0.701208,0.037141,0,"#00eeff"
55393664,NanyCandela,3,0,1,1,0.430508,0.753749,0,"#ffb3ff"
55519187,erlamorales,31,0,3,3,0.607044,0.498262,0.000973,"#3e93ff"
55531984,zotea,38,0,1,1,0.312509,0.190628,0,"#662859"
55539822,lab4O4,36,5,1,6,0.499766,0.382035,0.002432,"#825403"
55551179,PPMarx,49,3,0,3,0.446287,0.519631,0.000973,"#ff7007"
55607397,center21,36,0,2,2,0.427456,0.474836,0.000486,"#825403"
55623401,megafonet,30,1,0,1,0.616442,0.433428,0,"#ff77ff"
55628839,cultura_mx,7,1,0,1,0.424993,0.304844,0,"#ffb800"
55672511,atypicalGarcia,36,0,1,1,0.465987,0.290938,0,"#825403"
55746535,OPERAMUNDImx,49,1,0,1,0.43299,0.651821,0,"#ff7007"
55791334,patsapel,49,0,1,1,0.377452,0.528478,0,"#ff7007"
55854737,jesagu,13,0,1,1,0.481895,0.390628,0,"#3bec00"
55859461,zepedaserg,14,1,1,2,0.571505,0.436704,0.000486,"#00eeff"
55901300,edo21,13,0,1,1,0.440357,0.39719,0,"#3bec00"
55928431,mateobrown,38,1,0,1,0.545828,0.372427,0,"#662859"
55950888,lisavol,34,0,1,1,0.415365,0.282376,0,"#ff0d69"
55987540,ksmksm,13,0,12,12,0.492729,0.470781,0.00535,"#3bec00"
56070060,syromon,0,0,1,1,0.371086,0.558783,0,"#8ecfec"
56080802,Pornosawa,49,1,0,1,0.492854,0.603105,0,"#ff7007"
56092891,rrocio,31,0,1,1,0.755814,0.918194,0,"#3e93ff"
56134313,twistweb,36,0,1,1,0.491396,0.22211,0,"#825403"
56161580,OjoBlue,49,1,0,1,0.361209,0.69198,0,"#ff7007"
56184294,Al_Nagler,36,0,1,1,0.412493,0.583072,0,"#825403"
56216625,ren_reis,21,0,1,1,0.187668,0.209171,0,"#c6cc85"
56253925,AnaNoguera,38,0,1,1,0.669627,0.458644,0,"#662859"
56264954,LuisaF2046,34,0,1,1,0.538881,0.339736,0,"#ff0d69"
56321648,La_Cerca,15,0,4,4,0.575064,0.669555,0.001459,"#008ebb"
56337324,beestjee,31,0,1,1,0.698118,0.406446,0,"#3e93ff"
56371952,ObservatorioGE,56,1,1,2,0.375697,0.113349,0.000486,"#384205"
56447221,ptqk,22,10,0,10,0.591206,0.556457,0.004377,"#00e8b2"
56494139,nosoyposmo,49,0,1,1,0.295905,0.603691,0,"#ff7007"
56500942,eliperiodista,21,0,2,2,0.256494,0.239573,0.000486,"#c6cc85"
56505125,googlechrome,30,2,0,2,0.524095,0.579942,0.000486,"#ff77ff"
56529080,cbsalej,38,3,1,4,0.570967,0.47599,0.001459,"#662859"
56530444,gwaramari,49,0,2,2,0.41991,0.490676,0.000486,"#ff7007"
56538291,revtemalivre,36,2,0,2,0.485219,0.334292,0.000486,"#825403"
56540271,RoChuquiruna,10,0,1,1,0.689367,0.80808,0,"#52d7c0"
56583826,historiausp,36,1,0,1,0.447071,0.320189,0,"#825403"
56601707,dncdzgz,21,0,1,1,0.183613,0.243347,0,"#c6cc85"
56601879,juanpabangarita,38,5,26,31,0.517535,0.457645,0.014591,"#662859"
56608207,MaximoAfonso,13,1,12,13,0.465192,0.458907,0.005837,"#3bec00"
56633801,suenarototon,49,1,0,1,0.275141,0.542006,0,"#ff7007"
56635115,carlosgvidal,37,10,2,12,0.355772,0.368346,0.00535,"#006032"
56660843,MikelBelasko,22,0,1,1,0.541296,0.648444,0,"#00e8b2"
56688114,MarcosCasero,58,8,0,8,0.605359,0.621075,0.003405,"#005076"
56701913,zuckytha,49,1,0,1,0.391724,0.659757,0,"#ff7007"
56704556,caspel,49,0,1,1,0.253528,0.640875,0,"#ff7007"
56712678,AmianoMarcelino,36,1,0,1,0.506108,0.149955,0,"#825403"
56712707,Chestergalindos,38,0,1,1,0.609282,0.342104,0,"#662859"
56713067,lawsonstu,13,3,0,3,0.447795,0.429905,0.000973,"#3bec00"
56724999,SENAComunica,13,1,0,1,0.367502,0.374971,0,"#3bec00"
56744104,Conicet,49,6,0,6,0.471863,0.578385,0.002432,"#ff7007"
56751695,AdlaiSteven,38,0,1,1,0.616693,0.344272,0,"#662859"
56793958,carvelaiz,35,1,0,1,0.59824,0.393654,0,"#00faff"
56801991,Culturosa_,0,0,1,1,0.326805,0.568491,0,"#8ecfec"
56812711,miriamkp,34,52,4,56,0.475575,0.45392,0.026751,"#ff0d69"
56862964,Hecastanedaf,7,0,4,4,0.516704,0.505492,0.001459,"#ffb800"
56879263,KenniaV,49,1,0,1,0.415578,0.665397,0,"#ff7007"
56880579,davidipr,8,0,1,1,0.250271,0.25188,0,"#00ed5d"
56883694,ddaayyii,37,0,1,1,0.198048,0.473593,0,"#006032"
56957909,cristobalsuarez,31,230,69,299,0.572242,0.518315,0.144942,"#3e93ff"
56981285,jotegui,1,0,2,2,0.652367,0.447458,0.000486,"#b6cb00"
57019725,deborahjthorpe,30,1,0,1,0.509077,0.631799,0,"#ff77ff"
57040691,agendasamaria,38,0,1,1,0.684107,0.477284,0,"#662859"
57070847,canekozo,7,1,2,3,0.432632,0.332173,0.000973,"#ffb800"
57090216,joseangelbaez,34,0,1,1,0.588572,0.31764,0,"#ff0d69"
57136395,TalitaBaena,36,1,3,4,0.483081,0.310712,0.001459,"#825403"
57157570,Miriposita,13,0,5,5,0.491124,0.471006,0.001946,"#3bec00"
57193123,Dana_Corres,13,0,2,2,0.47247,0.366164,0.000486,"#3bec00"
57205025,lisefer,38,0,4,4,0.556295,0.442207,0.001459,"#662859"
57216469,Canadian_Errant,34,0,2,2,0.468191,0.402218,0.000486,"#ff0d69"
57235167,enurteagaa,34,2,15,17,0.474149,0.49667,0.007782,"#ff0d69"
57238298,MariaCafeina,7,0,2,2,0.413203,0.400453,0.000486,"#ffb800"
57320656,wikidata,30,1,0,1,0.471222,0.62263,0,"#ff77ff"
57351555,joannaprieto,38,1,6,7,0.522459,0.54507,0.002918,"#662859"
57354930,YorokobuMag,1,1,0,1,0.506251,0.783867,0,"#b6cb00"
57359444,MarthianaM,13,1,0,1,0.37582,0.364758,0,"#3bec00"
57374049,agendaccc,49,3,0,3,0.442196,0.563259,0.000973,"#ff7007"
57374240,anale81,34,0,1,1,0.548058,0.336443,0,"#ff0d69"
57403626,MuseoMIDE,13,0,2,2,0.429218,0.435608,0.000486,"#3bec00"
57406804,manny_techno,38,0,1,1,0.112633,0.804838,0,"#662859"
57408549,jedit_editor,36,1,0,1,0.512356,0.332501,0,"#825403"
57421340,kakashi0142009,22,0,1,1,0.611566,0.619427,0,"#00e8b2"
57473707,segoviasan,49,1,0,1,0.295693,0.620771,0,"#ff7007"
57603150,etsinfupv,22,0,1,1,0.658749,0.473134,0,"#00e8b2"
57623076,uc3m,37,55,1,56,0.58157,0.567348,0.026751,"#006032"
57629578,geografiaunb,36,0,1,1,0.460122,0.267483,0,"#825403"
57659119,joseiaguiar,13,0,12,12,0.499623,0.552576,0.00535,"#3bec00"
57666196,LauRobles,38,0,1,1,0.117263,0.798543,0,"#662859"
57667904,LaMuy,40,0,1,1,0.583921,0.011762,0,"#ff12a3"
57686497,dianamaffia,49,0,2,2,0.307449,0.481539,0.000486,"#ff7007"
57692449,ElenaAvanzas,30,1,1,2,0.688717,0.566455,0.000486,"#ff77ff"
57693050,reportera09,30,0,1,1,0.495097,0.619317,0,"#ff77ff"
57752838,liminar,49,1,0,1,0.388378,0.53344,0,"#ff7007"
57777139,radioclasica,8,1,0,1,0.804676,0.59544,0,"#00ed5d"
57806552,randreszurita,21,0,2,2,0.319414,0.362229,0.000486,"#c6cc85"
57824876,Flawery,13,0,1,1,0.645567,0.991625,0,"#3bec00"
57974481,asiriax,13,0,1,1,0.422857,0.410563,0,"#3bec00"
57976060,guicas,36,5,1,6,0.540197,0.473815,0.002432,"#825403"
57983020,la2_tve,0,2,0,2,0.634604,0.687101,0.000486,"#8ecfec"
57985101,CienciaRTVE,4,27,4,31,0.909732,0.25965,0.014591,"#f4c8cf"
57986415,rtveplay,4,27,0,27,0.906854,0.255361,0.012646,"#f4c8cf"
57990114,viviana_tes,38,0,1,1,0.129797,0.8033,0,"#662859"
58025800,Granjel,22,0,1,1,0.667393,0.483279,0,"#00e8b2"
58073253,espejolento,13,299,193,492,0.459007,0.457402,0.238813,"#3bec00"
58167087,Aukido,40,0,1,1,0.604018,0.025954,0,"#ff12a3"
58187124,merceds_vidal,14,0,1,1,0.643349,0.586063,0,"#00eeff"
58238392,ggrros,49,1,0,1,0.419277,0.671416,0,"#ff7007"
58263144,CharlitosVE,42,0,1,1,0.711985,0.44716,0,"#66e087"
58291700,migueljogja,13,7,19,26,0.484834,0.512889,0.01216,"#3bec00"
58333207,aizeta,30,4,10,14,0.463644,0.529695,0.006323,"#ff77ff"
58398846,sanitare,36,0,4,4,0.426893,0.442944,0.001459,"#825403"
58417540,desdelamoncloa,14,1,0,1,0.206771,0.654063,0,"#00eeff"
58434869,ujaen,1,10,2,12,0.535307,0.618595,0.00535,"#b6cb00"
58492780,joshmacfadyen,34,20,1,21,0.501668,0.445277,0.009728,"#ff0d69"
58506243,martinidemisec,21,0,1,1,0.038915,0.635584,0,"#c6cc85"
58554436,Romanl87,10,0,1,1,0.69488,0.791323,0,"#52d7c0"
58555535,fggutierrez,49,26,28,54,0.476483,0.552001,0.025778,"#ff7007"
58557811,cuchoalbert,37,1,1,2,0.599764,0.37538,0.000486,"#006032"
58576852,educacionenmlg,0,1,1,2,0.90606,0.350093,0.000486,"#8ecfec"
58598072,ConectaTECmx,10,2,2,4,0.368658,0.497622,0.001459,"#52d7c0"
58644236,rntdlsss,36,2,0,2,0.509661,0.30526,0.000486,"#825403"
58648556,christopher_ns,36,0,1,1,0.460981,0.25925,0,"#825403"
58660358,Cabildo_Digital,31,0,6,6,0.646239,0.435151,0.002432,"#3e93ff"
58662091,AnaLopesJP,36,0,2,2,0.520389,0.358665,0.000486,"#825403"
58666028,blkbep,10,0,3,3,0.384558,0.326468,0.000973,"#52d7c0"
58724547,IAB_Spain,49,1,0,1,0.341612,0.63456,0,"#ff7007"
58726725,Mediarse,3,0,2,2,0.463622,0.576685,0.000486,"#ffb3ff"
58731302,elestantelit,38,0,1,1,0.310662,0.519388,0,"#662859"
58777237,begoborras_,30,0,1,1,0.461606,0.693445,0,"#ff77ff"
58803111,pavlvstc,20,1,5,6,0.45474,0.291275,0.002432,"#f0be45"
58817433,caekattz,34,0,1,1,0.557735,0.417662,0,"#ff0d69"
58851199,cvdevolder,49,1,2,3,0.441971,0.586305,0.000973,"#ff7007"
58868203,price_bulnes,13,0,5,5,0.509816,0.495072,0.001946,"#3bec00"
58890904,josuerodrigo,3,0,3,3,0.456406,0.566997,0.000973,"#ffb3ff"
58899916,derechosdigital,0,34,1,35,0.471641,0.413763,0.016537,"#8ecfec"
58910888,rmunda,49,1,0,1,0.327842,0.621301,0,"#ff7007"
58923178,absentminddmama,36,0,1,1,0.498728,0.346372,0,"#825403"
58926848,lafranperez,13,0,1,1,0.410624,0.424524,0,"#3bec00"
58949171,natarestrepo,38,1,6,7,0.538379,0.440202,0.002918,"#662859"
58954658,Dianach22,38,0,1,1,0.447468,0.776134,0,"#662859"
59003878,dafranvi21,34,0,1,1,0.5995,0.314833,0,"#ff0d69"
59028483,aquiestadiego,38,0,1,1,0.102925,0.811786,0,"#662859"
59069560,aozomek,14,0,1,1,0.658821,0.510494,0,"#00eeff"
59176934,elieallouche,0,13,0,13,0.512584,0.468157,0.005837,"#8ecfec"
59215690,GiorgioJackson,21,0,1,1,0.154123,0.60817,0,"#c6cc85"
59243365,edisonchc,31,0,3,3,0.603231,0.505811,0.000973,"#3e93ff"
59249748,pablohaya,49,1,0,1,0.433024,0.664506,0,"#ff7007"
59349218,clesanchez,3,0,1,1,0.60727,0.706495,0,"#ffb3ff"
59371979,petrohs,13,0,9,9,0.472524,0.434952,0.003891,"#3bec00"
59446132,koldogb,2,1,0,1,0.395526,0.546943,0,"#ffa64e"
59483936,MundoVisionUSA,34,0,2,2,0.37594,0.419295,0.000486,"#ff0d69"
59528794,El_Mois,13,2,14,16,0.482387,0.448447,0.007296,"#3bec00"
59541115,luiza_xavier,36,4,0,4,0.477628,0.310254,0.001459,"#825403"
59545503,Laravena,21,0,1,1,0.239992,0.213678,0,"#c6cc85"
59554649,_Tiagoventura,36,4,0,4,0.499881,0.368199,0.001459,"#825403"
59564817,sebarojasn,21,0,1,1,0.325661,0.449596,0,"#c6cc85"
59622310,m_collada,49,1,0,1,0.35429,0.641868,0,"#ff7007"
59714254,meditantiguo,37,1,0,1,0.632515,0.350295,0,"#006032"
59741769,susdina,31,0,3,3,0.604713,0.570984,0.000973,"#3e93ff"
59757142,anaalonsofernan,49,2,7,9,0.536694,0.533957,0.003891,"#ff7007"
59770388,sergsfh,36,0,1,1,0.442492,0.264103,0,"#825403"
59787042,danimollo,31,0,2,2,0.587652,0.555497,0.000486,"#3e93ff"
59805032,umblaetterer,30,24,41,65,0.495213,0.516365,0.031128,"#ff77ff"
59815753,ANPBOLIVIA,38,0,3,3,0.547187,0.426911,0.000973,"#662859"
59825751,flaviatcbueno,36,0,1,1,0.369656,0.349273,0,"#825403"
59835165,litocesar,0,0,2,2,0.435282,0.388067,0.000486,"#8ecfec"
59858588,arawaco,40,0,1,1,0.622329,0.030376,0,"#ff12a3"
59870145,PedroGarciaM,21,0,1,1,0.325449,0.438089,0,"#c6cc85"
59885369,Munttse,30,0,1,1,0.524956,0.6315,0,"#ff77ff"
59904740,ticocantillog,3,0,1,1,0.515167,0.755768,0,"#ffb3ff"
59940016,pedroisandretta,36,15,0,15,0.510688,0.343741,0.006809,"#825403"
59949107,jclemus,30,1,0,1,0.711017,0.642134,0,"#ff77ff"
59960687,Maxito_Videla,49,1,0,1,0.354074,0.592296,0,"#ff7007"
60004711,mmeduchatelet,42,2,4,6,0.627619,0.428585,0.002432,"#66e087"
60114903,OscarHablarte,37,0,2,2,0.585922,0.433059,0.000486,"#006032"
60168652,Titoaguirre,13,0,4,4,0.353711,0.337669,0.001459,"#3bec00"
60195750,Prof_Sepulveda,49,0,2,2,0.388767,0.514818,0.000486,"#ff7007"
60304659,paulopen,36,0,4,4,0.514246,0.350486,0.001459,"#825403"
60322031,homabarume,31,0,2,2,0.62243,0.539531,0.000486,"#3e93ff"
60336095,philosophico,49,1,0,1,0.429377,0.680762,0,"#ff7007"
60430130,rizomaka,21,0,1,1,0.491674,0.948526,0,"#c6cc85"
60439734,danavido,34,13,69,82,0.481757,0.491279,0.039397,"#ff0d69"
60474269,dvisuales,13,0,2,2,0.404366,0.436544,0.000486,"#3bec00"
60514114,unibern,36,2,0,2,0.470473,0.337245,0.000486,"#825403"
60549265,javiergomez_eu,49,1,0,1,0.396777,0.618747,0,"#ff7007"
60573613,Vivirdecuentos,15,0,4,4,0.490788,0.57716,0.001459,"#008ebb"
60597591,marcelarosen,21,0,1,1,0.007838,0.644025,0,"#c6cc85"
60632511,gemancastanedap,34,0,2,2,0.545418,0.392464,0.000486,"#ff0d69"
60642183,UniofExeter,36,2,0,2,0.445004,0.506565,0.000486,"#825403"
60670150,CruzCoaching,58,0,1,1,0.554677,0.171129,0,"#005076"
60685242,FTMovistarCL,32,2,1,3,0.34677,0.459177,0.000973,"#00b1c7"
60715051,DublinCore,34,2,0,2,0.415961,0.456084,0.000486,"#ff0d69"
60939339,ElArlequin1,21,0,1,1,0.19975,0.234257,0,"#c6cc85"
60968015,dantexier,49,0,8,8,0.468297,0.541252,0.003405,"#ff7007"
60976373,guishevega,49,1,0,1,0.362639,0.672357,0,"#ff7007"
61010605,LiEspin,34,2,7,9,0.533076,0.458233,0.003891,"#ff0d69"
61055660,mongerogel,30,0,1,1,0.419,0.611139,0,"#ff77ff"
61058501,MarciaRCandido,36,0,2,2,0.45892,0.378353,0.000486,"#825403"
61065637,alternoso,34,0,1,1,0.628031,0.323659,0,"#ff0d69"
61093336,julitoalonso,49,15,16,31,0.447527,0.588637,0.014591,"#ff7007"
61145089,msiemund,36,0,1,1,0.378962,0.479441,0,"#825403"
61190451,pacoramon,30,0,2,2,0.38498,0.40742,0.000486,"#ff77ff"
61195184,CervantesLondon,1,1,3,4,0.460782,0.683195,0.001459,"#b6cb00"
61207257,sophimania,49,1,0,1,0.372524,0.647712,0,"#ff7007"
61217392,uff_br,36,4,0,4,0.500855,0.351107,0.001459,"#825403"
61260912,PROITA,21,0,1,1,0.246692,0.205524,0,"#c6cc85"
61376431,isabelgines,19,3,5,8,0.656052,0.735842,0.003405,"#00d3ff"
61496527,agencia_fiocruz,36,3,1,4,0.544123,0.257881,0.001459,"#825403"
61514276,merrypessina,22,0,1,1,0.545416,0.80963,0,"#00e8b2"
61516341,TeresaOM,13,0,2,2,0.41937,0.381593,0.000486,"#3bec00"
61540160,clausgr,13,0,2,2,0.444105,0.400592,0.000486,"#3bec00"
61559636,InnovaMineduc,21,0,2,2,0.236439,0.254774,0.000486,"#c6cc85"
61584042,arenasjp,30,0,2,2,0.588055,0.642559,0.000486,"#ff77ff"
61648536,dh2015,13,1,0,1,0.484658,0.38846,0,"#3bec00"
61649837,ju4np417,4,0,2,2,0.506668,0.38779,0.000486,"#f4c8cf"
61662269,kaabmuslims,36,0,1,1,0.55893,0.282853,0,"#825403"
61744008,Telefonica,0,7,1,8,0.349299,0.563317,0.003405,"#8ecfec"
61746101,pastandpres,19,1,0,1,0.613962,0.78528,0,"#00d3ff"
61749884,jmcollado,34,0,1,1,0.381028,0.457506,0,"#ff0d69"
61762488,christof77,30,7,38,45,0.493688,0.498306,0.021401,"#ff77ff"
61789162,major_tom_77,13,1,1,2,0.435067,0.37695,0.000486,"#3bec00"
61806528,kicibonaerensa,48,0,1,1,0.24534,0.732072,0,"#ff7a78"
61865540,logoje,3,0,2,2,0.585651,0.56322,0.000486,"#ffb3ff"
62016143,Yhonnatan,3,0,1,1,0.696546,0.650626,0,"#ffb3ff"
62030243,ftsaez,31,10,18,28,0.603407,0.518948,0.013132,"#3e93ff"
62033350,I027614,30,0,1,1,0.578825,0.674451,0,"#ff77ff"
62065310,vrodes,55,7,6,13,0.556444,0.586627,0.005837,"#cb3f32"
62091982,nesacardenas,37,2,0,2,0.569543,0.362403,0.000486,"#006032"
62121364,gelitoazul,3,1,1,2,0.473237,0.655005,0.000486,"#ffb3ff"
62123113,redvilla,21,0,1,1,0.220746,0.195383,0,"#c6cc85"
62130862,semuve,21,0,1,1,0.46157,0.951229,0,"#c6cc85"
62144306,mandrakeelvago,42,0,1,1,0.832064,0.465244,0,"#66e087"
62164668,TelmaIndexer,36,0,1,1,0.557498,0.313184,0,"#825403"
62206995,MateoCardona,3,0,1,1,0.460709,0.756838,0,"#ffb3ff"
62293944,scherichiacoli_,43,0,1,1,0.856095,0.554298,0,"#fcae7e"
62326766,gyrizar,37,2,4,6,0.469102,0.304653,0.002432,"#006032"
62355366,emilopezcano,14,0,2,2,0.572635,0.486738,0.000486,"#00eeff"
62564395,MemoDrawSearch,49,2,0,2,0.412617,0.570811,0.000486,"#ff7007"
62616992,erdosain87,21,0,4,4,0.362834,0.372979,0.001459,"#c6cc85"
62707798,unisabana,38,1,1,2,0.506724,0.285831,0.000486,"#662859"
62816429,ValentinaMoreno,14,0,2,2,0.622069,0.535106,0.000486,"#00eeff"
62818589,IraniDiaspora,30,0,2,2,0.585388,0.636726,0.000486,"#ff77ff"
62830337,mhlarramendi,15,5,3,8,0.533633,0.633706,0.003405,"#008ebb"
62851712,adrianolcp,36,1,3,4,0.480344,0.329509,0.001459,"#825403"
62867284,mirces69,31,0,5,5,0.524401,0.525172,0.001946,"#3e93ff"
62938801,morenocris,22,1,4,5,0.513063,0.472164,0.001946,"#00e8b2"
62976863,AnaXoch,3,1,4,5,0.478527,0.559792,0.001946,"#ffb3ff"
63079140,eldadodelarte,14,10,5,15,0.553545,0.542505,0.006809,"#00eeff"
63176407,Stelluchis,38,0,5,5,0.584889,0.412594,0.001946,"#662859"
63247530,BeatrizNSH,18,0,2,2,0.702589,0.630387,0.000486,"#5456a6"
63298406,farfalev,38,0,1,1,0.550969,0.301682,0,"#662859"
63313996,LaVayolette,30,0,1,1,0.629466,0.609384,0,"#ff77ff"
63316494,FerchoWayne,10,0,1,1,0.672573,0.807787,0,"#52d7c0"
63411616,TheManilaTimes,15,7,0,7,0.507916,0.595012,0.002918,"#008ebb"
63421692,unisevilla,1,47,6,53,0.496232,0.55674,0.025292,"#b6cb00"
63472152,davidgadir,22,0,1,1,0.524545,0.703106,0,"#00e8b2"
63478213,ColombiaAprende,38,0,1,1,0.61985,0.365825,0,"#662859"
63513417,juambedo,0,0,2,2,0.43024,0.602201,0.000486,"#8ecfec"
63532696,Readex,34,0,2,2,0.35265,0.420156,0.000486,"#ff0d69"
63548075,soymanuelduran,49,0,2,2,0.423839,0.61179,0.000486,"#ff7007"
63590302,MariaisabelMota,7,1,1,2,0.36493,0.336375,0.000486,"#ffb800"
63646945,maovato,38,0,1,1,0.301772,0.184275,0,"#662859"
63715498,n_quiroga,49,33,17,50,0.498873,0.485027,0.023833,"#ff7007"
63718692,antoniosalomon,34,0,1,1,0.466559,0.38019,0,"#ff0d69"
63734982,ysrraelcamero,13,0,1,1,0.538522,0.467427,0,"#3bec00"
63765675,undivaga,30,1,3,4,0.532031,0.520849,0.001459,"#ff77ff"
63780723,Alediaganet,49,2,0,2,0.432181,0.560844,0.000486,"#ff7007"
63796001,silviadanzarina,31,0,2,2,0.694508,0.535544,0.000486,"#3e93ff"
63798154,sadads,13,0,3,3,0.46197,0.477235,0.000973,"#3bec00"
63931742,HelmutKramer,49,1,0,1,0.348919,0.635783,0,"#ff7007"
63945888,FrancMambr,22,1,0,1,0.518003,0.671574,0,"#00e8b2"
63955942,areanorte,22,0,4,4,0.557073,0.609982,0.001459,"#00e8b2"
64191222,juandacontreras,49,0,1,1,0.365583,0.529251,0,"#ff7007"
64238450,pokemami,13,0,1,1,0.440119,0.363147,0,"#3bec00"
64243308,Sarahidalgo,13,1,0,1,0.446649,0.364516,0,"#3bec00"
64245814,sethvanhooland,34,30,5,35,0.476633,0.479743,0.016537,"#ff0d69"
64254665,IUColmayor,38,0,1,1,0.614633,0.368383,0,"#662859"
64327748,jaroldiazc,31,0,6,6,0.50386,0.529685,0.002432,"#3e93ff"
64368213,mpalafoxp,30,5,8,13,0.52969,0.57748,0.005837,"#ff77ff"
64374288,VIIICentenario,58,15,2,17,0.47708,0.576924,0.007782,"#005076"
64419705,elcolombiano,38,2,0,2,0.685568,0.616513,0.000486,"#662859"
64430780,caiowerneck,36,2,1,3,0.085051,0.710455,0.000973,"#825403"
64431755,lilobp,38,1,2,3,0.546909,0.395457,0.000973,"#662859"
64439316,Jairo_neuta,49,1,0,1,0.360047,0.648402,0,"#ff7007"
64467281,chamacodelmal,7,0,3,3,0.424389,0.375384,0.000973,"#ffb800"
64470420,aldocalderon,21,0,2,2,0.231406,0.255542,0.000486,"#c6cc85"
64483834,lernante,7,0,1,1,0.406929,0.204447,0,"#ffb800"
64509750,sadoth,38,0,2,2,0.641394,0.441387,0.000486,"#662859"
64660135,conchijimenez,58,4,0,4,0.460567,0.57681,0.001459,"#005076"
64665504,carmencantillo,31,1,1,2,0.488527,0.675772,0.000486,"#3e93ff"
64688299,pepmartorell,8,1,0,1,0.670221,0.25785,0,"#00ed5d"
64689528,gastonlalla,49,1,0,1,0.392901,0.639809,0,"#ff7007"
64689700,elenaarrieta,30,2,0,2,0.500004,0.583105,0.000486,"#ff77ff"
64705873,noheca,30,0,1,1,0.593839,0.664507,0,"#ff77ff"
64721078,YanyetSoto,4,0,1,1,0.875302,0.241868,0,"#f4c8cf"
64721582,omurphy16,30,0,1,1,0.606172,0.38892,0,"#ff77ff"
64744322,ileana_faerie,13,1,11,12,0.532663,0.505473,0.00535,"#3bec00"
64798107,PilpintuTintaya,38,0,1,1,0.521616,0.321068,0,"#662859"
64832859,gracearcher,13,0,3,3,0.469555,0.421042,0.000973,"#3bec00"
64863875,platzi,38,10,0,10,0.330909,0.566025,0.004377,"#662859"
64872094,cployola,38,1,7,8,0.516361,0.474532,0.003405,"#662859"
64939623,jamotilla,34,63,32,95,0.499255,0.472271,0.04572,"#ff0d69"
65067650,jorgepuche,3,0,1,1,0.66994,0.79814,0,"#ffb3ff"
65069099,alf4000,35,0,1,1,0.577017,0.306984,0,"#00faff"
65090367,sandro00304,43,0,2,2,0.647733,0.616068,0.000486,"#fcae7e"
65127540,bibliocampusMTY,10,0,1,1,0.335555,0.485526,0,"#52d7c0"
65162365,jacintodavila,13,0,3,3,0.509669,0.451871,0.000973,"#3bec00"
65163592,Historia_Viva,36,1,0,1,0.448627,0.321527,0,"#825403"
65190931,HarvardHistory,36,1,0,1,0.439474,0.31782,0,"#825403"
65246807,nierere,40,0,1,1,0.606249,0.038229,0,"#ff12a3"
65313232,RecBib,22,2,0,2,0.536764,0.668844,0.000486,"#00e8b2"
65320628,oiarzabal,13,0,3,3,0.414486,0.451194,0.000973,"#3bec00"
65359345,badgalvi,36,2,0,2,0.46765,0.310237,0.000486,"#825403"
65385285,fape_fape,0,3,0,3,0.92711,0.706623,0.000973,"#8ecfec"
65395035,oscarjulian9490,38,0,1,1,0.664326,0.348095,0,"#662859"
65395760,cpdocfgv,36,88,12,100,0.526423,0.366066,0.048152,"#825403"
65396880,enedelate,13,0,2,2,0.529967,0.442018,0.000486,"#3bec00"
65430720,a_gutierrezs,4,0,1,1,0.870665,0.234354,0,"#f4c8cf"
65440006,URosario,37,4,1,5,0.501211,0.340915,0.001946,"#006032"
65463428,Redalyc,34,1,0,1,0.354864,0.485286,0,"#ff0d69"
65501164,yus87,2,0,2,2,0.683349,0.657861,0.000486,"#ffa64e"
65503081,bia_smd_,36,0,1,1,0.492347,0.182215,0,"#825403"
65510475,RobertoNobleL,34,0,2,2,0.465458,0.40198,0.000486,"#ff0d69"
65593241,JulenZaballa,38,0,2,2,0.693154,0.588815,0.000486,"#662859"
65596331,aboutgeo,49,1,4,5,0.435342,0.518305,0.001946,"#ff7007"
65615210,bibliotecasCSIC,22,33,16,49,0.554399,0.559503,0.023346,"#00e8b2"
65616670,UFU_Oficial,36,1,0,1,0.449339,0.257109,0,"#825403"
65723778,tramullas,34,5,5,10,0.556984,0.479666,0.004377,"#ff0d69"
65726830,casperlibero,36,1,0,1,0.438868,0.271907,0,"#825403"
65790870,CELACP,13,1,1,2,0.426137,0.462097,0.000486,"#3bec00"
65825943,CristianSalte,21,0,3,3,0.366337,0.362525,0.000973,"#c6cc85"
65829641,labalteira,49,1,4,5,0.427001,0.554642,0.001946,"#ff7007"
65936045,galarzaba,49,1,0,1,0.397716,0.641877,0,"#ff7007"
65966693,ROLOTESO,3,0,1,1,0.474917,0.755373,0,"#ffb3ff"
65979074,canekzapata,0,1,0,1,0.625848,0.250321,0,"#8ecfec"
66017707,glaucia_ribeiro,36,0,2,2,0.64615,0.442241,0.000486,"#825403"
66026773,laurabogotana,35,0,1,1,0.551921,0.26321,0,"#00faff"
66127272,dgv2014,21,0,1,1,0.215088,0.2177,0,"#c6cc85"
66129085,nmhouston,34,0,2,2,0.463419,0.426308,0.000486,"#ff0d69"
66205047,historiachiqui,35,3,3,6,0.444228,0.342352,0.002432,"#00faff"
66214657,UNRoficial,49,3,0,3,0.416676,0.510459,0.000973,"#ff7007"
66219622,bicilabco,38,0,1,1,0.125966,0.800215,0,"#662859"
66309096,miradaenpapel,21,0,1,1,0.191504,0.241121,0,"#c6cc85"
66319092,annaguillaumet,31,0,2,2,0.584422,0.504835,0.000486,"#3e93ff"
66324125,Angeles_Jurado,30,1,5,6,0.444323,0.524946,0.002432,"#ff77ff"
66340430,monttm,7,0,8,8,0.466751,0.419785,0.003405,"#ffb800"
66340724,disorder80,30,0,2,2,0.536279,0.533599,0.000486,"#ff77ff"
66367629,marianamaggio,3,1,0,1,0.482897,0.666559,0,"#ffb3ff"
66478859,GCalzadilla,42,1,1,2,0.729545,0.441786,0.000486,"#66e087"
66571267,UniJaveriana,37,22,0,22,0.55536,0.416097,0.010214,"#006032"
66584107,aacostach,49,1,0,1,0.380664,0.642742,0,"#ff7007"
66623006,fpianz,49,0,2,2,0.418092,0.518435,0.000486,"#ff7007"
66636184,marianalojo,13,0,4,4,0.489747,0.438306,0.001459,"#3bec00"
66685452,rafamadi,31,0,5,5,0.537419,0.521872,0.001946,"#3e93ff"
66703068,adrijg,13,8,0,8,0.45263,0.382264,0.003405,"#3bec00"
66709269,Yolandoska,30,0,1,1,0.646777,0.682947,0,"#ff77ff"
66718303,AniRedGris,42,0,1,1,0.711265,0.430742,0,"#66e087"
66739013,lc_rb,13,3,14,17,0.488672,0.427305,0.007782,"#3bec00"
66745633,Infobierzo,37,1,1,2,0.540453,0.774806,0.000486,"#006032"
66775485,olartejohn,38,0,2,2,0.577152,0.457384,0.000486,"#662859"
66796847,renatablablabla,48,0,1,1,0.231706,0.721754,0,"#ff7a78"
66933123,Minerva822,13,4,9,13,0.47007,0.468578,0.005837,"#3bec00"
66942912,fatihaidmhand,14,20,7,27,0.502669,0.49303,0.012646,"#00eeff"
67039054,canarias7,30,10,0,10,0.544359,0.598107,0.004377,"#ff77ff"
67059846,Caiobarbo,36,0,3,3,0.530254,0.268157,0.000973,"#825403"
67129377,ramon_heredia,49,1,0,1,0.353421,0.6424,0,"#ff7007"
67167216,cablevisiontv,21,0,1,1,0.199713,0.219635,0,"#c6cc85"
67212563,adedis,17,0,1,1,0.837183,0.22212,0,"#ff9cc7"
67260064,laidea,49,1,0,1,0.348409,0.675792,0,"#ff7007"
67418441,Disney,3,1,0,1,0.301816,0.572848,0,"#ffb3ff"
67420860,UniversidadUCES,49,41,0,41,0.462265,0.500239,0.019455,"#ff7007"
67436345,Bagatela1983,49,1,0,1,0.346641,0.651469,0,"#ff7007"
67443223,CAE1309,49,1,0,1,0.409508,0.676439,0,"#ff7007"
67478115,ACO_1962,21,0,1,1,0.028632,0.637462,0,"#c6cc85"
67486701,anne_elliot07,7,0,1,1,0.839425,0.544552,0,"#ffb800"
67516256,clarabermudez1a,38,0,1,1,0.428733,0.766031,0,"#662859"
67611334,tcreatius,14,0,1,1,0.626516,0.656636,0,"#00eeff"
67640572,valdrimx,13,0,1,1,0.388074,0.426422,0,"#3bec00"
67690199,CDRH_UNL,34,6,0,6,0.432605,0.463679,0.002432,"#ff0d69"
67707256,psilocybernie,34,0,2,2,0.585521,0.381892,0.000486,"#ff0d69"
67724044,mariod2118,38,0,1,1,0.30369,0.177433,0,"#662859"
67756489,danielortizhdez,41,0,1,1,0.313779,0.386919,0,"#697b00"
67795729,e_alfaro,42,0,1,1,0.700911,0.449953,0,"#66e087"
67873788,filipesaraiva,36,0,4,4,0.512598,0.38911,0.001459,"#825403"
67945006,zapatosrosas,30,0,1,1,0.490458,0.652507,0,"#ff77ff"
68168216,gato_rorro,21,6,1,7,0.180094,0.206724,0.002918,"#c6cc85"
68204430,NewsNeus,8,1,10,11,0.58708,0.404358,0.004864,"#00ed5d"
68238336,ktikariza,3,0,1,1,0.463814,0.76149,0,"#ffb3ff"
68238844,GirardyR,49,1,0,1,0.394054,0.696517,0,"#ff7007"
68240802,MarisSchiavo,36,0,2,2,0.703672,0.346883,0.000486,"#825403"
68355544,FrauHihler,21,0,2,2,0.217474,0.244629,0.000486,"#c6cc85"
68385771,RadioSabadell,8,3,2,5,0.689336,0.322858,0.001946,"#00ed5d"
68387146,rivonrl,13,0,2,2,0.413116,0.420593,0.000486,"#3bec00"
68399629,lauraqesta,2,0,2,2,0.687275,0.64842,0.000486,"#ffa64e"
68442845,jgbarah,14,0,1,1,0.611827,0.483748,0,"#00eeff"
68449032,lweakly,34,0,1,1,0.393215,0.4469,0,"#ff0d69"
68504706,aliscolo,13,1,0,1,0.434163,0.288779,0,"#3bec00"
68507139,UdeA,38,7,0,7,0.373694,0.518071,0.002918,"#662859"
68573675,estebanmsch,21,1,0,1,0.231823,0.311767,0,"#c6cc85"
68610860,enriquemaraver,13,0,2,2,0.548882,0.438127,0.000486,"#3bec00"
68673994,Danny__Mac__,34,20,0,20,0.500845,0.450714,0.009241,"#ff0d69"
68730002,EDSITEment,36,1,0,1,0.426535,0.293111,0,"#825403"
68748245,malmirk,55,0,3,3,0.34216,0.546112,0.000973,"#cb3f32"
68775128,OscarMonroy,38,0,1,1,0.686079,0.465062,0,"#662859"
68808619,_SenoraGeek_,3,0,1,1,0.468362,0.739347,0,"#ffb3ff"
68811311,RodrigoSolis_,21,0,2,2,0.254938,0.248427,0.000486,"#c6cc85"
68823009,nicvel,34,0,4,4,0.477724,0.43224,0.001459,"#ff0d69"
68844197,CarlosLoret,17,1,0,1,0.808,0.186731,0,"#ff9cc7"
68904812,danny_boy_jikis,37,2,0,2,0.62205,0.398226,0.000486,"#006032"
68907548,salvagoga,37,0,2,2,0.64111,0.413151,0.000486,"#006032"
68947801,JorgeJmzLpz,58,2,5,7,0.496602,0.574835,0.002918,"#005076"
68963332,marceloraimundo,34,10,0,10,0.497231,0.436206,0.004377,"#ff0d69"
69011706,waltermezquita1,7,0,3,3,0.563838,0.5733,0.000973,"#ffb800"
69012440,PosgradosMTY,13,1,0,1,0.374346,0.510727,0,"#3bec00"
69028635,guillermobustos,49,1,0,1,0.393714,0.668243,0,"#ff7007"
69034110,barbara_dn,30,0,2,2,0.541683,0.527883,0.000486,"#ff77ff"
69072381,enriqueriobo,21,0,1,1,0.029991,0.657956,0,"#c6cc85"
69095369,titopage,38,0,12,12,0.541076,0.447431,0.00535,"#662859"
69139956,gdonoso,21,0,1,1,0.261077,0.20422,0,"#c6cc85"
69226121,avesandr,49,1,0,1,0.38971,0.644182,0,"#ff7007"
69271507,rafadelcastillo,0,0,1,1,0.841114,0.44433,0,"#8ecfec"
69272080,dcontesse,37,0,3,3,0.33183,0.546452,0.000973,"#006032"
69303815,rodrigo_firmino,36,0,2,2,0.539986,0.433139,0.000486,"#825403"
69303881,margaritavela,3,0,1,1,0.442323,0.738436,0,"#ffb3ff"
69341061,edufba,36,2,0,2,0.494673,0.304688,0.000486,"#825403"
69389432,sdelarosasolano,38,0,2,2,0.54807,0.418109,0.000486,"#662859"
69428531,Lety_Crespillo,14,5,28,33,0.551722,0.531032,0.015564,"#00eeff"
69433654,lorep_j,37,0,2,2,0.419981,0.565864,0.000486,"#006032"
69450436,SanIldefonsoMx,13,3,0,3,0.720305,0.596379,0.000973,"#3bec00"
69524415,PercyRosendo,49,1,0,1,0.338599,0.647012,0,"#ff7007"
69619550,LURE_ARQUEO,37,1,0,1,0.631618,0.340378,0,"#006032"
69625871,evfk,34,0,2,2,0.424857,0.469526,0.000486,"#ff0d69"
69655943,centic,22,1,0,1,0.609531,0.639003,0,"#00e8b2"
69668300,CarmenGutiez,1,0,2,2,0.656557,0.541467,0.000486,"#b6cb00"
69683409,filarmonibogota,38,0,1,1,0.797976,0.436037,0,"#662859"
69712005,michabt,14,0,1,1,0.296337,0.378088,0,"#00eeff"
69769332,veraxvel,21,0,1,1,0.234605,0.19492,0,"#c6cc85"
69776538,fernandaabsil,38,0,1,1,0.457644,0.785224,0,"#662859"
69785689,vevecurl,34,0,3,3,0.399059,0.407443,0.000973,"#ff0d69"
69889155,SraCLaus,14,0,2,2,0.569816,0.50151,0.000486,"#00eeff"
70102248,AgustiColomines,22,0,5,5,0.535695,0.502369,0.001946,"#00e8b2"
70147644,penileyramirez,37,2,0,2,0.577305,0.327507,0.000486,"#006032"
70306863,NiadeOca,49,0,2,2,0.430095,0.693696,0.000486,"#ff7007"
70333154,PublicacionsURV,1,0,1,1,0.321937,0.750594,0,"#b6cb00"
70358438,serranocobos,3,5,6,11,0.470384,0.574728,0.004864,"#ffb3ff"
70379556,unmdp,49,3,0,3,0.894967,0.276309,0.000973,"#ff7007"
70388499,asolitaryreign,14,0,1,1,0.687438,0.510636,0,"#00eeff"
70490552,suniggurath,49,0,1,1,0.364129,0.749061,0,"#ff7007"
70493521,CongresoVisible,38,0,1,1,0.731232,0.279018,0,"#662859"
70510009,Lumiephoenix,36,0,3,3,0.476563,0.200073,0.000973,"#825403"
70512879,lojaumet,8,0,2,2,0.798895,0.184487,0.000486,"#00ed5d"
70553033,guzisandoval,13,0,1,1,0.458963,0.304798,0,"#3bec00"
70563525,santiagoitzcoat,0,1,0,1,0.628443,0.252831,0,"#8ecfec"
70591112,irlandast,2,0,2,2,0.688451,0.655707,0.000486,"#ffa64e"
70619271,alexpintor,31,5,8,13,0.590928,0.516624,0.005837,"#3e93ff"
70695732,wikimedia_ar,49,17,6,23,0.451004,0.518351,0.0107,"#ff7007"
70711209,giansaavedrach,31,0,1,1,0.599439,0.722708,0,"#3e93ff"
70718739,UNIVDEP,7,2,0,2,0.807108,0.412621,0.000486,"#ffb800"
70727356,MarceCervantes,13,0,1,1,0.324098,0.497149,0,"#3bec00"
70781018,la_yuko,7,1,0,1,0.512498,0.134608,0,"#ffb800"
70783234,arualdnas,55,0,4,4,0.676941,0.642407,0.001459,"#cb3f32"
70831432,bu_ufsc,22,0,1,1,0.60096,0.623242,0,"#00e8b2"
70865658,siestafuriosa,21,0,2,2,0.243127,0.228796,0.000486,"#c6cc85"
70887911,paduafernandes,36,0,1,1,0.578208,0.282776,0,"#825403"
70908416,So_Miyagawa,22,0,4,4,0.522033,0.522297,0.001459,"#00e8b2"
70964092,andressaramalho,36,0,1,1,0.54509,0.236214,0,"#825403"
70972716,SonogramaMGZN,22,5,2,7,0.381837,0.73129,0.002918,"#00e8b2"
70997942,MiDaimon,13,1,2,3,0.475827,0.437905,0.000973,"#3bec00"
71082415,MarianSulbaran,42,0,1,1,0.714588,0.432152,0,"#66e087"
71088492,Mellember,3,0,2,2,0.440883,0.639605,0.000486,"#ffb3ff"
71111338,edercaz,7,0,2,2,0.79838,0.612921,0.000486,"#ffb800"
71123227,ivanflis,13,0,1,1,0.429197,0.498824,0,"#3bec00"
71140685,Bibipin,38,0,2,2,0.448277,0.798993,0.000486,"#662859"
71169168,Chachacharlis,7,0,1,1,0.343802,0.367798,0,"#ffb800"
71297854,RENATAColombia,3,1,0,1,0.29762,0.578078,0,"#ffb3ff"
71316255,wrongrrl,13,3,0,3,0.471093,0.439604,0.000973,"#3bec00"
71320992,RedeSciELO,36,16,2,18,0.469689,0.439931,0.008268,"#825403"
71357578,elperiodic,14,0,1,1,0.463732,0.675972,0,"#00eeff"
71370207,christilcara,3,4,2,6,0.45466,0.673055,0.002432,"#ffb3ff"
71432785,comoduermes,38,0,1,1,0.546758,0.369317,0,"#662859"
71497091,zdeo,0,1,1,2,0.404804,0.559071,0.000486,"#8ecfec"
71542755,Latanace,10,0,1,1,0.328961,0.487526,0,"#52d7c0"
71584114,Ariel_Moran,13,23,21,44,0.489684,0.466442,0.020914,"#3bec00"
71589573,israeleon,7,0,1,1,0.591936,0.18661,0,"#ffb800"
71623966,RaquelMesaKC,36,7,2,9,0.450115,0.37655,0.003891,"#825403"
71678953,Perestupinya,4,26,4,30,0.909096,0.252872,0.014105,"#f4c8cf"
71681542,xitlally25,10,0,2,2,0.393857,0.458738,0.000486,"#52d7c0"
71682665,danieldjesus1,35,0,1,1,0.732646,0.439984,0,"#00faff"
71687635,maxrodriguezfer,53,0,2,2,0.511889,0.715956,0.000486,"#008bdd"
71779714,EnrikeLopez,0,1,6,7,0.436625,0.555629,0.002918,"#8ecfec"
71796527,jimenezpernett,22,0,1,1,0.393226,0.19391,0,"#00e8b2"
71806186,Lomarsocial,1,0,1,1,0.366929,0.544957,0,"#b6cb00"
71821543,Patriciaenverde,0,0,1,1,0.786858,0.699554,0,"#8ecfec"
71880878,remycast,8,0,1,1,0.262474,0.257396,0,"#00ed5d"
71943155,pedrohuerta,49,1,0,1,0.368055,0.619724,0,"#ff7007"
71959471,maitemorales13,21,0,1,1,0.469279,0.960339,0,"#c6cc85"
71962193,jaescobarh,21,0,1,1,0.179304,0.245068,0,"#c6cc85"
72066634,KleinMGomez,3,0,1,1,0.465147,0.771341,0,"#ffb3ff"
72091564,miguelconga,42,0,1,1,0.718326,0.44503,0,"#66e087"
72149034,FidelRodV,35,6,25,31,0.551677,0.442947,0.014591,"#00faff"
72218292,esechicotan,1,0,3,3,0.660762,0.448339,0.000973,"#b6cb00"
72282160,segunricardo,34,1,0,1,0.528697,0.265741,0,"#ff0d69"
72296583,enunofg,49,3,3,6,0.484205,0.535329,0.002432,"#ff7007"
72466209,ekbufalo,42,3,0,3,0.780923,0.440853,0.000973,"#66e087"
72479585,marcosvdotcom,34,1,0,1,0.306583,0.40445,0,"#ff0d69"
72499358,doctora_alvarez,4,0,4,4,0.915465,0.235424,0.001459,"#f4c8cf"
72525452,herderbarcelona,30,0,1,1,0.52585,0.734686,0,"#ff77ff"
72527814,ACCC_,22,0,2,2,0.665603,0.480659,0.000486,"#00e8b2"
72531111,raultoran,22,0,2,2,0.648815,0.476289,0.000486,"#00e8b2"
72542703,begonyacayuela,34,1,35,36,0.488612,0.509014,0.017023,"#ff0d69"
72677087,EquipoGNOSS,0,1,3,4,0.35896,0.530787,0.001459,"#8ecfec"
72768766,AlxRubio,13,0,1,1,0.41435,0.413094,0,"#3bec00"
72821818,CantabriaCampus,22,0,2,2,0.653265,0.485242,0.000486,"#00e8b2"
72828943,SergiGarcesDiez,8,0,2,2,0.674634,0.31009,0.000486,"#00ed5d"
72831953,tedeguarana,14,16,24,40,0.511088,0.503186,0.018969,"#00eeff"
72841200,JordiPrats,14,0,2,2,0.661264,0.533675,0.000486,"#00eeff"
72874356,nataliesita,38,0,2,2,0.567589,0.342334,0.000486,"#662859"
72922368,SexyCodicology,36,1,1,2,0.468555,0.583008,0.000486,"#825403"
72936117,boricles,22,0,2,2,0.575909,0.72278,0.000486,"#00e8b2"
72967678,Amdrunkencat,38,0,1,1,0.320519,0.182648,0,"#662859"
72994401,Alejoarbelaez,14,0,2,2,0.623557,0.530372,0.000486,"#00eeff"
73024871,udecaldas,9,33,13,46,0.668298,0.620118,0.021887,"#008f7b"
73035041,david_zuratzi,0,0,1,1,0.294054,0.461243,0,"#8ecfec"
73038078,ThoseWhoDesign,0,0,2,2,0.304396,0.483682,0.000486,"#8ecfec"
73081185,mikel_uriguen,3,0,4,4,0.582663,0.656211,0.001459,"#ffb3ff"
73124012,Dpinilla1,22,0,2,2,0.557508,0.718346,0.000486,"#00e8b2"
73139343,teccogs,36,5,2,7,0.502694,0.355253,0.002918,"#825403"
73163693,catalina_uribe,34,0,1,1,0.638467,0.328645,0,"#ff0d69"
73173370,Samarisha,37,0,1,1,0.360646,0.329403,0,"#006032"
73177180,fabiogomesrocha,37,2,1,3,0.535123,0.348828,0.000973,"#006032"
73197259,eortegag,13,9,13,22,0.483873,0.503505,0.010214,"#3bec00"
73205448,albapca,30,0,1,1,0.444386,0.592636,0,"#ff77ff"
73243783,itsvelutluna,49,0,1,1,0.413365,0.516298,0,"#ff7007"
73307531,bdsharmas,0,0,2,2,0.501966,0.424779,0.000486,"#8ecfec"
73312997,marcelobersano,21,0,1,1,0.218271,0.192798,0,"#c6cc85"
73315263,tttkay,13,15,16,31,0.444164,0.46848,0.014591,"#3bec00"
73350229,japtapias,1,9,0,9,0.637617,0.528915,0.003891,"#b6cb00"
73350559,UFVComunicacion,15,0,2,2,0.547311,0.676094,0.000486,"#008ebb"
73467807,SBPCnet,36,1,1,2,0.520983,0.267858,0.000486,"#825403"
73496444,encarnalago,2,0,2,2,0.665022,0.663993,0.000486,"#ffa64e"
73562400,opinioncaribe,49,1,0,1,0.437037,0.687042,0,"#ff7007"
73563898,sellamaconi,21,0,2,2,0.26396,0.223062,0.000486,"#c6cc85"
73623870,ONUMujeres,10,1,0,1,0.283914,0.537859,0,"#52d7c0"
73749456,ju_ms,36,40,35,75,0.494508,0.427878,0.035992,"#825403"
73750177,carolina_bcg,34,0,3,3,0.546123,0.397915,0.000973,"#ff0d69"
73795488,brilealv,21,0,1,1,0.203477,0.252431,0,"#c6cc85"
73796237,Vivmab,13,0,2,2,0.436628,0.422943,0.000486,"#3bec00"
73834748,josegacel,38,1,0,1,0.686556,0.481083,0,"#662859"
73851206,ricardoccorrea,36,2,0,2,0.452824,0.300894,0.000486,"#825403"
73884498,iajoro,37,1,0,1,0.575322,0.381073,0,"#006032"
73891619,llamadmeloco,22,0,1,1,0.38978,0.594984,0,"#00e8b2"
73919744,jwatermelono,58,0,2,2,0.585309,0.295297,0.000486,"#005076"
73933266,Facultad,31,2,0,2,0.836825,0.403292,0.000486,"#3e93ff"
73952364,JAVIERCANTO,3,0,1,1,0.706876,0.715328,0,"#ffb3ff"
74025278,ferbudrovich,21,0,1,1,0.226662,0.210936,0,"#c6cc85"
74042304,dennistenen,34,31,5,36,0.474492,0.458238,0.017023,"#ff0d69"
74068977,elisneimenezes,48,0,1,1,0.221525,0.715787,0,"#ff7a78"
74163875,febab,36,5,0,5,0.59964,0.205631,0.001946,"#825403"
74176581,abrosler,49,1,0,1,0.345783,0.632374,0,"#ff7007"
74178667,redhispanistas,1,1,0,1,0.407457,0.739065,0,"#b6cb00"
74199422,sonmil,38,0,1,1,0.550474,0.414369,0,"#662859"
74201578,VerdadAbierta,38,1,0,1,0.565884,0.374391,0,"#662859"
74293960,ellefj,49,0,1,1,0.348879,0.477013,0,"#ff7007"
74310452,labrendachavez,13,0,3,3,0.504633,0.462128,0.000973,"#3bec00"
74368302,DavidAlexanderB,49,1,0,1,0.38463,0.620052,0,"#ff7007"
74385220,juanluisrios87,14,0,2,2,0.607866,0.469701,0.000486,"#00eeff"
74453123,LaVanguardia,15,31,0,31,0.595999,0.468404,0.014591,"#008ebb"
74466336,abrahammena,13,0,2,2,0.448045,0.452383,0.000486,"#3bec00"
74494726,marcelo_gf,49,0,2,2,0.408131,0.390421,0.000486,"#ff7007"
74534887,Cervinorossel,30,0,1,1,0.440612,0.698575,0,"#ff77ff"
74601155,jcaetanoleite,36,1,1,2,0.50079,0.298346,0.000486,"#825403"
74683881,airun72,14,201,121,322,0.533116,0.5087,0.156128,"#00eeff"
74747358,btik,43,0,1,1,0.722253,0.565438,0,"#fcae7e"
74776409,RevistaArcadia,13,1,0,1,0.381831,0.330424,0,"#3bec00"
74998275,labejita2005,4,0,1,1,0.838269,0.213031,0,"#f4c8cf"
75014629,TecCCM,34,3,0,3,0.480306,0.494861,0.000973,"#ff0d69"
75068957,PatryOcana,49,2,0,2,0.398214,0.578382,0.000486,"#ff7007"
75070810,asesorpolitico,7,0,1,1,0.389246,0.332605,0,"#ffb800"
75085818,iiaunam,13,63,13,76,0.495203,0.419327,0.036479,"#3bec00"
75107677,nuevodiario,38,1,0,1,0.695186,0.461378,0,"#662859"
75140489,diana18ps,58,0,2,2,0.610405,0.302608,0.000486,"#005076"
75141101,vladschuler,36,0,1,1,0.489707,0.224132,0,"#825403"
75251902,institucionsek,8,2,0,2,0.678731,0.31383,0.000486,"#00ed5d"
75286820,natlibscot,13,1,0,1,0.399781,0.495155,0,"#3bec00"
75323881,Omar_r47m4ch1n3,25,4,8,12,0.56275,0.15948,0.00535,"#f4a2ff"
75336065,PENSART,2,0,1,1,0.757376,0.511196,0,"#ffa64e"
75337774,Spanishcountry,31,0,1,1,0.565417,0.622966,0,"#3e93ff"
75339353,gdabos,30,3,7,10,0.532918,0.534929,0.004377,"#ff77ff"
75354109,bla222,7,2,7,9,0.464893,0.424526,0.003891,"#ffb800"
75425373,adriosoriog,9,0,2,2,0.721111,0.657155,0.000486,"#008f7b"
75437408,IsaTagle,21,0,1,1,0.204888,0.231361,0,"#c6cc85"
75453658,cynthiasalazare,7,0,2,2,0.411773,0.359167,0.000486,"#ffb800"
75541219,ManuelaRuiz,31,0,1,1,0.670422,0.549476,0,"#3e93ff"
75584075,INFAIMON,14,2,0,2,0.550613,0.632766,0.000486,"#00eeff"
75620812,merymoisa,49,0,1,1,0.406625,0.713973,0,"#ff7007"
75632275,missylolahuetem,0,0,2,2,0.459334,0.577744,0.000486,"#8ecfec"
75671093,revistalafuga,21,3,3,6,0.435935,0.495489,0.002432,"#c6cc85"
75809770,bibliotecasusal,49,2,0,2,0.460298,0.609725,0.000486,"#ff7007"
75863541,acamaril,0,0,3,3,0.309796,0.481247,0.000973,"#8ecfec"
75863967,JLBuenache,8,0,1,1,0.271309,0.259531,0,"#00ed5d"
75927998,allmota,36,0,1,1,0.509651,0.325195,0,"#825403"
75932312,agnra,49,0,2,2,0.383802,0.542726,0.000486,"#ff7007"
75983317,BorisAlmonacid,13,0,1,1,0.417672,0.494941,0,"#3bec00"
76020353,Esri_Spain,1,4,1,5,0.675855,0.477898,0.001946,"#b6cb00"
76146283,CienciaPR,34,3,2,5,0.325025,0.469161,0.001946,"#ff0d69"
76191300,memoo_mx,7,0,1,1,0.785941,0.31909,0,"#ffb800"
76196543,jcoyuela,49,1,0,1,0.341924,0.610175,0,"#ff7007"
76200776,anapoima1984,38,0,1,1,0.133181,0.822731,0,"#662859"
76212796,Wribrarian,34,0,2,2,0.361949,0.413729,0.000486,"#ff0d69"
76222197,ideagenial,49,1,0,1,0.387235,0.637537,0,"#ff7007"
76320017,BAD74,9,0,3,3,0.664739,0.434888,0.000973,"#008f7b"
76368230,imargarites,36,0,1,1,0.54519,0.28238,0,"#825403"
76418578,revistanan,49,1,0,1,0.371719,0.641797,0,"#ff7007"
76427609,fjrascon,49,1,0,1,0.392277,0.620628,0,"#ff7007"
76517736,JLMONDRAGONS,4,0,1,1,0.843753,0.246966,0,"#f4c8cf"
76547015,pavesipavesi,36,3,12,15,0.502126,0.385155,0.006809,"#825403"
76607286,ElBierzoDigital,37,7,1,8,0.521218,0.828965,0.003405,"#006032"
76649031,fabianasans,22,0,1,1,0.414774,0.706421,0,"#00e8b2"
76671912,Avaa_org,49,1,0,1,0.422648,0.669151,0,"#ff7007"
76673044,escritoriocont,49,2,0,2,0.421438,0.620308,0.000486,"#ff7007"
76674192,CalamoyCran,15,7,1,8,0.600183,0.563306,0.003405,"#008ebb"
76678975,MariaPradaU,34,0,1,1,0.56387,0.225296,0,"#ff0d69"
76686789,ANUIES,13,1,0,1,0.312045,0.328557,0,"#3bec00"
76687584,Daniel_TrejosT,38,0,1,1,0.321306,0.185522,0,"#662859"
76693160,steltenpower,13,0,1,1,0.490338,0.370626,0,"#3bec00"
76746450,pedro_ojeda,30,4,0,4,0.6409,0.603646,0.001459,"#ff77ff"
76901774,impactocr,34,1,0,1,0.39385,0.507915,0,"#ff0d69"
76982124,raguayor,21,0,2,2,0.23755,0.230936,0.000486,"#c6cc85"
76997494,anadecimononica,13,0,3,3,0.532463,0.409304,0.000973,"#3bec00"
77011793,aralimfr,13,0,1,1,0.408331,0.398008,0,"#3bec00"
77015159,gerardoblancopy,37,0,1,1,0.218813,0.480021,0,"#006032"
77019067,nupill,36,3,0,3,0.412017,0.499778,0.000973,"#825403"
77038564,nyunyusa,15,0,1,1,0.546977,0.748051,0,"#008ebb"
77043235,jvinopal,41,0,1,1,0.366868,0.398174,0,"#697b00"
77046171,juanlu_rc,14,0,1,1,0.359016,0.450928,0,"#00eeff"
77074214,marisolbcn,14,0,2,2,0.578135,0.448296,0.000486,"#00eeff"
77087569,2Panoramix,38,0,1,1,0.464379,0.360693,0,"#662859"
77113742,pablofd,49,1,0,1,0.316954,0.677073,0,"#ff7007"
77132943,feramosg,2,0,2,2,0.478351,0.631961,0.000486,"#ffa64e"
77185791,silvymargarita,14,6,10,16,0.516332,0.505248,0.007296,"#00eeff"
77192055,LuisaLisette,22,0,1,1,0.291627,0.656144,0,"#00e8b2"
77195099,DGSoziologie,36,2,0,2,0.468917,0.326995,0.000486,"#825403"
77205777,MosaicUOC,37,6,2,8,0.612272,0.329575,0.003405,"#006032"
77209211,Bibliotecas_UC,7,4,3,7,0.425748,0.341625,0.002918,"#ffb800"
77288753,notipositivas,3,0,3,3,0.446941,0.609381,0.000973,"#ffb3ff"
77298876,Nuria_Costa,49,1,0,1,0.398374,0.657373,0,"#ff7007"
77311199,aletzgarher,10,0,1,1,0.672149,0.812667,0,"#52d7c0"
77348735,elisadel,49,1,0,1,0.536295,0.351132,0,"#ff7007"
77372765,Junkiezap,4,0,1,1,0.836943,0.231364,0,"#f4c8cf"
77415983,merinol,42,2,9,11,0.553411,0.45209,0.004864,"#66e087"
77436748,juliannenyhan,36,1,2,3,0.473199,0.51564,0.000973,"#825403"
77506826,Carlostorress07,38,0,1,1,0.596542,0.351571,0,"#662859"
77679581,CelisMX,38,0,1,1,0.651819,0.472668,0,"#662859"
77697860,jfaziob,49,1,0,1,0.393683,0.64274,0,"#ff7007"
77734968,tresher2,49,1,0,1,0.338815,0.678388,0,"#ff7007"
77748386,ginniasa,21,0,3,3,0.325975,0.344106,0.000973,"#c6cc85"
77882600,Jazminmatic,49,1,0,1,0.303678,0.616602,0,"#ff7007"
78064536,mmerinoru,31,0,1,1,0.631108,0.526852,0,"#3e93ff"
78068951,undervivi,13,0,4,4,0.473655,0.532921,0.001459,"#3bec00"
78104190,cliotropic,13,1,4,5,0.422473,0.461297,0.001946,"#3bec00"
78119269,ttubio,3,0,1,1,0.471027,0.664988,0,"#ffb3ff"
78180420,elibro,13,1,0,1,0.367403,0.482214,0,"#3bec00"
78213334,6medina7,38,0,1,1,0.303337,0.167788,0,"#662859"
78236617,alimcamara,0,2,4,6,0.472049,0.574595,0.002432,"#8ecfec"
78249307,casamerica,22,1,0,1,0.601115,0.608437,0,"#00e8b2"
78318151,afhilipo,37,1,1,2,0.56102,0.381037,0.000486,"#006032"
78395672,aunapaloma,21,0,2,2,0.266529,0.240561,0.000486,"#c6cc85"
78421281,javiersanmartin,37,0,1,1,0.559732,0.47288,0,"#006032"
78422328,kauaguilar,36,0,1,1,0.465675,0.264932,0,"#825403"
78442404,bestqualitycrab,13,1,4,5,0.452412,0.463984,0.001946,"#3bec00"
78442816,inst_humboldt,38,1,0,1,0.539238,0.373859,0,"#662859"
78445689,Zirvita,14,0,1,1,0.485272,0.581716,0,"#00eeff"
78544627,digibis,15,8,8,16,0.504823,0.621011,0.007296,"#008ebb"
78653340,Liz_Dinicola,49,2,0,2,0.392651,0.569783,0.000486,"#ff7007"
78661031,msalguerb,13,0,1,1,0.308833,0.465988,0,"#3bec00"
78665678,alexmoga,15,0,2,2,0.638306,0.420082,0.000486,"#008ebb"
78694627,lawbraryan,15,0,3,3,0.507713,0.611906,0.000973,"#008ebb"
78716559,yesmorales,22,0,1,1,0.589047,0.618321,0,"#00e8b2"
78740555,guillermoacuna,49,2,0,2,0.348335,0.700035,0.000486,"#ff7007"
78782879,KaUnhapreta,36,0,1,1,0.621982,0.138599,0,"#825403"
78807273,Fabioki,3,0,1,1,0.479566,0.776657,0,"#ffb3ff"
78841292,BelenaVeleta,31,8,4,12,0.594002,0.542794,0.00535,"#3e93ff"
78887411,UniofHerts,34,2,4,6,0.491562,0.429069,0.002432,"#ff0d69"
78926575,bancodellibro,22,2,0,2,0.773185,0.471719,0.000486,"#00e8b2"
78929077,odraregblack,7,0,1,1,0.419282,0.360875,0,"#ffb800"
78941964,ordorika,13,2,0,2,0.425728,0.349845,0.000486,"#3bec00"
78950628,AlfonRoldan,19,1,0,1,0.642282,0.799978,0,"#00d3ff"
79023275,CarlosGarc1a,42,1,0,1,0.770694,0.433086,0,"#66e087"
79083076,movimiento13,42,0,1,1,0.913228,0.443369,0,"#66e087"
79138095,nogensmenys,1,0,1,1,0.36938,0.735197,0,"#b6cb00"
79238964,MuseuAstronomia,36,14,4,18,0.521215,0.324846,0.008268,"#825403"
79241363,fjlobof,0,0,1,1,0.428161,0.609177,0,"#8ecfec"
79241971,portal_ufsc,36,3,0,3,0.543083,0.299424,0.000973,"#825403"
79271706,matthewdlincoln,34,37,6,43,0.504793,0.480308,0.020428,"#ff0d69"
79285551,adoyma,19,1,0,1,0.632264,0.798089,0,"#00d3ff"
79299249,Europeanaeu,30,12,2,14,0.517589,0.610602,0.006323,"#ff77ff"
79478803,LaRazon__,49,2,0,2,0.435965,0.55372,0.000486,"#ff7007"
79483727,RadNalCo,38,1,0,1,0.586429,0.344058,0,"#662859"
79502575,hypatiabcn,8,0,1,1,0.274709,0.266746,0,"#00ed5d"
79513810,bryan_alcazar,38,0,1,1,0.300382,0.175237,0,"#662859"
79528658,delfinosauria,21,0,1,1,0.470093,0.952834,0,"#c6cc85"
79556841,FelipePigna,38,0,1,1,0.750372,0.461356,0,"#662859"
79558162,AlfonGuardia,2,0,1,1,0.653837,0.643207,0,"#ffa64e"
79570388,_carlosherrera,38,8,10,18,0.562128,0.457892,0.008268,"#662859"
79585327,NoticiasUno,38,1,0,1,0.54558,0.37231,0,"#662859"
79614887,IreneKarenina,38,0,1,1,0.270465,0.625042,0,"#662859"
79620076,moises_araujo13,49,0,1,1,0.48214,0.354431,0,"#ff7007"
79717192,monicalgalvao,48,0,1,1,0.196454,0.718034,0,"#ff7a78"
79749280,berrydm,13,8,0,8,0.497956,0.468615,0.003405,"#3bec00"
79766698,mingorance76,49,1,0,1,0.373582,0.637603,0,"#ff7007"
79818808,cosmoduende,13,0,1,1,0.546934,0.442273,0,"#3bec00"
79853446,Marmotaop,34,0,1,1,0.541016,0.336083,0,"#ff0d69"
79988143,OVTT,31,6,4,10,0.549813,0.521914,0.004377,"#3e93ff"
80064831,CanalOnceTV,13,1,0,1,0.311022,0.399155,0,"#3bec00"
80075722,sandrapmesar,38,0,1,1,0.600367,0.363373,0,"#662859"
80132573,aicsoluciones,37,0,2,2,0.448181,0.548216,0.000486,"#006032"
80134617,maria_marchant,4,0,1,1,0.697602,0.36929,0,"#f4c8cf"
80184487,littlenancypere,21,0,2,2,0.407357,0.461535,0.000486,"#c6cc85"
80206028,Carlosbreporta,42,3,2,5,0.792381,0.451196,0.001946,"#66e087"
80257989,anandadecarlos,0,0,2,2,0.648768,0.620126,0.000486,"#8ecfec"
80268981,ManjoExLibris,14,0,2,2,0.562221,0.521321,0.000486,"#00eeff"
80345828,heycookies,36,0,1,1,0.551356,0.24821,0,"#825403"
80386427,alexbrey,34,24,3,27,0.490303,0.470437,0.012646,"#ff0d69"
80403388,lapatriacom,9,3,0,3,0.596444,0.531317,0.000973,"#008f7b"
80408010,lacatedra,49,0,14,14,0.490721,0.554982,0.006323,"#ff7007"
80410883,Acircamargo,36,0,1,1,0.501355,0.270713,0,"#825403"
80434545,SoyLaClauchis,4,0,1,1,0.877152,0.239304,0,"#f4c8cf"
80458869,RiveraNat,49,1,0,1,0.351813,0.693451,0,"#ff7007"
80501934,cafe_con_pan,13,0,1,1,0.436453,0.334714,0,"#3bec00"
80586973,clavizart,21,0,2,2,0.23027,0.234781,0.000486,"#c6cc85"
80600561,Davidvalpo,49,1,0,1,0.326684,0.636699,0,"#ff7007"
80603909,ich_tat,34,0,4,4,0.429114,0.377514,0.001459,"#ff0d69"
80625094,albantacafe,13,2,0,2,0.446061,0.371519,0.000486,"#3bec00"
80625624,la_UPC,8,5,0,5,0.647591,0.361526,0.001946,"#00ed5d"
80631258,marcostaracido,22,0,1,1,0.666804,0.573722,0,"#00e8b2"
80650908,ufrnbr,36,2,0,2,0.469441,0.356799,0.000486,"#825403"
80657934,CarlitoS_lim,13,0,2,2,0.430029,0.229244,0.000486,"#3bec00"
80679836,anewlibrarian,13,0,1,1,0.370695,0.381136,0,"#3bec00"
80693383,molimari_01,42,0,1,1,0.746442,0.409736,0,"#66e087"
80726833,LeandroArndt,36,0,1,1,0.47029,0.268557,0,"#825403"
80763139,AVallecillo,14,0,3,3,0.509368,0.56434,0.000973,"#00eeff"
80807653,srosmu,30,29,15,44,0.523029,0.534531,0.020914,"#ff77ff"
80851544,silvinadasso,49,1,0,1,0.383805,0.646152,0,"#ff7007"
80858333,UniBonn,34,2,0,2,0.459986,0.475435,0.000486,"#ff0d69"
80871603,wcaleb,34,54,3,57,0.489731,0.471626,0.027237,"#ff0d69"
80878353,CEJOTABE,49,1,0,1,0.327713,0.614756,0,"#ff7007"
80949005,BarbaraACN_Cuba,43,0,1,1,0.719798,0.563077,0,"#fcae7e"
81001006,henrique_parra,36,0,2,2,0.536869,0.437317,0.000486,"#825403"
81002479,eco_onis,34,11,25,36,0.478118,0.477767,0.017023,"#ff0d69"
81077139,Alracava,40,0,1,1,0.646721,0.021256,0,"#ff12a3"
81081065,cronicaglobal,8,10,0,10,0.756793,0.221837,0.004377,"#00ed5d"
81114590,gfeippe,49,1,0,1,0.337302,0.660407,0,"#ff7007"
81140887,patricia_danae,21,0,1,1,0.318539,0.453525,0,"#c6cc85"
81151317,richiedf,13,0,2,2,0.45193,0.429236,0.000486,"#3bec00"
81172318,nmelendez21,49,1,0,1,0.334925,0.627286,0,"#ff7007"
81188489,josefxgames,22,0,2,2,0.634046,0.462037,0.000486,"#00e8b2"
81207171,liliapau,13,0,2,2,0.578693,0.380305,0.000486,"#3bec00"
81223482,AnnaCarolinie,48,0,1,1,0.206767,0.715782,0,"#ff7a78"
81378140,rathiankit,36,0,1,1,0.492501,0.348889,0,"#825403"
81657824,davidceront,37,1,1,2,0.504922,0.395443,0.000486,"#006032"
81699137,jzamorabonilla,30,1,0,1,0.699394,0.654249,0,"#ff77ff"
81702317,uvigo,14,11,0,11,0.52831,0.469695,0.004864,"#00eeff"
81811013,marseron,0,1,0,1,0.846276,0.442485,0,"#8ecfec"
81844118,multiformato,13,0,2,2,0.481339,0.380545,0.000486,"#3bec00"
81860183,educacyl,2,1,0,1,0.688437,0.360969,0,"#ffa64e"
81893387,cinvestav,30,4,0,4,0.488519,0.522116,0.001459,"#ff77ff"
81900697,ArcanoHistoria,13,0,1,1,0.397317,0.376763,0,"#3bec00"
81929909,LauraPLarraya,31,0,4,4,0.582231,0.496638,0.001459,"#3e93ff"
81986272,elsalvadorcom,49,2,0,2,0.404603,0.573906,0.000486,"#ff7007"
82055746,literatrero,58,0,2,2,0.635488,0.397417,0.000486,"#005076"
82089552,jsergiopaz,37,0,2,2,0.404301,0.470627,0.000486,"#006032"
82119937,lopezobrador_,17,2,0,2,0.711966,0.199185,0.000486,"#ff9cc7"
82154606,saturana,38,0,1,1,0.320297,0.175818,0,"#662859"
82347027,JCBLibrary,34,1,0,1,0.41907,0.352262,0,"#ff0d69"
82380256,silvia_cho,34,4,0,4,0.443012,0.378972,0.001459,"#ff0d69"
82409699,UAQmx,13,57,3,60,0.451457,0.429065,0.028696,"#3bec00"
82445131,MirianGarridoR,48,0,1,1,0.227236,0.703329,0,"#ff7a78"
82445181,llilasbenson,34,19,1,20,0.494827,0.47442,0.009241,"#ff0d69"
82462818,ja_santana,48,0,1,1,0.226354,0.709491,0,"#ff7a78"
82521761,Gitanagpa2,36,0,1,1,0.57677,0.296435,0,"#825403"
82591315,itzisvg,22,0,1,1,0.694977,0.531004,0,"#00e8b2"
82623959,mascarasangrada,13,0,1,1,0.382108,0.32343,0,"#3bec00"
82655077,FILMineria,13,12,0,12,0.422776,0.413059,0.00535,"#3bec00"
82662625,julioaguileraf,13,0,1,1,0.428166,0.503857,0,"#3bec00"
82722478,pvidria,34,0,2,2,0.45935,0.402466,0.000486,"#ff0d69"
82740371,Mauphelan,22,0,3,3,0.608354,0.384499,0.000973,"#00e8b2"
82780537,ereglz_linares,7,0,1,1,0.695981,0.313656,0,"#ffb800"
82821574,canalesa99,13,0,2,2,0.454709,0.377819,0.000486,"#3bec00"
82860809,SusanaValdez,36,1,2,3,0.714031,0.400241,0.000973,"#825403"
82889243,jairoamelo,13,143,113,256,0.503221,0.466438,0.124027,"#3bec00"
82908840,lletrA,14,2,0,2,0.590253,0.548933,0.000486,"#00eeff"
82927717,mcnoticias,49,1,0,1,0.386323,0.648208,0,"#ff7007"
82943362,chipimariana,7,0,1,1,0.400469,0.322835,0,"#ffb800"
82946408,jmcriado,0,0,1,1,0.848366,0.446573,0,"#8ecfec"
83012816,Tecpanero,4,0,1,1,0.846566,0.233228,0,"#f4c8cf"
83033519,ccgonella,31,0,2,2,0.574573,0.521424,0.000486,"#3e93ff"
83040775,bicho24mx,13,0,1,1,0.405472,0.486242,0,"#3bec00"
83045340,ibeleno,38,4,13,17,0.507495,0.445988,0.007782,"#662859"
83052847,FraternoDraconS,21,0,1,1,0.220422,0.201794,0,"#c6cc85"
83071062,Adeleurban,7,1,0,1,0.459869,0.229395,0,"#ffb800"
83128968,rojo_neon,7,0,2,2,0.620302,0.452026,0.000486,"#ffb800"
83129069,juanca028,49,0,5,5,0.449283,0.5724,0.001946,"#ff7007"
83180640,JuanSe_417,49,0,6,6,0.423794,0.476305,0.002432,"#ff7007"
83226268,Garatxa,22,0,1,1,0.623149,0.614606,0,"#00e8b2"
83320468,merchesan,15,0,5,5,0.503106,0.589743,0.001946,"#008ebb"
83324697,fernandocuenca,49,0,3,3,0.416046,0.536629,0.000973,"#ff7007"
83336185,fundacionupo,1,1,0,1,0.478159,0.589299,0,"#b6cb00"
83432957,emijrp,19,1,0,1,0.629852,0.782379,0,"#00d3ff"
83481693,romerocastellon,17,0,1,1,0.943545,0.367212,0,"#ff9cc7"
83513514,leiiviis,7,0,2,2,0.798863,0.607759,0.000486,"#ffb800"
83582126,acdelion,13,1,3,4,0.52626,0.416925,0.001459,"#3bec00"
83614813,ahfrog,13,0,1,1,0.512324,0.318466,0,"#3bec00"
83633934,samirestefan,38,1,0,1,0.690106,0.481297,0,"#662859"
83688947,carlos_hueza,3,0,1,1,0.525903,0.757918,0,"#ffb3ff"
83691246,IshCamargo,7,0,2,2,0.375361,0.374654,0.000486,"#ffb800"
83702986,carolnalin,36,1,0,1,0.486213,0.257202,0,"#825403"
83724058,diacaromu,38,0,1,1,0.129087,0.80804,0,"#662859"
83893557,Editorialunlp,49,1,0,1,0.392966,0.673221,0,"#ff7007"
83905125,Clauditabm,37,2,0,2,0.61409,0.375705,0.000486,"#006032"
83915056,Kalepsheel,40,0,1,1,0.650522,0.015859,0,"#ff12a3"
83940853,pucriooficial,36,3,0,3,0.510199,0.367743,0.000973,"#825403"
83950344,Mangematin,7,0,3,3,0.535314,0.48971,0.000973,"#ffb800"
83957611,Maluavi,49,1,0,1,0.339858,0.638221,0,"#ff7007"
83980988,AnaBSayago,38,0,1,1,0.665355,0.461196,0,"#662859"
83995049,LuisDeLaPeJ,38,1,5,6,0.597282,0.49385,0.002432,"#662859"
84031335,DeadFox_,0,0,1,1,0.29834,0.464921,0,"#8ecfec"
84045279,hexaflexagon,22,0,2,2,0.580554,0.626965,0.000486,"#00e8b2"
84094267,ufvmadrid,15,4,4,8,0.520739,0.5853,0.003405,"#008ebb"
84156832,gramelgar,49,0,7,7,0.561807,0.591527,0.002918,"#ff7007"
84157104,nicolausoares,36,0,1,1,0.478579,0.229313,0,"#825403"
84182192,raizzaketzali,13,0,1,1,0.49245,0.399553,0,"#3bec00"
84184917,licelectron,7,0,1,1,0.39742,0.351283,0,"#ffb800"
84189140,Curitero,42,0,3,3,0.72274,0.451648,0.000973,"#66e087"
84190427,Luiscrgoncalves,36,0,3,3,0.536515,0.407955,0.000973,"#825403"
84249568,AmazonKindle,55,2,0,2,0.561388,0.633883,0.000486,"#cb3f32"
84258886,UParisNanterre,15,1,0,1,0.55929,0.651668,0,"#008ebb"
84272746,eshowesp,49,1,0,1,0.363851,0.655285,0,"#ff7007"
84280773,Ricardo_AMASTE,22,1,0,1,0.657776,0.528516,0,"#00e8b2"
84309031,devuelta,14,0,3,3,0.652864,0.523372,0.000973,"#00eeff"
84327770,UConn,2,2,0,2,0.40832,0.502049,0.000486,"#ffa64e"
84331701,vokaribe,38,0,1,1,0.735331,0.322454,0,"#662859"
84351228,timberners_lee,30,3,0,3,0.475693,0.577448,0.000973,"#ff77ff"
84369409,rouefortune,13,0,3,3,0.543908,0.393095,0.000973,"#3bec00"
84408406,taniayamili,7,0,1,1,0.510089,0.179784,0,"#ffb800"
84411919,DiegoAngeles9,41,0,1,1,0.326645,0.39614,0,"#697b00"
84416422,lontrinhastark,36,0,1,1,0.584262,0.193526,0,"#825403"
84442872,MexicoUnete,13,0,1,1,0.497019,0.397562,0,"#3bec00"
84447018,MeLlamoEri,38,0,1,1,0.146199,0.804298,0,"#662859"
84564138,staldera,7,1,0,1,0.584248,0.526381,0,"#ffb800"
84589265,AvecesCalla,0,0,1,1,0.448173,0.339574,0,"#8ecfec"
84596845,ACLS1919,41,2,0,2,0.356099,0.432088,0.000486,"#697b00"
84613584,Pajaropolitico,34,1,0,1,0.632921,0.319735,0,"#ff0d69"
84630766,tonoperez,31,0,1,1,0.638024,0.512479,0,"#3e93ff"
84633183,AuryGarcia_,35,0,10,10,0.444401,0.503723,0.004377,"#00faff"
84675409,jujodiru,22,0,1,1,0.6983,0.473214,0,"#00e8b2"
84702117,AnaCorojan,37,2,4,6,0.563304,0.491724,0.002432,"#006032"
84706345,Catademar,40,0,1,1,0.565764,0.027102,0,"#ff12a3"
84707102,s_papastamkou,34,1,6,7,0.480416,0.452042,0.002918,"#ff0d69"
84735244,Pintomiraya,13,0,5,5,0.464243,0.473888,0.001946,"#3bec00"
84860294,RayS6,22,1,0,1,0.537631,0.650749,0,"#00e8b2"
84869916,Shxeila,3,0,1,1,0.444101,0.649002,0,"#ffb3ff"
84870006,GirlWithClaws,0,0,1,1,0.379015,0.566584,0,"#8ecfec"
84876128,minoaresendiz,14,0,1,1,0.335839,0.504541,0,"#00eeff"
84910342,slayerkinney,49,1,0,1,0.347997,0.663806,0,"#ff7007"
84974713,diegorojasajmad,14,0,2,2,0.65245,0.525988,0.000486,"#00eeff"
85000372,Josegabriel0214,13,0,1,1,0.390493,0.375456,0,"#3bec00"
85001358,PrensaULA,42,19,1,20,0.853759,0.435571,0.009241,"#66e087"
85067574,enriquetames,10,3,0,3,0.332372,0.464506,0.000973,"#52d7c0"
85123311,ANPOCS,36,1,0,1,0.538849,0.312408,0,"#825403"
85130724,saladeprensa,3,53,2,55,0.633872,0.649661,0.026265,"#ffb3ff"
85146736,Latindex,13,2,1,3,0.472726,0.400746,0.000973,"#3bec00"
85161462,OhhMar9933,34,0,2,2,0.482077,0.409502,0.000486,"#ff0d69"
85177452,BeirutMaria,38,0,1,1,0.16822,0.433341,0,"#662859"
85181312,Xantallavina,8,3,0,3,0.66651,0.288073,0.000973,"#00ed5d"
85191164,Thifariamelo,36,1,0,1,0.528468,0.226164,0,"#825403"
85224634,pkp,1,1,0,1,0.488069,0.784806,0,"#b6cb00"
85278192,iderioja,22,0,1,1,0.576161,0.622632,0,"#00e8b2"
85317774,jagg66,15,0,2,2,0.657726,0.436732,0.000486,"#008ebb"
85329789,RomaoSan,36,0,1,1,0.498931,0.184495,0,"#825403"
85343435,unicomplutense,30,66,0,66,0.551129,0.537649,0.031615,"#ff77ff"
85484364,hugopatrici0,30,0,2,2,0.588396,0.660069,0.000486,"#ff77ff"
85525534,lesandie,55,0,1,1,0.352232,0.540246,0,"#cb3f32"
85627317,interaccio,14,5,1,6,0.541704,0.463377,0.002432,"#00eeff"
85642167,_DobleInfinito,37,0,1,1,0.767509,0.502528,0,"#006032"
85645969,doeumlivro,36,3,0,3,0.416151,0.294669,0.000973,"#825403"
85683238,journalWebSem,14,4,0,4,0.559512,0.499323,0.001459,"#00eeff"
85686392,adarapzab,0,0,3,3,0.495138,0.538715,0.000973,"#8ecfec"
85735042,paolacsierra,38,0,2,2,0.593552,0.388285,0.000486,"#662859"
85788285,elcultural,15,8,0,8,0.498706,0.527115,0.003405,"#008ebb"
85812259,esMONDRAGON,18,8,1,9,0.639629,0.607576,0.003891,"#5456a6"
85837999,Zona_Seguridad,22,0,2,2,0.583598,0.5827,0.000486,"#00e8b2"
85846217,Fontevecchia,3,1,0,1,0.455065,0.676729,0,"#ffb3ff"
85847215,maggyontiveros,13,1,0,1,0.415234,0.298622,0,"#3bec00"
85935099,EFECANTON,18,0,3,3,0.416593,0.761275,0.000973,"#5456a6"
85950468,PazByC,13,0,2,2,0.395593,0.438586,0.000486,"#3bec00"
85970724,jaricoar,38,0,1,1,0.436805,0.765302,0,"#662859"
85975759,GTAveledo,42,0,3,3,0.676765,0.434884,0.000973,"#66e087"
86045463,david_escribano,30,0,1,1,0.487415,0.703164,0,"#ff77ff"
86114251,Escuelaing,3,1,1,2,0.82358,0.752334,0.000486,"#ffb3ff"
86126384,UNAM_FCPyS,13,7,1,8,0.495137,0.406548,0.003405,"#3bec00"
86177044,Airplume,22,0,3,3,0.567666,0.500831,0.000973,"#00e8b2"
86213208,TodoDocumentos,49,1,0,1,0.363315,0.610894,0,"#ff7007"
86328331,Pri_MBS,36,0,2,2,0.531027,0.438299,0.000486,"#825403"
86380901,adnauseam_,13,9,17,26,0.474306,0.500167,0.01216,"#3bec00"
86390214,Wikipedia,13,12,0,12,0.486094,0.476258,0.00535,"#3bec00"
86395643,ibconstant,36,0,1,1,0.501432,0.090583,0,"#825403"
86414158,Maribel_VO,7,0,2,2,0.414732,0.360178,0.000486,"#ffb800"
86470700,YURYRIVEROS,38,0,1,1,0.346851,0.163976,0,"#662859"
86529364,Arquivistica,36,3,0,3,0.525388,0.34695,0.000973,"#825403"
86550750,alejolo77,38,0,1,1,0.683659,0.463743,0,"#662859"
86585500,Cheivs,49,7,6,13,0.517574,0.480374,0.005837,"#ff7007"
86602749,alvarobianchi,36,1,0,1,0.491037,0.247443,0,"#825403"
86603388,MendezTavo,0,0,1,1,0.269011,0.494917,0,"#8ecfec"
86645014,aeochoap,34,0,1,1,0.556937,0.337628,0,"#ff0d69"
86670537,donjergo,0,0,1,1,0.430029,0.392127,0,"#8ecfec"
86677226,DoriamReyes,13,1,0,1,0.480567,0.384046,0,"#3bec00"
86731691,MichelQuiroz,8,0,1,1,0.268226,0.248927,0,"#00ed5d"
86764405,kashyapvyaas,34,0,1,1,0.348777,0.430546,0,"#ff0d69"
86779410,xarxatic,0,1,0,1,0.835182,0.447159,0,"#8ecfec"
86803346,HectorQuispe,3,0,1,1,0.681015,0.703498,0,"#ffb3ff"
86828323,estradalvaro,38,0,1,1,0.613887,0.359848,0,"#662859"
86853453,JulietaLionetti,14,0,2,2,0.54997,0.446552,0.000486,"#00eeff"
86861883,fzerboni,3,0,6,6,0.475554,0.62552,0.002432,"#ffb3ff"
86888056,rubenmatos,3,0,1,1,0.46438,0.660101,0,"#ffb3ff"
86912648,anaduermaier,13,0,1,1,0.408073,0.482071,0,"#3bec00"
86913960,miguelmcminn,22,0,1,1,0.666176,0.468177,0,"#00e8b2"
86928053,valeriaodetti,49,0,3,3,0.721361,0.753426,0.000973,"#ff7007"
86948149,anasuzina,36,1,1,2,0.509012,0.290659,0.000486,"#825403"
86969920,Becas_Hispanos,1,1,0,1,0.402292,0.528993,0,"#b6cb00"
87025783,luiscrh,34,1,0,1,0.495222,0.256934,0,"#ff0d69"
87068047,rocha_thais,36,2,2,4,0.51753,0.416442,0.001459,"#825403"
87081736,salvador_alc,7,0,2,2,0.410734,0.339526,0.000486,"#ffb800"
87084423,leorodriguezd,42,1,1,2,0.636846,0.467054,0.000486,"#66e087"
87103022,JesusMHerrera,49,1,0,1,0.396866,0.685113,0,"#ff7007"
87211544,SeeburgerNews,13,1,0,1,0.349874,0.29863,0,"#3bec00"
87263421,_Yosune,13,1,0,1,0.399296,0.313512,0,"#3bec00"
87267162,ATErickson,49,1,0,1,0.385028,0.529532,0,"#ff7007"
87270548,PaniToledo,1,0,2,2,0.486524,0.53085,0.000486,"#b6cb00"
87272789,mrockembach,49,7,3,10,0.511341,0.402258,0.004377,"#ff7007"
87405655,BalG_,14,0,3,3,0.52724,0.612997,0.000973,"#00eeff"
87408443,FECYT_Ciencia,30,3,1,4,0.533909,0.547872,0.001459,"#ff77ff"
87419607,dariorodighiero,14,1,0,1,0.598642,0.486661,0,"#00eeff"
87468422,SilviaPaillanC,21,0,1,1,0.184432,0.238696,0,"#c6cc85"
87470676,BibFMUL,36,1,0,1,0.56975,0.420862,0,"#825403"
87525642,daisysarita,21,0,1,1,0.203447,0.205913,0,"#c6cc85"
87589678,alexbeta2,38,0,2,2,0.453037,0.6344,0.000486,"#662859"
87592318,LatteSinLactosa,37,0,1,1,0.720032,0.274293,0,"#006032"
87606371,omartinezmore,38,0,1,1,0.293073,0.19404,0,"#662859"
87606674,nodexl,36,0,1,1,0.392693,0.315529,0,"#825403"
87664195,Nuevebits,38,1,1,2,0.711013,0.599727,0.000486,"#662859"
87678878,vigilanteinfo,49,1,0,1,0.364731,0.598209,0,"#ff7007"
87679406,listochao,1,0,1,1,0.470436,0.58253,0,"#b6cb00"
87685218,Ingmaurox,21,0,1,1,0.178256,0.232294,0,"#c6cc85"
87718453,suelifeliz,48,0,1,1,0.236161,0.734059,0,"#ff7a78"
87726517,mataderomadrid,58,4,2,6,0.551111,0.440289,0.002432,"#005076"
87748377,cejamercado,3,0,1,1,0.69586,0.717574,0,"#ffb3ff"
87781992,Ambientebogota,38,0,1,1,0.66524,0.368317,0,"#662859"
87853831,hildyta,7,0,1,1,0.409053,0.730218,0,"#ffb800"
87911262,evinki,8,0,1,1,0.247485,0.255419,0,"#00ed5d"
87913096,AdolfoUEX,30,0,2,2,0.590989,0.605956,0.000486,"#ff77ff"
87913253,ac_olite,22,0,1,1,0.321269,0.585583,0,"#00e8b2"
87917306,Corresponsables,22,1,1,2,0.632064,0.469832,0.000486,"#00e8b2"
87918200,jenniferisve,34,147,131,278,0.464509,0.48111,0.134728,"#ff0d69"
87920683,bernardosampa,14,1,1,2,0.64492,0.520078,0.000486,"#00eeff"
87952600,OrtaKev,49,2,0,2,0.410501,0.550717,0.000486,"#ff7007"
87967640,chaolinliu,36,0,7,7,0.470732,0.479819,0.002918,"#825403"
88008463,krespo_Valencia,17,0,1,1,0.943925,0.381956,0,"#ff9cc7"
88041518,pfernandezd,0,0,2,2,0.421382,0.564952,0.000486,"#8ecfec"
88050518,mcarigon,55,0,2,2,0.633002,0.652477,0.000486,"#cb3f32"
88095677,Purdom_L,13,1,15,16,0.460298,0.486142,0.007296,"#3bec00"
88123218,EdderGon8,17,0,1,1,0.831942,0.219175,0,"#ff9cc7"
88178223,jatenas,49,5,1,6,0.482113,0.553979,0.002432,"#ff7007"
88214618,luciadasilveira,31,1,1,2,0.585611,0.398111,0.000486,"#3e93ff"
88245882,iphes,30,1,0,1,0.584719,0.565839,0,"#ff77ff"
88259828,BAlmarazC,41,2,5,7,0.387436,0.34591,0.002918,"#697b00"
88312018,weareDAQ,0,0,5,5,0.429203,0.548973,0.001946,"#8ecfec"
88332362,_AMariela,13,1,3,4,0.468354,0.451585,0.001459,"#3bec00"
88341038,AlanConcepcion,49,0,3,3,0.438246,0.476876,0.000973,"#ff7007"
88344706,gestormundial,38,0,3,3,0.696813,0.54761,0.000973,"#662859"
88395586,AntonioDome,30,0,4,4,0.532638,0.581716,0.001459,"#ff77ff"
88483635,puc_sp,36,6,0,6,0.515195,0.334738,0.002432,"#825403"
88556672,teresasilvaRJ,36,0,1,1,0.511872,0.259568,0,"#825403"
88638894,EDUCAWEB,30,0,1,1,0.624075,0.56522,0,"#ff77ff"
88661857,Maqueveq,31,0,1,1,0.752365,0.920417,0,"#3e93ff"
88692033,bibliosalud,2,0,2,2,0.465031,0.647878,0.000486,"#ffa64e"
88692208,juanrodriguezm5,2,0,2,2,0.678008,0.505348,0.000486,"#ffa64e"
88694828,AgendaUnicamp,36,7,0,7,0.478381,0.29283,0.002918,"#825403"
88698010,betucap,13,0,2,2,0.459626,0.421463,0.000486,"#3bec00"
88699372,ivntres,22,0,9,9,0.601672,0.610427,0.003891,"#00e8b2"
88704310,juanfratic,58,0,2,2,0.511375,0.647431,0.000486,"#005076"
88708038,BiblioUValpo,49,0,2,2,0.378472,0.506057,0.000486,"#ff7007"
88730798,roambriz,13,2,1,3,0.442767,0.370207,0.000973,"#3bec00"
88787521,JorgePanchoaga,38,0,3,3,0.537443,0.395193,0.000973,"#662859"
88789823,consev,22,1,0,1,0.533817,0.674447,0,"#00e8b2"
88796380,felipe_mexico,13,0,11,11,0.450288,0.490555,0.004864,"#3bec00"
88944920,elioferser,1,0,1,1,0.493697,0.68544,0,"#b6cb00"
88954535,atlante83,31,2,0,2,0.538933,0.686914,0.000486,"#3e93ff"
89162993,calendaSHS,36,3,0,3,0.446609,0.516429,0.000973,"#825403"
89168573,ccupf,14,2,1,3,0.575261,0.567722,0.000973,"#00eeff"
89176279,issa_ave,38,2,3,5,0.56494,0.48086,0.001946,"#662859"
89191137,luminalia,49,1,0,1,0.375017,0.606983,0,"#ff7007"
89258666,fernando__lopez,49,76,41,117,0.463805,0.551719,0.05642,"#ff7007"
89279813,CarlosAntonioMZ,13,1,1,2,0.474255,0.370401,0.000486,"#3bec00"
89288671,whernandezch,21,0,1,1,0.150988,0.620527,0,"#c6cc85"
89307673,nataliapessoni,48,0,1,1,0.249953,0.718229,0,"#ff7a78"
89309417,UNIRIO_Oficial,36,6,0,6,0.46046,0.314926,0.002432,"#825403"
89312744,Literature_Geek,34,6,15,21,0.430813,0.483471,0.009728,"#ff0d69"
89318175,JaimeObregon,33,1,0,1,0.153343,0.624217,0,"#ff8c00"
89333649,le_chatcosmique,13,0,1,1,0.413617,0.382964,0,"#3bec00"
89421014,mentxuwiki,30,0,2,2,0.556184,0.640152,0.000486,"#ff77ff"
89423894,Scopeo_,31,0,1,1,0.646652,0.505092,0,"#3e93ff"
89452463,mmorresig,14,0,1,1,0.672073,0.498724,0,"#00eeff"
89472246,UPV,14,15,0,15,0.499094,0.59488,0.006809,"#00eeff"
89479750,GC_CUNY,34,3,0,3,0.455896,0.3665,0.000973,"#ff0d69"
89492611,Aulogelio,49,1,0,1,0.638316,0.666248,0,"#ff7007"
89496439,SilviPrado,0,0,1,1,0.378118,0.561677,0,"#8ecfec"
89520884,educashun,14,0,2,2,0.689822,0.557811,0.000486,"#00eeff"
89525927,citicresearch,14,10,3,13,0.495317,0.563054,0.005837,"#00eeff"
89579687,claucasariego,14,0,2,2,0.628011,0.524517,0.000486,"#00eeff"
89607377,julianjem,38,4,18,22,0.511147,0.439778,0.010214,"#662859"
89718182,eumanismo,30,41,78,119,0.489469,0.514448,0.057393,"#ff77ff"
89734947,boozrolf,17,0,1,1,0.626187,0.268455,0,"#ff9cc7"
89746885,JAngelLeon,42,12,4,16,0.67648,0.442962,0.007296,"#66e087"
89753976,de_cronopio,49,2,0,2,0.420573,0.535164,0.000486,"#ff7007"
89942672,ehaline,48,0,1,1,0.223279,0.723805,0,"#ff7a78"
89950111,sandrirena,38,0,1,1,0.311422,0.187702,0,"#662859"
89954550,foromemoria,19,1,0,1,0.636534,0.802367,0,"#00d3ff"
89964785,poetaguiral,37,0,1,1,0.69313,0.560015,0,"#006032"
89966230,psalaper,3,1,0,1,0.841533,0.738275,0,"#ffb3ff"
89980954,hiamet,31,0,2,2,0.609894,0.509867,0.000486,"#3e93ff"
90000018,frangp,14,0,6,6,0.489395,0.557303,0.002432,"#00eeff"
90066214,Netoli,15,0,1,1,0.493411,0.724578,0,"#008ebb"
90072965,Haviau,13,0,4,4,0.504823,0.437848,0.001459,"#3bec00"
90078644,VictoriaGarMor,37,0,2,2,0.256963,0.464333,0.000486,"#006032"
90110752,LaArchivista,38,0,1,1,0.599132,0.355925,0,"#662859"
90137659,aurora_al,31,0,1,1,0.580092,0.619826,0,"#3e93ff"
90203790,Marymm15,58,0,1,1,0.598928,0.172277,0,"#005076"
90233276,AMTAMMARO,49,1,0,1,0.383737,0.526183,0,"#ff7007"
90287380,ninnacarneiro,36,0,1,1,0.495695,0.279538,0,"#825403"
90324876,digitalmedieval,30,7,0,7,0.457072,0.586738,0.002918,"#ff77ff"
90330506,ASEIBI,37,2,1,3,0.611551,0.535464,0.000973,"#006032"
90364910,tic,8,6,0,6,0.606508,0.400601,0.002432,"#00ed5d"
90368674,UH_Humanities,34,0,2,2,0.458498,0.3899,0.000486,"#ff0d69"
90372642,nogares,1,0,1,1,0.366712,0.541827,0,"#b6cb00"
90387110,fesmcugtaragon,49,1,0,1,0.330215,0.681016,0,"#ff7007"
90419140,recardenas,21,0,1,1,0.02047,0.621907,0,"#c6cc85"
90474216,nadiaislas,1,0,2,2,0.638435,0.472856,0.000486,"#b6cb00"
90495916,anacabello,49,11,16,27,0.499333,0.583149,0.012646,"#ff7007"
90513743,AngelVicentin,22,0,1,1,0.577091,0.684054,0,"#00e8b2"
90541444,LaMarceCubi,21,1,0,1,0.226681,0.436219,0,"#c6cc85"
90549534,dhnow,36,51,0,51,0.46971,0.486397,0.024319,"#825403"
90569845,viktormed,30,0,1,1,0.592434,0.59321,0,"#ff77ff"
90598880,fundacioncd,49,10,4,14,0.540049,0.542511,0.006323,"#ff7007"
90661080,vitoeps,31,2,4,6,0.611637,0.542163,0.002432,"#3e93ff"
90670192,obffelius,15,1,0,1,0.745661,0.560065,0,"#008ebb"
90674648,IBERO_mx,13,10,0,10,0.475661,0.399816,0.004377,"#3bec00"
90725961,ElSaltoDiario,38,1,0,1,0.73135,0.454282,0,"#662859"
90749356,talvezeunude,36,0,1,1,0.484071,0.305439,0,"#825403"
90751238,alcentrosevilla,49,1,0,1,0.328948,0.606591,0,"#ff7007"
90780470,carlosalvarezji,8,0,1,1,0.257577,0.259562,0,"#00ed5d"
90782817,phpacha,36,0,1,1,0.535052,0.286759,0,"#825403"
90810188,melusan,49,1,0,1,0.350135,0.648144,0,"#ff7007"
90828164,hypothesesorg,22,25,1,26,0.56076,0.512662,0.01216,"#00e8b2"
90866211,schreib100,36,1,1,2,0.409052,0.555137,0.000486,"#825403"
90878064,ferialibro,49,2,0,2,0.39482,0.562649,0.000486,"#ff7007"
90950560,agumiglio,3,3,6,9,0.470807,0.601206,0.003891,"#ffb3ff"
90984390,gibesco,1,0,1,1,0.318054,0.752899,0,"#b6cb00"
90985260,CarlosPC_Mx,17,0,2,2,0.561267,0.390334,0.000486,"#ff9cc7"
91103479,ramirociencia,49,1,0,1,0.362624,0.704553,0,"#ff7007"
91106214,marcosgcm,3,3,0,3,0.530299,0.56955,0.000973,"#ffb3ff"
91106767,Riclargo,49,1,0,1,0.401382,0.670666,0,"#ff7007"
91142698,jdc1983,38,0,1,1,0.6671,0.628659,0,"#662859"
91202669,kristeniemma,49,0,1,1,0.391342,0.416231,0,"#ff7007"
91231212,Victoriaviti,13,1,0,1,0.588093,0.429719,0,"#3bec00"
91312791,UniVerona,14,2,0,2,0.531237,0.573581,0.000486,"#00eeff"
91382195,Univ_Villanueva,22,2,2,4,0.624796,0.50728,0.001459,"#00e8b2"
91438333,elotroalex,13,110,36,146,0.455358,0.472755,0.070525,"#3bec00"
91450120,Espespots,37,0,1,1,0.701656,0.496861,0,"#006032"
91493851,JJIbarias,13,0,2,2,0.486294,0.389139,0.000486,"#3bec00"
91505941,DUV4N,38,0,2,2,0.615696,0.393648,0.000486,"#662859"
91511905,UAntwerpen,30,9,0,9,0.511277,0.570616,0.003891,"#ff77ff"
91567677,crisiscrisis_,37,1,0,1,0.568624,0.374912,0,"#006032"
91597376,eugeniohv,34,0,1,1,0.562562,0.34046,0,"#ff0d69"
91601683,mapisaro,38,1,20,21,0.590109,0.465288,0.009728,"#662859"
91609020,AndyStalman,49,1,0,1,0.397836,0.662137,0,"#ff7007"
91612785,jhergony,49,2,2,4,0.287768,0.628613,0.001459,"#ff7007"
91616458,HASTACscholars,41,1,0,1,0.359933,0.396423,0,"#697b00"
91627591,mizzi_schnyder,36,0,1,1,0.421087,0.586109,0,"#825403"
91668864,JavReb,17,0,1,1,0.811819,0.223337,0,"#ff9cc7"
91695075,octavioarbelaez,9,1,4,5,0.5982,0.542617,0.001946,"#008f7b"
91708013,Gstnsalvov,13,0,1,1,0.440382,0.305319,0,"#3bec00"
91720727,rggja,7,0,3,3,0.435111,0.616549,0.000973,"#ffb800"
91839908,solo_constancia,30,0,1,1,0.627491,0.479618,0,"#ff77ff"
91872067,histleg,30,1,2,3,0.556185,0.535648,0.000973,"#ff77ff"
91889703,mcarabali,31,0,1,1,0.714793,0.481971,0,"#3e93ff"
91927275,DayofDH,30,221,64,285,0.512087,0.502708,0.138132,"#ff77ff"
91933744,pedlemus,38,1,0,1,0.134373,0.816877,0,"#662859"
91962092,editum,38,1,0,1,0.721189,0.587597,0,"#662859"
91969667,pgdiaz_,0,0,1,1,0.431071,0.389577,0,"#8ecfec"
92014786,aleixvalls,8,5,0,5,0.651358,0.328936,0.001946,"#00ed5d"
92036022,esbaluardmuseu,31,1,0,1,0.646963,0.489405,0,"#3e93ff"
92101991,txemavalenzuela,0,0,1,1,0.393306,0.558559,0,"#8ecfec"
92127390,susanaoviedo,3,0,1,1,0.694353,0.707794,0,"#ffb3ff"
92231255,rosabelUA,31,1,3,4,0.572743,0.536864,0.001459,"#3e93ff"
92249250,UribeX,22,0,1,1,0.511706,0.664567,0,"#00e8b2"
92263542,elearningcesga,55,7,3,10,0.422743,0.54594,0.004377,"#cb3f32"
92303165,SaraAlvGom,2,0,1,1,0.754001,0.523612,0,"#ffa64e"
92309335,TrilceNavarrete,49,1,0,1,0.326413,0.598941,0,"#ff7007"
92329445,SinServilismos,37,0,1,1,0.53603,0.755779,0,"#006032"
92331865,santiperezisasi,14,22,67,89,0.503816,0.519325,0.042802,"#00eeff"
92381471,jburnford,34,20,0,20,0.498669,0.447852,0.009241,"#ff0d69"
92395503,LewisMcCaine,49,1,0,1,0.354083,0.624643,0,"#ff7007"
92415862,BrunaHusky,15,3,0,3,0.550833,0.672141,0.000973,"#008ebb"
92443514,SamVGatica,7,0,8,8,0.487841,0.461483,0.003405,"#ffb800"
92502631,EducaAndInnova,31,1,0,1,0.627024,0.483273,0,"#3e93ff"
92504832,pa_stokes,14,0,2,2,0.567503,0.49672,0.000486,"#00eeff"
92536561,RedAcademica,38,3,2,5,0.609303,0.419695,0.001946,"#662859"
92557356,andonicarrion,31,0,2,2,0.717734,0.534025,0.000486,"#3e93ff"
92557751,anamartagg,30,0,2,2,0.635161,0.677377,0.000486,"#ff77ff"
92611193,SabrinaAlmGer,13,0,3,3,0.440662,0.420467,0.000973,"#3bec00"
92630324,elpezflaco,13,6,13,19,0.463439,0.481469,0.008755,"#3bec00"
92634871,ivonnelujano,49,23,13,36,0.456258,0.485519,0.017023,"#ff7007"
92644495,conal_tuohy,36,1,0,1,0.502203,0.334395,0,"#825403"
92648267,soyfelipe,13,1,2,3,0.417757,0.441201,0.000973,"#3bec00"
92685946,Valtus87,7,0,2,2,0.402717,0.333376,0.000486,"#ffb800"
92741956,idelavega,30,0,1,1,0.572658,0.475708,0,"#ff77ff"
92748843,joseluisserrano,31,0,1,1,0.633106,0.500765,0,"#3e93ff"
92843563,ticerun,3,0,3,3,0.444083,0.605848,0.000973,"#ffb3ff"
92871031,ComercioTotal,42,0,1,1,0.781343,0.364387,0,"#66e087"
92974918,SandraGaelGo,31,0,1,1,0.764675,0.92616,0,"#3e93ff"
93000629,IlzianeLaune,36,2,2,4,0.517796,0.381424,0.001459,"#825403"
93021235,udp_cl,49,6,2,8,0.416468,0.475524,0.003405,"#ff7007"
93031847,Humanidades_Uch,56,1,0,1,0.366936,0.095108,0,"#384205"
93054093,morganmim,7,0,1,1,0.387903,0.299743,0,"#ffb800"
93074055,UAOCEU,22,2,2,4,0.816896,0.713968,0.001459,"#00e8b2"
93221940,Mopsos1,30,1,12,13,0.524437,0.55473,0.005837,"#ff77ff"
93247565,vgportal,36,2,2,4,0.448295,0.457453,0.001459,"#825403"
93279612,ale_camors,22,0,1,1,0.565646,0.68472,0,"#00e8b2"
93320991,Olafo72,0,0,1,1,0.413599,0.593906,0,"#8ecfec"
93321575,timote0w,3,0,1,1,0.494136,0.77346,0,"#ffb3ff"
93363172,felixtuesta,0,0,4,4,0.364178,0.528572,0.001459,"#8ecfec"
93490528,claudia_cbs,36,0,1,1,0.504975,0.33496,0,"#825403"
93578999,tihui,13,2,6,8,0.465394,0.44603,0.003405,"#3bec00"
93655583,filarramendi,15,41,21,62,0.51251,0.594581,0.029669,"#008ebb"
93680698,VSCLS,13,1,0,1,0.41693,0.411299,0,"#3bec00"
93694982,GeekGarage,7,0,2,2,0.520375,0.437759,0.000486,"#ffb800"
93729259,Paitokito,22,0,1,1,0.67925,0.57315,0,"#00e8b2"
93735450,BURSofia,30,19,21,40,0.502305,0.567008,0.018969,"#ff77ff"
93763693,En1ra_Persona,7,0,1,1,0.836611,0.542003,0,"#ffb800"
93879259,LoreIsab3l,21,0,1,1,0.174375,0.216526,0,"#c6cc85"
93901769,UAEM_MX,41,14,0,14,0.363642,0.350619,0.006323,"#697b00"
93913274,RL_UK,14,1,0,1,0.578522,0.477621,0,"#00eeff"
93920250,vjuliao,36,0,1,1,0.576284,0.293861,0,"#825403"
93972404,LarissaCrespoMx,7,0,4,4,0.502088,0.417162,0.001459,"#ffb800"
94000473,pedrocantue,7,0,1,1,0.798094,0.314111,0,"#ffb800"
94034938,e_duco,31,1,3,4,0.515234,0.546886,0.001459,"#3e93ff"
94050446,NicksNames,31,0,7,7,0.578791,0.511204,0.002918,"#3e93ff"
94112527,upbcolombia,22,0,1,1,0.66532,0.385251,0,"#00e8b2"
94114407,kosmopolisCCCB,0,4,0,4,0.703321,0.604986,0.001459,"#8ecfec"
94117217,NuVallejo,31,0,1,1,0.531708,0.694042,0,"#3e93ff"
94120111,PrimaEstrategia,7,0,2,2,0.407993,0.362682,0.000486,"#ffb800"
94130850,ljsimonb,3,2,2,4,0.450947,0.562832,0.001459,"#ffb3ff"
94131301,EHESS_fr,35,6,0,6,0.523993,0.468339,0.002432,"#00faff"
94181981,irlandaalvarez,3,0,2,2,0.636781,0.56796,0.000486,"#ffb3ff"
94186594,chinoup,36,0,3,3,0.468958,0.435711,0.000973,"#825403"
94226347,ActiveHist,38,1,0,1,0.551274,0.378066,0,"#662859"
94261637,Georges_Cabrera,49,1,0,1,0.357436,0.641115,0,"#ff7007"
94265190,FES_ACATLAN,13,24,0,24,0.452694,0.442785,0.011187,"#3bec00"
94287024,bufetalmeida,22,1,0,1,0.505698,0.683571,0,"#00e8b2"
94409074,Francirosy,36,2,0,2,0.50892,0.352885,0.000486,"#825403"
94411552,3duard0rivera,13,0,7,7,0.449948,0.437751,0.002918,"#3bec00"
94429051,rariasg,49,1,0,1,0.319653,0.627212,0,"#ff7007"
94487995,elinaresc,37,1,0,1,0.457326,0.289103,0,"#006032"
94489422,_thatri,7,0,2,2,0.421699,0.353306,0.000486,"#ffb800"
94570957,facundosuenzo,13,0,1,1,0.641988,0.996792,0,"#3bec00"
94589006,saroide,37,0,1,1,0.778151,0.479165,0,"#006032"
94603759,Gerrycondi,17,0,1,1,0.826777,0.250339,0,"#ff9cc7"
94637919,aguilandrea,49,0,4,4,0.428113,0.461718,0.001459,"#ff7007"
94688095,morgaine2000,31,0,1,1,0.750164,0.913652,0,"#3e93ff"
94707569,LaPapaEsPop,36,0,1,1,0.461617,0.221944,0,"#825403"
94736382,estonoescierto,38,1,0,1,0.120213,0.823402,0,"#662859"
94742869,mabcags,14,0,1,1,0.674965,0.523468,0,"#00eeff"
94803477,carescano,31,5,1,6,0.702117,0.462692,0.002432,"#3e93ff"
94812639,ggarcialutz,1,1,1,2,0.501955,0.684425,0.000486,"#b6cb00"
94852689,teorm11,34,0,1,1,0.532903,0.342779,0,"#ff0d69"
94861184,LangForCareers,34,0,2,2,0.454352,0.227043,0.000486,"#ff0d69"
95039432,cepmalaga,0,2,5,7,0.872176,0.376245,0.002918,"#8ecfec"
95057086,AFFICForense,34,0,1,1,0.552101,0.342035,0,"#ff0d69"
95064159,luciafwx,36,0,3,3,0.469765,0.212565,0.000973,"#825403"
95106703,josegalvanh,13,0,1,1,0.418663,0.43329,0,"#3bec00"
95177547,adsuara,22,1,0,1,0.56285,0.642258,0,"#00e8b2"
95210070,CasasSilviaS,3,0,4,4,0.537156,0.575178,0.001459,"#ffb3ff"
95220409,alepoulos,49,6,1,7,0.70856,0.792707,0.002918,"#ff7007"
95238467,AntonioHLobo,2,1,1,2,0.638321,0.656534,0.000486,"#ffa64e"
95331276,odessler,21,0,2,2,0.285107,0.240189,0.000486,"#c6cc85"
95433165,AATSPglobal,13,11,0,11,0.503533,0.46963,0.004864,"#3bec00"
95446652,Karisma,38,9,0,9,0.556298,0.448504,0.003891,"#662859"
95486714,BabaOBarrett,13,1,0,1,0.467723,0.397904,0,"#3bec00"
95495919,GinnySilvaY,13,0,1,1,0.387967,0.335407,0,"#3bec00"
95507710,leonautajujuy,30,2,2,4,0.464859,0.616345,0.001459,"#ff77ff"
95635791,meigaglg,14,1,1,2,0.577135,0.716809,0.000486,"#00eeff"
95654761,BibliotecaNalCo,38,225,62,287,0.56579,0.417908,0.139105,"#662859"
95674971,presscambrabcn,22,0,1,1,0.791274,0.520375,0,"#00e8b2"
95800431,rg13consultores,49,1,0,1,0.370964,0.652363,0,"#ff7007"
95852581,Teacher_Orlando,36,3,0,3,0.544102,0.331048,0.000973,"#825403"
95947579,J_A_Serrano,30,0,2,2,0.535912,0.632867,0.000486,"#ff77ff"
95957303,pedrograsa,10,0,1,1,0.334579,0.574771,0,"#52d7c0"
96104794,Leon_Fran_,22,0,2,2,0.639505,0.618157,0.000486,"#00e8b2"
96147674,Lifeceline,3,1,0,1,0.621244,0.573196,0,"#ffb3ff"
96176261,Fundly,8,1,0,1,0.586633,0.35117,0,"#00ed5d"
96180483,pao_lin,49,0,1,1,0.196172,0.543047,0,"#ff7007"
96188622,vazquezbrust,37,1,2,3,0.278123,0.460766,0.000973,"#006032"
96312462,maurotov,38,7,2,9,0.526539,0.554637,0.003891,"#662859"
96313526,Esta_Idiota,7,0,2,2,0.431895,0.360769,0.000486,"#ffb800"
96336504,W_E_F3,14,0,1,1,0.268814,0.576267,0,"#00eeff"
96392139,akuestas,14,0,7,7,0.547151,0.512703,0.002918,"#00eeff"
96395749,ei_sev,14,1,0,1,0.617813,0.49193,0,"#00eeff"
96422773,nohemilugo,3,0,1,1,0.454109,0.662162,0,"#ffb3ff"
96591764,Erick_Aguirre,13,0,2,2,0.493957,0.387339,0.000486,"#3bec00"
96620979,pleon1311,21,0,1,1,0.018709,0.637222,0,"#c6cc85"
96627140,RPallol,19,2,0,2,0.62805,0.758842,0.000486,"#00d3ff"
96683447,mvaldeb,21,4,1,5,0.354397,0.428083,0.001946,"#c6cc85"
96730899,eusebiocordoba,31,1,2,3,0.589102,0.502112,0.000973,"#3e93ff"
96813709,ecosurmx,17,0,1,1,0.620731,0.27784,0,"#ff9cc7"
96837167,robinson_ma,36,0,5,5,0.554215,0.274356,0.001946,"#825403"
96851655,TheGuadalupe,34,0,1,1,0.338593,0.399856,0,"#ff0d69"
96885393,pizzeriapanucci,35,0,1,1,0.571676,0.265196,0,"#00faff"
96953655,Filoinfosofia,31,1,0,1,0.705091,0.423354,0,"#3e93ff"
96958540,ArmandoCamejoR,0,0,1,1,0.429538,0.613737,0,"#8ecfec"
96963417,bibliotecaceu,49,1,0,1,0.436033,0.664637,0,"#ff7007"
97007360,Rasloc87,22,0,1,1,0.625073,0.618848,0,"#00e8b2"
97033997,nardineosman,14,1,1,2,0.534171,0.474901,0.000486,"#00eeff"
97035376,ocrumoy,37,1,1,2,0.482195,0.475936,0.000486,"#006032"
97040396,cordimoni,2,2,0,2,0.457537,0.531557,0.000486,"#ffa64e"
97075570,urielcast,36,0,9,9,0.526079,0.463661,0.003891,"#825403"
97113902,carsan12,30,11,9,20,0.554147,0.613838,0.009241,"#ff77ff"
97129377,cesarmex87,3,0,3,3,0.464383,0.589123,0.000973,"#ffb3ff"
97257206,cuau_cruz,37,3,5,8,0.480578,0.303444,0.003405,"#006032"
97260223,sisibuchile,49,12,3,15,0.419303,0.43742,0.006809,"#ff7007"
97308802,moredestructive,7,0,1,1,0.399842,0.344771,0,"#ffb800"
97385725,Temistogenes,1,0,1,1,0.414738,0.618204,0,"#b6cb00"
97405431,ediazsan,1,1,14,15,0.520418,0.56044,0.006809,"#b6cb00"
97419198,BBVAPrensa,22,0,1,1,0.648053,0.461089,0,"#00e8b2"
97435634,incasaimoveis,49,1,0,1,0.427408,0.676713,0,"#ff7007"
97475853,hectorfro,42,0,1,1,0.84319,0.424035,0,"#66e087"
97478162,camipetrucci,38,0,1,1,0.614672,0.357839,0,"#662859"
97523001,Pedro_Rojo,30,0,1,1,0.479785,0.638698,0,"#ff77ff"
97591901,nombreimpropio,14,4,14,18,0.52812,0.543505,0.008268,"#00eeff"
97619390,LauraDonadeo,22,0,3,3,0.559606,0.572278,0.000973,"#00e8b2"
97640657,UniversidadVIU,31,2,1,3,0.575584,0.340244,0.000973,"#3e93ff"
97662573,PublicacionesUH,37,0,1,1,0.538117,0.199932,0,"#006032"
97693385,AlexisElegante,34,0,1,1,0.474896,0.257394,0,"#ff0d69"
97733682,MaribelBarrante,22,0,2,2,0.203225,0.572133,0.000486,"#00e8b2"
97883387,LluisAgusti,22,4,5,9,0.571568,0.583286,0.003891,"#00e8b2"
97918863,dflp1961,7,0,1,1,0.637543,0.376043,0,"#ffb800"
97924773,merytortiz,49,1,0,1,0.347826,0.640757,0,"#ff7007"
97974188,diegoiturriaga,14,0,1,1,0.401339,0.591614,0,"#00eeff"
97976497,gabzaffari,36,1,0,1,0.522239,0.275474,0,"#825403"
98105537,losdarling_ella,31,0,2,2,0.725515,0.463809,0.000486,"#3e93ff"
98150840,NandreaBeltran,38,0,1,1,0.331268,0.196439,0,"#662859"
98256630,MinistroCiencia,49,0,1,1,0.343111,0.561617,0,"#ff7007"
98419412,Ade1a,13,0,3,3,0.452083,0.45428,0.000973,"#3bec00"
98489292,Sr_Kraken,13,0,1,1,0.35869,0.514045,0,"#3bec00"
98620063,NicoLillo,34,1,0,1,0.487711,0.255185,0,"#ff0d69"
98636576,ULL,14,21,7,28,0.579811,0.631787,0.013132,"#00eeff"
98660192,cbamadrid,37,60,24,84,0.603128,0.50141,0.04037,"#006032"
98683765,doliveira__,36,0,2,2,0.472039,0.166601,0.000486,"#825403"
98686854,PabloEnVocativo,58,0,2,2,0.471959,0.625081,0.000486,"#005076"
98701846,ravellom,14,0,2,2,0.628757,0.507529,0.000486,"#00eeff"
98758699,anaraietparvar,36,2,0,2,0.480898,0.332227,0.000486,"#825403"
98767274,JESEGURAD,37,0,1,1,0.447971,0.210864,0,"#006032"
98882777,flunal,22,0,3,3,0.615811,0.512048,0.000973,"#00e8b2"
98890966,jenterysayers,31,1,2,3,0.526112,0.49794,0.000973,"#3e93ff"
98922593,GaleriaBS,42,0,2,2,0.689261,0.439195,0.000486,"#66e087"
98980568,mariusexfluvio,30,0,2,2,0.304681,0.580038,0.000486,"#ff77ff"
99009128,InstitutoConex,36,2,0,2,0.464348,0.332439,0.000486,"#825403"
99009530,lulyta64,3,0,1,1,0.696659,0.696369,0,"#ffb3ff"
99096555,lourdesepstein,2,0,4,4,0.56479,0.458323,0.001459,"#ffa64e"
99256505,repisogurru,31,1,1,2,0.647553,0.54355,0.000486,"#3e93ff"
99347779,YaNiPaper,13,0,2,2,0.481138,0.426404,0.000486,"#3bec00"
99360296,guerrerolunaa,31,0,1,1,0.601799,0.475811,0,"#3e93ff"
99404278,emmanuelrazog,0,0,1,1,0.378597,0.57091,0,"#8ecfec"
99532337,mariposatuitera,35,0,1,1,0.580525,0.272283,0,"#00faff"
99546039,CARLITIOX,13,0,1,1,0.434407,0.40251,0,"#3bec00"
99654720,garevaloz,49,2,0,2,0.410125,0.553972,0.000486,"#ff7007"
99666495,Bound_Variable,13,0,2,2,0.466102,0.384198,0.000486,"#3bec00"
99694266,MarcelaEsnaola,39,0,2,2,0.589281,0.649175,0.000486,"#ff77f7"
99707590,mezgravis,22,3,7,10,0.562902,0.488516,0.004377,"#00e8b2"
99858669,eraimundez,0,0,1,1,0.374886,0.543528,0,"#8ecfec"
99869536,DANNIELLA14,34,0,6,6,0.475854,0.454425,0.002432,"#ff0d69"
99947070,hbenja_m,49,0,2,2,0.435188,0.523101,0.000486,"#ff7007"
99959293,PaulaSarovic,21,0,2,2,0.377283,0.40147,0.000486,"#c6cc85"
100030951,xjuaanx,7,0,1,1,0.376845,0.294939,0,"#ffb800"
100033765,perroroque,14,0,4,4,0.615966,0.523256,0.001459,"#00eeff"
100070760,rocioserna__,58,9,0,9,0.525218,0.587235,0.003891,"#005076"
100073878,Gibranazoo,13,0,1,1,0.367114,0.309534,0,"#3bec00"
100080235,miquelporta,14,0,2,2,0.601473,0.567026,0.000486,"#00eeff"
100113862,javiercha,49,2,0,2,0.407314,0.385375,0.000486,"#ff7007"
100118307,Lalysds,49,0,33,33,0.45912,0.541122,0.015564,"#ff7007"
100128774,ma_isabelac,21,0,3,3,0.264067,0.277717,0.000973,"#c6cc85"
100134181,thaisgarbel,3,0,1,1,0.698332,0.701046,0,"#ffb3ff"
100216557,yanella256,21,0,1,1,0.203323,0.244727,0,"#c6cc85"
100236692,tinortiz,3,0,1,1,0.687697,0.701278,0,"#ffb3ff"
100252669,oscuriosa,49,0,30,30,0.506344,0.515725,0.014105,"#ff7007"
100260538,3thinkerEduc,14,0,2,2,0.430849,0.53224,0.000486,"#00eeff"
100262416,quellegeixes,15,0,2,2,0.604736,0.50553,0.000486,"#008ebb"
100291556,textualizada,22,0,1,1,0.517555,0.671703,0,"#00e8b2"
100338317,NataliaFL,49,0,3,3,0.726008,0.757222,0.000973,"#ff7007"
100367603,Mediterraneo76,13,0,1,1,0.450075,0.405086,0,"#3bec00"
100369418,arixha,14,0,1,1,0.680495,0.516924,0,"#00eeff"
100404934,Le_Gabicci,10,0,1,1,0.663828,0.804098,0,"#52d7c0"
100440332,leeres,49,15,2,17,0.430725,0.595915,0.007782,"#ff7007"
100512579,_BrasilNews,36,0,1,1,0.378351,0.235049,0,"#825403"
100533939,gastonbecerra,49,8,8,16,0.355535,0.497732,0.007296,"#ff7007"
100575652,marthapuca,7,0,1,1,0.416639,0.208599,0,"#ffb800"
100592931,Danieldazaprado,49,5,9,14,0.411192,0.540446,0.006323,"#ff7007"
100651865,Kendy_Mar,49,1,0,1,0.392798,0.650398,0,"#ff7007"
100682150,telecomymedios,7,0,1,1,0.395647,0.737244,0,"#ffb800"
100722312,deunacarretero,14,0,2,2,0.630035,0.53107,0.000486,"#00eeff"
100786314,BibliotecasMed,38,0,2,2,0.265122,0.497055,0.000486,"#662859"
100899292,veracruz777,58,0,1,1,0.5783,0.186534,0,"#005076"
101117378,luzzavala_29,7,0,1,1,0.784159,0.586949,0,"#ffb800"
101120777,Sephys00,38,0,1,1,0.805454,0.638784,0,"#662859"
101129558,nesdaniel,41,0,4,4,0.412327,0.477199,0.001459,"#697b00"
101227770,Paloma_Ausin,49,2,0,2,0.399533,0.57564,0.000486,"#ff7007"
101248441,pephernandez,58,0,2,2,0.518999,0.650481,0.000486,"#005076"
101291889,firulaicia,38,0,1,1,0.311893,0.165835,0,"#662859"
101303555,alfredovelazco,49,0,2,2,0.445446,0.563078,0.000486,"#ff7007"
101306114,juancpulidom,42,0,2,2,0.691329,0.43093,0.000486,"#66e087"
101319424,DIANA_VAL,38,0,10,10,0.46069,0.40772,0.004377,"#662859"
101378478,GoConqr,30,1,0,1,0.756603,0.720906,0,"#ff77ff"
101390245,clzantos,31,0,1,1,0.651458,0.508246,0,"#3e93ff"
101572491,caracola7mares,4,0,1,1,0.854695,0.248984,0,"#f4c8cf"
101573781,homero_hinojosa,38,1,2,3,0.572119,0.598438,0.000973,"#662859"
101741237,perurealfonso,14,0,1,1,0.650613,0.59695,0,"#00eeff"
101755795,GerhardLauer,36,1,0,1,0.43241,0.295124,0,"#825403"
101816944,LenguadeTrapo,40,0,2,2,0.078488,0.404424,0.000486,"#ff12a3"
101826976,Mertrak,0,6,10,16,0.374519,0.564618,0.007296,"#8ecfec"
101828980,checocruz,49,0,1,1,0.386521,0.487925,0,"#ff7007"
101876990,criveragarza,41,1,1,2,0.30633,0.336854,0.000486,"#697b00"
101881914,raypadilla1,10,6,2,8,0.386521,0.317165,0.003405,"#52d7c0"
101890021,MartaBeatrize,21,0,1,1,0.189348,0.217565,0,"#c6cc85"
101895548,meigul,49,4,1,5,0.446518,0.603984,0.001946,"#ff7007"
102037500,DaveJSayers,30,0,1,1,0.602837,0.451212,0,"#ff77ff"
102090423,gmomillan,13,0,1,1,0.476346,0.395958,0,"#3bec00"
102096126,Lexvivanco,21,0,1,1,0.230483,0.220338,0,"#c6cc85"
102142180,limonjuridico,7,0,2,2,0.396193,0.363066,0.000486,"#ffb800"
102148729,DiegoPuente_V,14,0,3,3,0.490563,0.403178,0.000973,"#00eeff"
102181447,markornelas,49,0,1,1,0.298813,0.491439,0,"#ff7007"
102206860,RadioUNAM,7,6,1,7,0.41369,0.319527,0.002918,"#ffb800"
102272704,gestionpublicav,8,0,1,1,0.251442,0.254546,0,"#00ed5d"
102307440,darinin,13,0,1,1,0.365801,0.536833,0,"#3bec00"
102444623,chayo_sotelo,41,0,2,2,0.350471,0.387494,0.000486,"#697b00"
102472037,juanccolomer,31,0,2,2,0.606007,0.491296,0.000486,"#3e93ff"
102481444,amdvfa,22,0,5,5,0.591327,0.567986,0.001946,"#00e8b2"
102496611,David4R,49,1,0,1,0.336894,0.631181,0,"#ff7007"
102534313,Luanquinzedias,30,0,1,1,0.623318,0.482094,0,"#ff77ff"
102535845,IIEs_UNAM,13,11,2,13,0.439475,0.370036,0.005837,"#3bec00"
102808133,Marihuanita17,4,0,1,1,0.844153,0.218594,0,"#f4c8cf"
102817255,govilini,14,0,2,2,0.604012,0.680723,0.000486,"#00eeff"
102835920,ccemx,13,3,0,3,0.375357,0.412822,0.000973,"#3bec00"
102856183,MovLibertario,19,1,0,1,0.660871,0.784391,0,"#00d3ff"
102871903,omarmatamoros,31,0,2,2,0.578202,0.592433,0.000486,"#3e93ff"
102930571,AulaMagna,31,2,1,3,0.518193,0.568713,0.000973,"#3e93ff"
102948927,CDOIA,0,1,0,1,0.355059,0.523946,0,"#8ecfec"
102964431,anterotesis,13,8,0,8,0.476628,0.403481,0.003405,"#3bec00"
102986075,RedCLARA,49,5,0,5,0.482663,0.456299,0.001946,"#ff7007"
103007773,marequipa,31,0,3,3,0.608176,0.507261,0.000973,"#3e93ff"
103025842,Tec_CCM,10,6,0,6,0.404602,0.561679,0.002432,"#52d7c0"
103040547,ociodv,49,1,0,1,0.360569,0.626748,0,"#ff7007"
103067285,article19mex,35,2,0,2,0.4292,0.231561,0.000486,"#00faff"
103086911,guerrerocamilaa,38,0,1,1,0.126517,0.811871,0,"#662859"
103258683,MolinodeIdeas,30,0,5,5,0.472343,0.569618,0.001946,"#ff77ff"
103280958,gobiline,15,5,1,6,0.497831,0.565445,0.002432,"#008ebb"
103327545,CamiloCalderonA,38,0,1,1,0.870477,0.504669,0,"#662859"
103340920,cubaliteraria,49,1,0,1,0.356935,0.723527,0,"#ff7007"
103409751,cibermarikiya,14,14,26,40,0.567803,0.549681,0.018969,"#00eeff"
103424993,josue_barrera,14,0,2,2,0.516239,0.492329,0.000486,"#00eeff"
103437718,rennygranda,49,0,5,5,0.456346,0.564536,0.001946,"#ff7007"
103454816,Veruani,41,0,2,2,0.355127,0.392021,0.000486,"#697b00"
103474579,tutiperalta28,34,0,1,1,0.611337,0.395796,0,"#ff0d69"
103550181,Crowdfire,34,2,0,2,0.422534,0.433868,0.000486,"#ff0d69"
103596787,betacerq,36,11,7,18,0.531092,0.385815,0.008268,"#825403"
103614120,xavier0031,8,0,1,1,0.23301,0.26772,0,"#00ed5d"
103638498,Trifenol,36,0,5,5,0.5052,0.342532,0.001946,"#825403"
103646556,aeunah,30,0,2,2,0.527784,0.606178,0.000486,"#ff77ff"
103766295,DamasoLuis,22,0,3,3,0.608849,0.603025,0.000973,"#00e8b2"
103772258,Julianatilano,7,0,2,2,0.4291,0.328377,0.000486,"#ffb800"
103875784,EditoraFGV,34,7,0,7,0.502191,0.453797,0.002918,"#ff0d69"
103887518,gilbertodiazt,34,0,2,2,0.590163,0.241544,0.000486,"#ff0d69"
103898432,sufridasafo,30,1,0,1,0.701204,0.66209,0,"#ff77ff"
103926649,pablowhipple,4,0,2,2,0.416446,0.379299,0.000486,"#f4c8cf"
103930107,FEducativas,31,0,2,2,0.555868,0.542908,0.000486,"#3e93ff"
103931824,kamiyano,36,0,2,2,0.404767,0.461241,0.000486,"#825403"
103939677,pablodeolavide,1,56,12,68,0.442363,0.530066,0.032588,"#b6cb00"
103940149,Pacificnihil,14,0,1,1,0.681063,0.507996,0,"#00eeff"
103946337,carlesora,22,0,1,1,0.331498,0.586949,0,"#00e8b2"
103946875,Jhonatancarrero,42,0,1,1,0.698089,0.446659,0,"#66e087"
103992636,yoly_m,55,0,4,4,0.629476,0.533633,0.001459,"#cb3f32"
104025110,anaravagnani,36,0,1,1,0.546419,0.293567,0,"#825403"
104036127,CATWLACDIR,13,0,1,1,0.305913,0.462653,0,"#3bec00"
104062818,MerIriondo,14,3,2,5,0.613422,0.569668,0.001946,"#00eeff"
104071926,Rulo_Lobo,22,0,2,2,0.685578,0.460674,0.000486,"#00e8b2"
104118686,Sandylu91,31,0,1,1,0.635943,0.509088,0,"#3e93ff"
104160141,AZuberogoitia,18,4,6,10,0.607118,0.528757,0.004377,"#5456a6"
104162716,Vicmunro,38,2,0,2,0.637121,0.464208,0.000486,"#662859"
104200308,cobdc,22,1,1,2,0.561464,0.633883,0.000486,"#00e8b2"
104213364,yazgt,7,0,2,2,0.576272,0.3978,0.000486,"#ffb800"
104222118,JBocaL,34,0,1,1,0.349793,0.515934,0,"#ff0d69"
104244727,RetroBrit,14,0,1,1,0.630716,0.544173,0,"#00eeff"
104250408,traficantes2010,36,6,9,15,0.570191,0.424832,0.006809,"#825403"
104257449,DiplomadosIbero,13,5,2,7,0.466964,0.372713,0.002918,"#3bec00"
104357575,upelienta_sss,21,0,1,1,0.25851,0.195265,0,"#c6cc85"
104424708,slealm,31,1,0,1,0.703019,0.533746,0,"#3e93ff"
104461382,biasantos13,36,1,0,1,0.471978,0.322877,0,"#825403"
104467006,Cris_Monteneg,36,0,1,1,0.562566,0.220467,0,"#825403"
104481563,YarimCorrea,49,1,0,1,0.362395,0.655499,0,"#ff7007"
104485966,cextremadura,30,1,0,1,0.553077,0.656756,0,"#ff77ff"
104516054,mercedesdelpozo,14,0,1,1,0.5104,0.640225,0,"#00eeff"
104521668,GobiernoUAndes,34,0,2,2,0.548291,0.390205,0.000486,"#ff0d69"
104526097,radionline,43,0,1,1,0.877581,0.539799,0,"#fcae7e"
104529881,diogo_souto,36,0,1,1,0.733188,0.596049,0,"#825403"
104530997,MuseuNacional,36,2,0,2,0.474033,0.352582,0.000486,"#825403"
104604540,EPFL_en,14,1,0,1,0.541486,0.466614,0,"#00eeff"
104604800,raulgilarias,8,0,1,1,0.263413,0.266755,0,"#00ed5d"
104631792,andresmancinie,49,1,0,1,0.329281,0.652402,0,"#ff7007"
104648362,MaggieNavarr0,49,0,5,5,0.585249,0.604136,0.001946,"#ff7007"
104659339,anabelibarrab,3,0,3,3,0.457987,0.803688,0.000973,"#ffb3ff"
104668379,jpavendano,21,0,1,1,0.228223,0.217382,0,"#c6cc85"
104691800,arely_sweet,7,0,1,1,0.40995,0.334958,0,"#ffb800"
104737646,psymxrk,13,0,1,1,0.444847,0.298146,0,"#3bec00"
104768601,TampereUni,31,1,0,1,0.596783,0.467773,0,"#3e93ff"
104876991,eddgz,2,0,1,1,0.654229,0.655931,0,"#ffa64e"
104880391,irvin_psb,41,0,8,8,0.404971,0.42268,0.003405,"#697b00"
104889094,joelphillipsc,7,0,2,2,0.403529,0.337101,0.000486,"#ffb800"
104894644,electricarchaeo,34,28,7,35,0.499222,0.476247,0.016537,"#ff0d69"
104894993,jessichaweles,37,0,2,2,0.240547,0.495031,0.000486,"#006032"
105003601,eadg5,3,0,1,1,0.442165,0.751222,0,"#ffb3ff"
105165692,kathrynpiquette,22,2,10,12,0.512654,0.554571,0.00535,"#00e8b2"
105174365,jbnovais,36,0,2,2,0.499722,0.291052,0.000486,"#825403"
105185759,jairvegac,37,1,0,1,0.46072,0.351814,0,"#006032"
105227098,yolanda_7,3,0,1,1,0.691903,0.63992,0,"#ffb3ff"
105237750,T_Organiza,2,0,6,6,0.542823,0.606106,0.002432,"#ffa64e"
105248369,LicSevero,49,0,1,1,0.424883,0.626615,0,"#ff7007"
105265304,beamarqui,3,0,1,1,0.466156,0.751508,0,"#ffb3ff"
105282966,alearangov,38,0,2,2,0.663024,0.377871,0.000486,"#662859"
105360924,CTorrealbaE,21,0,2,2,0.207778,0.259455,0.000486,"#c6cc85"
105374781,CristobalBarria,36,3,1,4,0.447015,0.383257,0.001459,"#825403"
105386908,billyescobar,49,1,0,1,0.368074,0.628715,0,"#ff7007"
105544986,lobarroco,51,0,1,1,0.365368,0.173077,0,"#c44aac"
105560931,ballpa,13,2,8,10,0.505694,0.497341,0.004377,"#3bec00"
105697603,AnarcoPesimista,40,0,1,1,0.619388,0.010583,0,"#ff12a3"
105709961,UnigisALatina,22,0,1,1,0.587891,0.632164,0,"#00e8b2"
105876020,amdelvaz,1,32,26,58,0.503671,0.54681,0.027724,"#b6cb00"
105879307,caterinegv,21,0,1,1,0.457304,0.949234,0,"#c6cc85"
105879530,Avelinohdz,17,0,1,1,0.611968,0.27238,0,"#ff9cc7"
105913094,Lemoni_,21,0,2,2,0.270693,0.213715,0.000486,"#c6cc85"
105932191,_Scrid,14,0,2,2,0.524725,0.502548,0.000486,"#00eeff"
105958161,itanlau,3,0,1,1,0.704423,0.708389,0,"#ffb3ff"
105970691,klynamen,21,0,1,1,0.771908,0.523946,0,"#c6cc85"
106004082,edgarmalario,13,0,1,1,0.38708,0.384777,0,"#3bec00"
106037450,urbanofl,49,1,0,1,0.325141,0.678846,0,"#ff7007"
106041193,nuzzel,36,2,0,2,0.590657,0.442312,0.000486,"#825403"
106047473,coralregi,8,2,0,2,0.58268,0.38302,0.000486,"#00ed5d"
106065260,mirsantos,36,0,8,8,0.52896,0.393193,0.003405,"#825403"
106071545,jaime_corner,30,0,2,2,0.528506,0.637552,0.000486,"#ff77ff"
106093928,mromandl,7,0,9,9,0.437797,0.433802,0.003891,"#ffb800"
106106024,Analisistrabaj,7,0,2,2,0.417073,0.332572,0.000486,"#ffb800"
106116553,dancassany,31,7,1,8,0.748528,0.538886,0.003405,"#3e93ff"
106128879,srebon,30,0,1,1,0.609163,0.659029,0,"#ff77ff"
106161997,pedromrodriguez,49,0,1,1,0.431296,0.621783,0,"#ff7007"
106236526,JannaJoceli,36,0,2,2,0.543144,0.432937,0.000486,"#825403"
106244211,Gardulez,17,0,1,1,0.828771,0.226597,0,"#ff9cc7"
106249756,Rusterx3,49,1,0,1,0.400144,0.675353,0,"#ff7007"
106377844,Angie_213,14,2,0,2,0.597482,0.577646,0.000486,"#00eeff"
106430178,educaINTEF,30,0,1,1,0.50806,0.6286,0,"#ff77ff"
106489752,IVANFERNANDEZ_O,58,0,2,2,0.633948,0.299006,0.000486,"#005076"
106504232,joaquinlugo,2,0,1,1,0.65018,0.643491,0,"#ffa64e"
106537905,BioDovScience,21,0,2,2,0.431735,0.69199,0.000486,"#c6cc85"
106555197,chacmoolvm,49,1,0,1,0.254867,0.643091,0,"#ff7007"
106562154,imuguetam,22,2,3,5,0.474348,0.617954,0.001946,"#00e8b2"
106566068,tlaltekatsin,13,0,3,3,0.501793,0.453711,0.000973,"#3bec00"
106568875,XeviCollell,14,0,1,1,0.546505,0.666385,0,"#00eeff"
106604112,ccinformacion,49,0,1,1,0.358861,0.535542,0,"#ff7007"
106680491,ressia_uy,55,0,2,2,0.668754,0.635523,0.000486,"#cb3f32"
106710609,mariajanethrios,49,2,0,2,0.420559,0.630908,0.000486,"#ff7007"
106769240,elpais_tec,30,4,0,4,0.554777,0.551286,0.001459,"#ff77ff"
106770944,yapalf,4,0,4,4,0.921784,0.244842,0.001459,"#f4c8cf"
106806419,ValentinCarrera,37,14,19,33,0.524688,0.687517,0.015564,"#006032"
106809102,Jorge_Sadi,7,0,1,1,0.326904,0.588765,0,"#ffb800"
106837709,manufacturaGE,49,1,0,1,0.353259,0.685922,0,"#ff7007"
106907143,CEURB_USB,13,1,0,1,0.402907,0.399559,0,"#3bec00"
106937182,DianaGabriellaC,7,0,1,1,0.365824,0.323769,0,"#ffb800"
106981025,JosafatHernndez,30,0,1,1,0.703272,0.64385,0,"#ff77ff"
107049683,Enpresagintza,18,3,0,3,0.592284,0.625208,0.000973,"#5456a6"
107051182,upvehu,22,17,0,17,0.535404,0.593203,0.007782,"#00e8b2"
107114193,freitas_mh,25,0,4,4,0.568817,0.09541,0.001459,"#f4a2ff"
107145333,UHouston,34,17,0,17,0.435106,0.449215,0.007782,"#ff0d69"
107145852,pablopuche4,30,0,2,2,0.532617,0.662932,0.000486,"#ff77ff"
107162328,Tec_CSF,10,2,0,2,0.348846,0.570776,0.000486,"#52d7c0"
107185307,Malodor,0,0,3,3,0.512684,0.558012,0.000973,"#8ecfec"
107242951,armando_acosta,17,0,1,1,0.839368,0.252853,0,"#ff9cc7"
107300773,Uziel_Pimentel,10,0,2,2,0.315993,0.485327,0.000486,"#52d7c0"
107338021,chelovargas,1,0,2,2,0.563376,0.564358,0.000486,"#b6cb00"
107346418,unlibroaldia,14,0,3,3,0.487332,0.512674,0.000973,"#00eeff"
107353980,tromeu,31,0,2,2,0.578808,0.523787,0.000486,"#3e93ff"
107356852,pramankapranam,36,0,1,1,0.476401,0.273929,0,"#825403"
107374564,AnaSerranoT,15,0,5,5,0.59232,0.572088,0.001946,"#008ebb"
107391511,jlmartinmas,14,0,1,1,0.705579,0.464715,0,"#00eeff"
107393104,GedisaEditorial,7,12,4,16,0.491309,0.607438,0.007296,"#ffb800"
107395934,ImanolLasa,8,0,1,1,0.27139,0.244023,0,"#00ed5d"
107529577,asicomred,22,0,4,4,0.579489,0.599892,0.001459,"#00e8b2"
107529696,ScieloMex,13,1,0,1,0.425354,0.296921,0,"#3bec00"
107615345,dramosgutierrez,41,0,2,2,0.349062,0.370469,0.000486,"#697b00"
107624688,EmelynRobot,3,5,6,11,0.478808,0.580316,0.004864,"#ffb3ff"
107685002,UminekoKaki,1,0,1,1,0.404848,0.785825,0,"#b6cb00"
107692607,unelibros,31,2,2,4,0.498249,0.609869,0.001459,"#3e93ff"
107696329,wikimedia_es,30,1,0,1,0.243316,0.464681,0,"#ff77ff"
107751029,casaliteratura,13,1,0,1,0.395887,0.445991,0,"#3bec00"
107792238,oscarszarate,13,0,5,5,0.485109,0.431998,0.001946,"#3bec00"
107857509,angelizabth,31,0,1,1,0.678439,0.551629,0,"#3e93ff"
107890940,diegopajarito,3,0,1,1,0.46496,0.780306,0,"#ffb3ff"
107917521,boriszaurio,0,0,1,1,0.321494,0.579678,0,"#8ecfec"
108029164,UCLDH,13,3,1,4,0.474574,0.473931,0.001459,"#3bec00"
108041364,baccheuo,2,0,2,2,0.691533,0.656428,0.000486,"#ffa64e"
108069810,redeln,13,4,4,8,0.618664,0.393451,0.003405,"#3bec00"
108099486,ClaraGrima,14,0,1,1,0.454842,0.668391,0,"#00eeff"
108105221,tetelorenzo,30,0,3,3,0.565823,0.535212,0.000973,"#ff77ff"
108124132,adriaceves,13,0,9,9,0.477858,0.506385,0.003891,"#3bec00"
108210623,AMAV_,38,0,1,1,0.558445,0.398813,0,"#662859"
108219271,CUZG,4,0,1,1,0.844319,0.237855,0,"#f4c8cf"
108249480,Loli_Ba,14,1,0,1,0.553103,0.676528,0,"#00eeff"
108273745,citafgsr,30,2,3,5,0.536422,0.585779,0.001946,"#ff77ff"
108280369,Univcordoba,30,1,0,1,0.596069,0.561517,0,"#ff77ff"
108326567,juanagarciaduqu,38,0,4,4,0.515166,0.440911,0.001459,"#662859"
108361535,MadamCatorola,13,0,1,1,0.393379,0.492496,0,"#3bec00"
108363533,carnalazo,13,1,0,1,0.516475,0.397554,0,"#3bec00"
108378098,luismc_21,30,0,1,1,0.581169,0.462984,0,"#ff77ff"
108391849,lenipez,15,0,1,1,0.560841,0.746964,0,"#008ebb"
108393927,cgeorgemx,0,0,2,2,0.443359,0.393155,0.000486,"#8ecfec"
108434183,_Hadita_,37,0,1,1,0.714024,0.590836,0,"#006032"
108440425,UV_EG,31,39,0,39,0.573683,0.49176,0.018482,"#3e93ff"
108467957,Marcus_Camus,34,2,8,10,0.529536,0.484691,0.004377,"#ff0d69"
108477485,WMonsy,41,0,1,1,0.33019,0.340544,0,"#697b00"
108598039,siliconspain,49,1,0,1,0.347089,0.668186,0,"#ff7007"
108613759,svinetarzuaga,3,0,1,1,0.696985,0.646133,0,"#ffb3ff"
108637735,maitesdg,0,0,3,3,0.442922,0.475364,0.000973,"#8ecfec"
108647110,richard_site,13,0,1,1,0.483589,0.343203,0,"#3bec00"
108648804,maturanaricardo,0,13,0,13,0.445413,0.525225,0.005837,"#8ecfec"
108650826,ffespechen,49,0,1,1,0.29131,0.488644,0,"#ff7007"
108671333,mapicama,38,0,1,1,0.61436,0.386965,0,"#662859"
108680766,spreadingsocial,22,0,2,2,0.639406,0.476081,0.000486,"#00e8b2"
108693031,cgalvanf,14,0,1,1,0.688435,0.515097,0,"#00eeff"
108704816,Pawtoja,13,0,1,1,0.418405,0.419132,0,"#3bec00"
108708222,1jagar,7,0,3,3,0.434301,0.315292,0.000973,"#ffb800"
108738149,Montseformage,7,0,1,1,0.384489,0.302317,0,"#ffb800"
108873806,fafddeportes,31,0,8,8,0.589152,0.498111,0.003405,"#3e93ff"
108890677,adricarol311,31,0,1,1,0.622361,0.513572,0,"#3e93ff"
108906423,misterpetrus,22,0,2,2,0.570763,0.675894,0.000486,"#00e8b2"
108932245,materia_ciencia,22,1,0,1,0.599456,0.604252,0,"#00e8b2"
108977809,UninorteCO,13,5,0,5,0.5255,0.488732,0.001946,"#3bec00"
108979965,CaFoscari,49,1,0,1,0.341161,0.465566,0,"#ff7007"
108987958,Uniandinos,34,5,0,5,0.541979,0.416103,0.001946,"#ff0d69"
109001353,TECcampusLEO,35,2,0,2,0.384747,0.514476,0.000486,"#00faff"
109049655,igomes2,36,1,0,1,0.47404,0.321756,0,"#825403"
109065529,ivanturmero,49,1,0,1,0.344076,0.684991,0,"#ff7007"
109109491,nenishi,21,0,1,1,0.22325,0.199322,0,"#c6cc85"
109115928,Careverdeazul,42,0,1,1,0.716754,0.432757,0,"#66e087"
109154400,alexsaum,30,18,16,34,0.493713,0.494746,0.016051,"#ff77ff"
109237258,JoseAngelARES,14,0,1,1,0.790866,0.43858,0,"#00eeff"
109275633,gandalf_u,14,0,1,1,0.496033,0.644612,0,"#00eeff"
109390268,twitemp1,13,0,1,1,0.494205,0.372521,0,"#3bec00"
109432928,felixtrevino,30,2,2,4,0.518389,0.46603,0.001459,"#ff77ff"
109502786,MarianaEguaras,30,3,3,6,0.537635,0.552076,0.002432,"#ff77ff"
109580511,IUMAnews,30,3,0,3,0.584761,0.641511,0.000973,"#ff77ff"
109616781,diegoebarros,40,0,1,1,0.625158,0.014503,0,"#ff12a3"
109681332,BeatrizGallardo,14,0,18,18,0.51342,0.531952,0.008268,"#00eeff"
109705840,DIEB_UNAL,38,0,4,4,0.464118,0.364638,0.001459,"#662859"
109748707,gioval_27,34,0,1,1,0.541836,0.326118,0,"#ff0d69"
109807316,VeroRamRan,22,0,1,1,0.3838,0.509408,0,"#00e8b2"
110048305,micho_champ,34,0,1,1,0.574548,0.353488,0,"#ff0d69"
110182536,EAMORENOURIBE,38,0,2,2,0.444845,0.796822,0.000486,"#662859"
110235773,KatherineM_G,38,0,1,1,0.118247,0.80236,0,"#662859"
110259026,CulturaenBta,38,13,4,17,0.661746,0.396342,0.007782,"#662859"
110260294,eellewoods,38,0,1,1,0.102945,0.802576,0,"#662859"
110308863,montesdeoca2010,14,0,2,2,0.486717,0.522758,0.000486,"#00eeff"
110312729,LuCerquera,49,0,4,4,0.4366,0.473193,0.001459,"#ff7007"
110423800,imagenfest,9,8,0,8,0.675588,0.582886,0.003405,"#008f7b"
110465562,j_w_baker,34,59,38,97,0.491577,0.474323,0.046693,"#ff0d69"
110517361,trigorosa,21,0,2,2,0.278445,0.379413,0.000486,"#c6cc85"
110521905,Laybet,1,0,2,2,0.444268,0.6597,0.000486,"#b6cb00"
110523661,KUTheatre,41,1,0,1,0.343401,0.446281,0,"#697b00"
110652739,CESGA_,14,6,8,14,0.509376,0.569936,0.006323,"#00eeff"
110740163,patricioraquel,31,0,1,1,0.650016,0.539598,0,"#3e93ff"
110762174,gabrielamunch,42,0,3,3,0.666528,0.429718,0.000973,"#66e087"
110770965,jlblanher,17,0,1,1,0.815174,0.225586,0,"#ff9cc7"
110847951,hildavanessar,0,0,1,1,0.376533,0.552668,0,"#8ecfec"
110949678,carlescamara,1,0,1,1,0.482236,0.798622,0,"#b6cb00"
110971872,bibliotecaUHU,31,0,2,2,0.585159,0.505204,0.000486,"#3e93ff"
110982200,_laura_acosta,1,0,3,3,0.45808,0.689539,0.000973,"#b6cb00"
111048646,zerpasad,22,0,2,2,0.648058,0.477023,0.000486,"#00e8b2"
111075843,LeoEliasDavid,34,4,0,4,0.440656,0.479734,0.001459,"#ff0d69"
111093073,interiordia,21,0,2,2,0.236656,0.242589,0.000486,"#c6cc85"
111132067,statsmaths,34,30,0,30,0.480227,0.478408,0.014105,"#ff0d69"
111137954,MartinOseguera1,13,0,1,1,0.420551,0.40701,0,"#3bec00"
111147974,benitezenlinea,13,0,2,2,0.39723,0.367193,0.000486,"#3bec00"
111166245,YamiriRodriguez,7,0,1,1,0.416123,0.333159,0,"#ffb800"
111234154,gilbertoleon,26,0,4,4,0.416257,0.177235,0.001459,"#a7d4ff"
111344135,EditorialUR,37,0,1,1,0.654462,0.382997,0,"#006032"
111362011,bulpgc,30,0,4,4,0.536917,0.557707,0.001459,"#ff77ff"
111367618,JoanSoler_,14,0,1,1,0.680861,0.409887,0,"#00eeff"
111423733,siglodelhombre,38,3,1,4,0.616402,0.496388,0.001459,"#662859"
111468831,bonuccimario,42,1,0,1,0.776896,0.438343,0,"#66e087"
111475114,panchosoto777,38,0,3,3,0.587384,0.471421,0.000973,"#662859"
111591104,Nanigs,22,1,6,7,0.51665,0.572376,0.002918,"#00e8b2"
111605285,laspauconnect,38,1,0,1,0.220051,0.57991,0,"#662859"
111651073,Campusmilenio,22,3,1,4,0.630042,0.446118,0.001459,"#00e8b2"
111689516,JoleRestrepo,38,3,0,3,0.626295,0.450079,0.000973,"#662859"
111702697,apoyomutuo,57,11,3,14,0.651063,0.50171,0.006323,"#b66f7a"
111789797,carlosqroo,7,0,2,2,0.424421,0.338726,0.000486,"#ffb800"
112021333,aceballosm,9,6,16,22,0.707701,0.659184,0.010214,"#008f7b"
112033498,MargeFigueroa,38,4,1,5,0.603428,0.48135,0.001946,"#662859"
112081025,BenjaAnaya,7,0,1,1,0.747723,0.353735,0,"#ffb800"
112113852,juannietogarcia,24,0,1,1,0.168632,0.628433,0,"#ff9b8f"
112200397,WorkMeter_es,49,2,0,2,0.414825,0.566693,0.000486,"#ff7007"
112243716,j_azpurua,49,1,0,1,0.341415,0.629741,0,"#ff7007"
112270673,AnalisisUNAL,38,0,1,1,0.393675,0.366546,0,"#662859"
112284808,BrunabLESSed,13,0,5,5,0.488904,0.442237,0.001946,"#3bec00"
112327236,jairoaescobarq,3,0,1,1,0.511033,0.773678,0,"#ffb3ff"
112446255,TorresTilteadas,22,0,1,1,0.383114,0.591909,0,"#00e8b2"
112463963,Fycma,14,1,0,1,0.699163,0.510712,0,"#00eeff"
112498897,sedici_unlp,49,10,0,10,0.518728,0.556678,0.004377,"#ff7007"
112558907,RangelIris,34,1,0,1,0.469026,0.204282,0,"#ff0d69"
112559150,aliciarll,8,1,0,1,0.667153,0.255644,0,"#00ed5d"
112559162,SaraVegaGa,49,0,1,1,0.395237,0.827881,0,"#ff7007"
112563680,cenartmx,37,1,0,1,0.605101,0.256965,0,"#006032"
112610515,Ted_Underwood,38,10,0,10,0.512364,0.463743,0.004377,"#662859"
112611244,lalotadeo,7,0,1,1,0.404334,0.203153,0,"#ffb800"
112694236,larazon_es,30,1,0,1,0.615126,0.575317,0,"#ff77ff"
112742370,aby_merino,13,3,3,6,0.400838,0.504358,0.002432,"#3bec00"
112748874,maraayen,21,0,2,2,0.247778,0.218713,0.000486,"#c6cc85"
112760496,BosniaSarajevo,13,0,1,1,0.471771,0.34633,0,"#3bec00"
112797762,Gbrl_Barcenas,7,2,1,3,0.433119,0.372401,0.000973,"#ffb800"
112913079,alfobioq,21,0,2,2,0.446245,0.483114,0.000486,"#c6cc85"
112950645,macabrofandango,49,0,2,2,0.393994,0.543157,0.000486,"#ff7007"
112961087,sintetia,8,1,0,1,0.657117,0.253282,0,"#00ed5d"
113021258,SdelBarrio,31,0,2,2,0.552517,0.481687,0.000486,"#3e93ff"
113080978,CCIT_,38,2,0,2,0.639055,0.457301,0.000486,"#662859"
113094442,PaulBitternut,31,0,1,1,0.595854,0.470999,0,"#3e93ff"
113127283,ArchivoGeneral,38,20,2,22,0.608526,0.398831,0.010214,"#662859"
113135890,RafaelOllarves,42,0,2,2,0.700844,0.427768,0.000486,"#66e087"
113162842,boldblack23,17,0,1,1,0.921331,0.362798,0,"#ff9cc7"
113179831,RaicesCC,49,0,1,1,0.407147,0.506133,0,"#ff7007"
113203383,M1Yar,38,0,1,1,0.175597,0.431351,0,"#662859"
113221576,Clau_Dgz_Myt,13,0,3,3,0.455544,0.456071,0.000973,"#3bec00"
113319974,robertlroyal,19,1,0,1,0.616585,0.707146,0,"#00d3ff"
113337434,martelo21,38,0,1,1,0.427576,0.770337,0,"#662859"
113410319,jornalistavitor,8,0,1,1,0.785611,0.190417,0,"#00ed5d"
113412296,ciesas,13,8,7,15,0.474148,0.383765,0.006809,"#3bec00"
113420372,JuanCaMendez_,49,1,0,1,0.306017,0.642931,0,"#ff7007"
113432424,NicoPetrosini,49,0,1,1,0.377386,0.583116,0,"#ff7007"
113452996,robdniel,13,0,2,2,0.376076,0.493487,0.000486,"#3bec00"
113469749,tlatland,49,16,16,32,0.464485,0.546837,0.015078,"#ff7007"
113498635,cabanasguzman,22,0,1,1,0.517277,0.705485,0,"#00e8b2"
113514502,tomlibrarian,7,1,2,3,0.456628,0.400941,0.000973,"#ffb800"
113517160,chcme,42,0,1,1,0.71863,0.462258,0,"#66e087"
113517203,ksoteldo,3,0,2,2,0.4941,0.608501,0.000486,"#ffb3ff"
113600987,stefano_2punto0,13,0,13,13,0.497428,0.463866,0.005837,"#3bec00"
113642978,ArturoLevAA,13,0,1,1,0.431188,0.422337,0,"#3bec00"
113658962,davidgarrofe,8,5,0,5,0.667629,0.312725,0.001946,"#00ed5d"
113698634,silfemina,22,1,3,4,0.577601,0.619615,0.001459,"#00e8b2"
113703706,MalenaStein,49,1,0,1,0.288907,0.634383,0,"#ff7007"
113715037,UCSFoficial,37,1,0,1,0.43558,0.668923,0,"#006032"
113728420,YO_____MERO,4,0,1,1,0.869534,0.244869,0,"#f4c8cf"
113732197,davidsonsekinfo,7,0,1,1,0.50763,0.697887,0,"#ffb800"
113735154,storiainrete,19,1,0,1,0.649054,0.783846,0,"#00d3ff"
113764386,mljockers,34,1,0,1,0.394607,0.457541,0,"#ff0d69"
113768214,alelam22,31,0,1,1,0.620642,0.498477,0,"#3e93ff"
113783436,fcobongiorno,42,1,0,1,0.785471,0.436048,0,"#66e087"
113789212,joreyes6,22,0,3,3,0.369619,0.384194,0.000973,"#00e8b2"
114035366,marthapalomino,31,0,1,1,0.648613,0.519235,0,"#3e93ff"
114057786,AgoraColmex,7,0,2,2,0.434429,0.356661,0.000486,"#ffb800"
114216982,FredTruyen,31,7,3,10,0.550899,0.586482,0.004377,"#3e93ff"
114234317,carolvicurban,7,0,2,2,0.433076,0.302695,0.000486,"#ffb800"
114264296,Feloarias,38,1,1,2,0.353685,0.296351,0.000486,"#662859"
114305141,enithj,38,0,3,3,0.462834,0.437819,0.000973,"#662859"
114341314,Tarrasilla,30,0,1,1,0.681534,0.623003,0,"#ff77ff"
114388311,sigfridlundberg,49,0,4,4,0.42526,0.530138,0.001459,"#ff7007"
114413759,BiVito,30,1,0,1,0.542432,0.623399,0,"#ff77ff"
114507083,carlosau7,38,0,11,11,0.485901,0.499231,0.004864,"#662859"
114509172,BIGRIVERIPN,49,1,0,1,0.365926,0.682919,0,"#ff7007"
114515969,NataliaGandara,34,0,1,1,0.46507,0.379382,0,"#ff0d69"
114521788,enrollate,49,1,0,1,0.354896,0.595933,0,"#ff7007"
114528144,ernestopena,13,10,15,25,0.518923,0.470047,0.011673,"#3bec00"
114564988,YasnayaEG,51,0,2,2,0.423344,0.220023,0.000486,"#c44aac"
114565226,vevavargas,49,1,0,1,0.367496,0.6767,0,"#ff7007"
114597566,euroluar,13,0,1,1,0.411741,0.430954,0,"#3bec00"
114600368,velasqueza,42,0,1,1,0.698405,0.441947,0,"#66e087"
114640432,j_lalogh,13,0,1,1,0.441185,0.307775,0,"#3bec00"
114650252,cristhian_rr,0,0,1,1,0.565121,0.672295,0,"#8ecfec"
114651036,krmugon,37,0,1,1,0.200353,0.486623,0,"#006032"
114700275,tonyatlantico,30,1,0,1,0.490211,0.664674,0,"#ff77ff"
114747360,kikemtzglz,31,3,0,3,0.687051,0.549894,0.000973,"#3e93ff"
114761932,yulmarco,42,0,1,1,0.702992,0.445502,0,"#66e087"
114775508,DialogosCanal11,13,3,5,8,0.375624,0.440794,0.003405,"#3bec00"
114802918,LasNavesINN,31,2,3,5,0.464921,0.542815,0.001946,"#3e93ff"
114807006,Carlospl1967,38,0,2,2,0.634133,0.522625,0.000486,"#662859"
114822440,grial_usal,14,0,2,2,0.452189,0.66459,0.000486,"#00eeff"
114916889,Minnaharker,21,0,1,1,0.189049,0.213246,0,"#c6cc85"
114929774,edr_arg,14,0,1,1,0.606252,0.461698,0,"#00eeff"
114931754,vleonfilm,38,0,1,1,0.542014,0.372106,0,"#662859"
115014966,federicomorando,34,0,3,3,0.535484,0.468819,0.000973,"#ff0d69"
115045848,pmorenocollado,49,2,4,6,0.523907,0.586688,0.002432,"#ff7007"
115127182,MosaicoMercurio,30,0,2,2,0.591459,0.637176,0.000486,"#ff77ff"
115141670,RodrigoMorenoGu,34,9,3,12,0.521083,0.399244,0.00535,"#ff0d69"
115153353,chemarodrigo,31,0,2,2,0.614856,0.511258,0.000486,"#3e93ff"
115156289,DJDeleuze,13,0,1,1,0.44243,0.317584,0,"#3bec00"
115161716,dedalus_73,22,0,1,1,0.395965,0.594033,0,"#00e8b2"
115168786,soriatere,13,0,3,3,0.457708,0.500157,0.000973,"#3bec00"
115189812,carlo_rios,7,0,2,2,0.400681,0.274225,0.000486,"#ffb800"
115199271,HackeaDistopia,0,0,2,2,0.506804,0.431998,0.000486,"#8ecfec"
115273149,heberquijano,13,0,4,4,0.443821,0.479723,0.001459,"#3bec00"
115348393,bibliotecaetsii,31,0,2,2,0.553171,0.587031,0.000486,"#3e93ff"
115355950,Cibeles_,58,0,1,1,0.575251,0.181425,0,"#005076"
115366611,TallinnUni,30,1,0,1,0.521775,0.787443,0,"#ff77ff"
115379053,KittyandJerry,14,0,2,2,0.61148,0.691083,0.000486,"#00eeff"
115382899,oriolTIC,1,1,0,1,0.36513,0.593715,0,"#b6cb00"
115416310,UNIRuniversidad,14,134,43,177,0.475489,0.517688,0.085603,"#00eeff"
115435513,AnnaForastier,49,1,0,1,0.407367,0.658328,0,"#ff7007"
115478293,IISUE_UNAM,13,21,9,30,0.453897,0.420124,0.014105,"#3bec00"
115531105,HANSDANIEL,13,0,1,1,0.509279,0.314744,0,"#3bec00"
115533632,EADABusiness,49,1,0,1,0.346771,0.593954,0,"#ff7007"
115546052,jamedinaromo,34,0,1,1,0.489003,0.374063,0,"#ff0d69"
115588310,kdrabinski,13,0,1,1,0.373913,0.444882,0,"#3bec00"
115650900,unirioja,24,5,1,6,0.32305,0.59119,0.002432,"#ff9b8f"
115691686,minotaurodigita,58,3,11,14,0.489216,0.534212,0.006323,"#005076"
115692123,LuizGustavoCota,36,2,0,2,0.484612,0.348327,0.000486,"#825403"
115711568,SorbonneParis1,31,1,0,1,0.634288,0.526689,0,"#3e93ff"
115714652,Cralkid,34,0,1,1,0.558444,0.336908,0,"#ff0d69"
115775168,TecdeMonterrey,37,38,0,38,0.380074,0.503034,0.017996,"#006032"
115782987,ybrand,31,0,2,2,0.626947,0.537506,0.000486,"#3e93ff"
115944812,mbd_uc3m,30,4,1,5,0.500523,0.582841,0.001946,"#ff77ff"
115978980,iraidarojas98,3,0,1,1,0.685641,0.715082,0,"#ffb3ff"
116207723,Gayoxo,30,0,2,2,0.586146,0.586602,0.000486,"#ff77ff"
116214228,digitaldante,36,0,10,10,0.482029,0.452095,0.004377,"#825403"
116235935,MPECHS,17,0,1,1,0.9038,0.374124,0,"#ff9cc7"
116262406,ertiodelatiza,1,0,1,1,0.436326,0.638153,0,"#b6cb00"
116337949,mfgaede,34,0,2,2,0.390782,0.461674,0.000486,"#ff0d69"
116355389,NellyMontreux,42,0,1,1,0.7119,0.452343,0,"#66e087"
116392868,USPCEU,2,10,4,14,0.485389,0.535714,0.006323,"#ffa64e"
116408890,eponsf,8,1,1,2,0.661029,0.268712,0.000486,"#00ed5d"
116469275,joscorte,34,0,1,1,0.601034,0.321446,0,"#ff0d69"
116491957,tonywebsoc,30,2,3,5,0.487269,0.561318,0.001946,"#ff77ff"
116492411,CENDES_UCV,22,0,2,2,0.612897,0.605359,0.000486,"#00e8b2"
116659732,MarCurielFerman,7,0,2,2,0.578916,0.406042,0.000486,"#ffb800"
116714746,fmentransito,49,1,0,1,0.428465,0.656257,0,"#ff7007"
116772649,sboteroc,34,1,0,1,0.544286,0.385223,0,"#ff0d69"
116787978,YanaraVivas,42,0,1,1,0.903643,0.441312,0,"#66e087"
116828005,carmenbeat,42,0,4,4,0.731446,0.431342,0.001459,"#66e087"
116831350,UFRJ_ECO,36,1,0,1,0.508053,0.264517,0,"#825403"
116857128,FestivalesGCBA,49,1,0,1,0.321893,0.650923,0,"#ff7007"
116925166,Banrepcultural,38,73,8,81,0.589965,0.477549,0.038911,"#662859"
116958257,rmedinaenator,42,0,1,1,0.899164,0.429005,0,"#66e087"
116973001,tataguirre,22,0,2,2,0.620503,0.509574,0.000486,"#00e8b2"
117020167,bosquetriste_,21,0,2,2,0.240201,0.236095,0.000486,"#c6cc85"
117033017,JoseManuelB2013,38,1,1,2,0.3968,0.33927,0.000486,"#662859"
117034312,cirollueca,14,21,14,35,0.579884,0.553848,0.016537,"#00eeff"
117075816,miniA3,14,0,2,2,0.561464,0.507206,0.000486,"#00eeff"
117095906,aambros,31,1,0,1,0.627738,0.52062,0,"#3e93ff"
117098029,cams_007,13,0,1,1,0.523548,0.230523,0,"#3bec00"
117122341,personaGGL,38,0,4,4,0.53767,0.47827,0.001459,"#662859"
117168033,piensa_digital,22,0,2,2,0.681795,0.489227,0.000486,"#00e8b2"
117171812,Telmacarv,36,0,1,1,0.624579,0.14082,0,"#825403"
117197118,mariacrespo___,14,0,2,2,0.568011,0.506768,0.000486,"#00eeff"
117274564,dadoruy,34,0,2,2,0.446548,0.252906,0.000486,"#ff0d69"
117295684,MLabrys,34,0,2,2,0.494203,0.411011,0.000486,"#ff0d69"
117356139,MatiasBarchino,15,7,2,9,0.498142,0.570308,0.003891,"#008ebb"
117376845,_mediatica,22,0,3,3,0.647358,0.531536,0.000973,"#00e8b2"
117405708,juanjoberger,21,0,7,7,0.408647,0.450867,0.002918,"#c6cc85"
117438101,mbelisario40,35,0,1,1,0.469124,0.691074,0,"#00faff"
117506621,CarlosE_Lozada,22,0,1,1,0.224772,0.684,0,"#00e8b2"
117507153,juanjose_rivera,8,0,1,1,0.284873,0.25223,0,"#00ed5d"
117538091,cirt_,49,1,0,1,0.300751,0.635715,0,"#ff7007"
117556542,albertcaste,8,9,0,9,0.654619,0.320043,0.003891,"#00ed5d"
117580378,ignaciojaramilo,31,0,3,3,0.602299,0.494158,0.000973,"#3e93ff"
117624188,profatassi,36,2,0,2,0.457965,0.341859,0.000486,"#825403"
117639860,kaappiah,34,0,2,2,0.368992,0.411721,0.000486,"#ff0d69"
117702814,datchery8,36,0,10,10,0.475669,0.493718,0.004377,"#825403"
117838012,jcolomasan,14,0,3,3,0.667266,0.512608,0.000973,"#00eeff"
117855212,dramirezf,38,1,0,1,0.400487,0.222302,0,"#662859"
117867560,damayor11,34,0,2,2,0.628976,0.35387,0.000486,"#ff0d69"
117931524,catrincoquille,3,0,1,1,0.329772,0.518667,0,"#ffb3ff"
118002733,alonsobarros,21,0,2,2,0.218325,0.238643,0.000486,"#c6cc85"
118058873,arquetipomasaje,30,0,1,1,0.609212,0.654844,0,"#ff77ff"
118120570,marcwasem,13,0,1,1,0.375676,0.455558,0,"#3bec00"
118224151,elcolmex,7,249,36,285,0.455891,0.399467,0.138132,"#ffb800"
118241589,Sebastiana2010,7,0,1,1,0.361006,0.364448,0,"#ffb800"
118260001,qsjose,49,1,0,1,0.415088,0.645012,0,"#ff7007"
118263124,stanfordnlp,13,0,1,1,0.513991,0.389129,0,"#3bec00"
118268716,lemarderi,22,0,9,9,0.513642,0.539914,0.003891,"#00e8b2"
118277287,Musicj20,14,1,0,1,0.441619,0.330103,0,"#00eeff"
118284622,m_chavoya,34,1,5,6,0.464887,0.433163,0.002432,"#ff0d69"
118371706,Rafa_DR,21,0,1,1,0.240226,0.217981,0,"#c6cc85"
118422297,lunnamoreira,36,0,1,1,0.654976,0.339778,0,"#825403"
118451380,ropalchi,49,0,1,1,0.337646,0.488861,0,"#ff7007"
118469001,AnaArenasUFV,15,2,1,3,0.475384,0.590827,0.000973,"#008ebb"
118471077,ebiblioteke,13,3,14,17,0.512024,0.49897,0.007782,"#3bec00"
118482051,tabitamoreno,49,8,6,14,0.379412,0.497991,0.006323,"#ff7007"
118493061,nenamarce,21,0,1,1,0.196711,0.247969,0,"#c6cc85"
118494134,Danic345,38,0,1,1,0.439665,0.755425,0,"#662859"
118523988,ariadnalaberint,15,0,4,4,0.519132,0.526349,0.001459,"#008ebb"
118526360,jmcastagnetto,37,1,2,3,0.453712,0.313493,0.000973,"#006032"
118550566,avesus,36,0,1,1,0.529029,0.284175,0,"#825403"
118575690,marisabelm12,21,0,1,1,0.191086,0.221563,0,"#c6cc85"
118659659,Qualispacer,0,0,2,2,0.633884,0.629721,0.000486,"#8ecfec"
118666101,EdinburghUP,36,9,0,9,0.499267,0.460951,0.003891,"#825403"
118707730,luciernagas24,30,1,1,2,0.547617,0.666029,0.000486,"#ff77ff"
118728808,jr_josue,49,1,0,1,0.400483,0.690135,0,"#ff7007"
118740026,JimmyVelez,38,0,1,1,0.421032,0.779697,0,"#662859"
118755764,pamaranti,21,0,1,1,0.183819,0.250032,0,"#c6cc85"
118793167,glofredes,31,0,1,1,0.62825,0.496328,0,"#3e93ff"
118794674,DreamtimeDrinne,36,0,1,1,0.393008,0.4713,0,"#825403"
118804682,GlobbIT_ES,49,1,0,1,0.292223,0.633519,0,"#ff7007"
118832434,CacereSebastian,38,0,1,1,0.619173,0.412048,0,"#662859"
118902901,VittorioNegroni,21,0,1,1,0.231074,0.224978,0,"#c6cc85"
118916657,yerbomatofono,38,0,1,1,0.320804,0.163521,0,"#662859"
119001008,GeekTeca,2,0,2,2,0.463044,0.644617,0.000486,"#ffa64e"
119015367,aedea87,24,0,2,2,0.28637,0.616379,0.000486,"#ff9b8f"
119040124,Movil707,21,0,2,2,0.221,0.246078,0.000486,"#c6cc85"
119048849,seeksanusername,13,1,1,2,0.49915,0.384811,0.000486,"#3bec00"
119071109,IgnacioMontag,31,0,2,2,0.593725,0.611362,0.000486,"#3e93ff"
119133521,pcfixmardel,49,2,0,2,0.42906,0.619068,0.000486,"#ff7007"
119146155,farruptero,21,0,2,2,0.234907,0.223032,0.000486,"#c6cc85"
119181575,marusuarezrp,17,0,1,1,0.81142,0.244265,0,"#ff9cc7"
119194942,ivansuazo,31,0,2,2,0.58883,0.505125,0.000486,"#3e93ff"
119211398,UDD_cl,37,1,0,1,0.268551,0.564643,0,"#006032"
119216935,t_banno,42,0,2,2,0.702522,0.431971,0.000486,"#66e087"
119229837,IIFL_UNAM,13,66,6,72,0.507007,0.399289,0.034533,"#3bec00"
119241934,FedesoftCol,38,3,1,4,0.499949,0.640529,0.001459,"#662859"
119246941,miciudadela,21,0,2,2,0.22575,0.227205,0.000486,"#c6cc85"
119400477,lauralbasulto,31,1,0,1,0.709552,0.536071,0,"#3e93ff"
119412544,mangelspbarniol,22,0,1,1,0.609277,0.608707,0,"#00e8b2"
119427098,HubitoTintel,37,0,4,4,0.313138,0.491631,0.001459,"#006032"
119440296,caroguaca,9,0,1,1,0.71998,0.624662,0,"#008f7b"
119563034,John_Logar,13,0,1,1,0.390733,0.380354,0,"#3bec00"
119591934,Paito_GD,38,0,1,1,0.120676,0.792682,0,"#662859"
119605968,an_niet92,13,0,2,2,0.465709,0.428422,0.000486,"#3bec00"
119791145,fmorfin,31,0,3,3,0.611626,0.507612,0.000973,"#3e93ff"
119797535,CIDE_MX,4,4,0,4,0.592359,0.277541,0.001459,"#f4c8cf"
119823435,ccvvgg,45,0,2,2,0.666453,0.18806,0.000486,"#00e8ff"
119842153,hibridaart,49,1,8,9,0.511281,0.451676,0.003891,"#ff7007"
119881342,jrherreraucv,22,0,1,1,0.664427,0.568585,0,"#00e8b2"
119922702,jana1903,21,0,2,2,0.267438,0.220914,0.000486,"#c6cc85"
119952698,LauraMComunica,38,0,1,1,0.606809,0.339779,0,"#662859"
119980862,LaCatarinaUDLAP,49,1,0,1,0.346985,0.663941,0,"#ff7007"
119981619,eddycpz,42,0,2,2,0.725206,0.3925,0.000486,"#66e087"
119999860,_toto________,3,0,1,1,0.508956,0.759958,0,"#ffb3ff"
120004959,nachouno,7,0,1,1,0.422428,0.326062,0,"#ffb800"
120058741,ramonsuarez_,0,3,1,4,0.44029,0.569888,0.001459,"#8ecfec"
120095188,simone_belli_,37,8,3,11,0.554326,0.48205,0.004864,"#006032"
120127051,saduran,7,0,1,1,0.403815,0.237738,0,"#ffb800"
120147806,leandrofridman,37,1,0,1,0.435455,0.668618,0,"#006032"
120166541,EnLaCiutat,14,9,5,14,0.505453,0.509288,0.006323,"#00eeff"
120232905,Bo_Oppenheim,13,2,0,2,0.437031,0.349228,0.000486,"#3bec00"
120233074,AngelJohanna,3,1,1,2,0.470743,0.637194,0.000486,"#ffb3ff"
120284067,Sindiek8,13,0,1,1,0.577713,0.408609,0,"#3bec00"
120357481,Jhaqual,49,1,0,1,0.401326,0.660321,0,"#ff7007"
120607519,Lulucita12344,21,0,1,1,0.307483,0.442722,0,"#c6cc85"
120619507,flalomorales,3,1,3,4,0.450928,0.568839,0.001459,"#ffb3ff"
120762196,Anatomiaedicion,22,1,1,2,0.607815,0.625469,0.000486,"#00e8b2"
120779648,GRQM,36,0,1,1,0.534987,0.280695,0,"#825403"
120846600,danreyesl,49,0,1,1,0.405639,0.511892,0,"#ff7007"
120954896,Lilithvi,40,0,1,1,0.591003,0.034697,0,"#ff12a3"
120961752,MarthaLMalagon,38,0,3,3,0.573351,0.443325,0.000973,"#662859"
120967518,Filoloca_,30,0,1,1,0.463449,0.624168,0,"#ff77ff"
121039771,hijos_capital,49,1,0,1,0.4087,0.640817,0,"#ff7007"
121107220,archivadorsalam,19,0,15,15,0.553307,0.533536,0.006809,"#00d3ff"
121143657,JoseGreAldana,49,1,0,1,0.382462,0.620113,0,"#ff7007"
121144751,UNLitoral,49,2,0,2,0.396599,0.570713,0.000486,"#ff7007"
121168954,jblasgarcia,22,1,0,1,0.483204,0.721239,0,"#00e8b2"
121183700,elpais_espana,31,2,0,2,0.513726,0.562099,0.000486,"#3e93ff"
121207150,SeguNina,34,3,3,6,0.488481,0.395375,0.002432,"#ff0d69"
121217094,arteenteoria,30,0,5,5,0.484749,0.549137,0.001946,"#ff77ff"
121220303,BelloPublico,21,0,1,1,0.25093,0.212763,0,"#c6cc85"
121257902,Flor52Torrez,49,0,6,6,0.469787,0.534995,0.002432,"#ff7007"
121259222,gustavovaldivie,53,0,2,2,0.55016,0.736384,0.000486,"#008bdd"
121259803,C__Retamal,13,0,1,1,0.408522,0.490546,0,"#3bec00"
121283993,alexvase,10,0,2,2,0.396641,0.29743,0.000486,"#52d7c0"
121294485,LAURA_ELENA82,49,2,0,2,0.402672,0.564815,0.000486,"#ff7007"
121398330,InfoUMA,14,120,4,124,0.5703,0.536303,0.059825,"#00eeff"
121401745,softapps,1,1,0,1,0.490604,0.788373,0,"#b6cb00"
121420694,marclia,13,0,2,2,0.530476,0.475976,0.000486,"#3bec00"
121425987,BibCraiGandia,22,13,2,15,0.569702,0.388823,0.006809,"#00e8b2"
121528259,adrianaky,30,0,1,1,0.607936,0.452841,0,"#ff77ff"
121530610,AlvarezUned,30,22,21,43,0.657105,0.603457,0.020428,"#ff77ff"
121533235,josemiguelnovoa,49,1,0,1,0.337887,0.65736,0,"#ff7007"
121537176,ICETEX,49,2,0,2,0.416569,0.608821,0.000486,"#ff7007"
121614910,UPR_Oficial,23,1,0,1,0.182648,0.504155,0,"#005455"
121696333,juancobo,34,0,3,3,0.531758,0.388718,0.000973,"#ff0d69"
121716400,nachogallegop,58,0,3,3,0.591023,0.430671,0.000973,"#005076"
121722780,GreenData_News,14,0,1,1,0.678573,0.605009,0,"#00eeff"
121793513,vlatido,13,0,7,7,0.436692,0.440387,0.002918,"#3bec00"
121812156,MaestriasTecPue,13,1,0,1,0.367831,0.516531,0,"#3bec00"
121818654,diocesis_celaya,49,1,0,1,0.359317,0.640956,0,"#ff7007"
121819799,CulturaEdomex,41,0,1,1,0.254749,0.346359,0,"#697b00"
121890310,luzhernandezr,13,0,1,1,0.607519,0.996371,0,"#3bec00"
122017893,eitbeus,22,0,4,4,0.596829,0.854786,0.001459,"#00e8b2"
122025737,Red_Carolina,15,3,3,6,0.561581,0.699367,0.002432,"#008ebb"
122124151,Humanidades_AB,22,7,0,7,0.556201,0.59388,0.002918,"#00e8b2"
122146040,fgh_ulpgc,30,1,0,1,0.447887,0.603104,0,"#ff77ff"
122155618,carIosaguiIar,16,9,2,11,0.947374,0.660356,0.004864,"#c42c63"
122166081,Karinity,0,0,1,1,0.382891,0.571215,0,"#8ecfec"
122189408,soniastehoy,42,0,2,2,0.696244,0.434353,0.000486,"#66e087"
122271303,evegarmu,7,0,1,1,0.409899,0.321255,0,"#ffb800"
122353251,ComunidadMadrid,2,7,0,7,0.662214,0.719637,0.002918,"#ffa64e"
122385223,Marianaarqueo,4,0,6,6,0.4655,0.429644,0.002432,"#f4c8cf"
122390534,chabbie74,14,0,1,1,0.65438,0.606023,0,"#00eeff"
122417673,nilodavila,36,0,2,2,0.508736,0.300005,0.000486,"#825403"
122421026,JSotoonline,42,0,1,1,0.670341,0.394625,0,"#66e087"
122468872,JuanM_Romero,49,0,4,4,0.429511,0.520608,0.001459,"#ff7007"
122520367,romansuarezg,13,2,4,6,0.485491,0.444101,0.002432,"#3bec00"
122638550,ChristianFGauna,49,0,1,1,0.798835,0.579723,0,"#ff7007"
122692105,lereca,36,0,2,2,0.502753,0.295903,0.000486,"#825403"
122698321,gabrielbmiller,49,1,0,1,0.572273,0.324684,0,"#ff7007"
122738730,iperancho,37,2,0,2,0.517058,0.373477,0.000486,"#006032"
122751413,Alcaldia_Coy,7,0,1,1,0.362276,0.367259,0,"#ffb800"
122966388,AngelaOlmedo_,37,0,2,2,0.373893,0.495378,0.000486,"#006032"
123083176,joss3rg,21,1,0,1,0.22941,0.314025,0,"#c6cc85"
123125321,elisastill,13,0,1,1,0.527557,0.415671,0,"#3bec00"
123130352,jaruizm,13,2,45,47,0.510109,0.47391,0.022374,"#3bec00"
123133015,natguerra,0,0,3,3,0.428624,0.567384,0.000973,"#8ecfec"
123161159,yonamx,4,0,1,1,0.84631,0.238321,0,"#f4c8cf"
123194018,eliasgrayeb,49,1,0,1,0.333591,0.632165,0,"#ff7007"
123222820,ruizsanmiguel,30,0,2,2,0.585546,0.639145,0.000486,"#ff77ff"
123235606,Rober_G_,15,0,2,2,0.565129,0.647416,0.000486,"#008ebb"
123281671,iaminfinance,38,0,1,1,0.636877,0.356147,0,"#662859"
123286262,oscarcli2010,42,0,2,2,0.674105,0.427371,0.000486,"#66e087"
123298517,MAGutierrez112,13,0,1,1,0.430402,0.426089,0,"#3bec00"
123306072,dorygascu,15,2,0,2,0.655663,0.704621,0.000486,"#008ebb"
123335104,doikea,38,0,1,1,0.318855,0.191854,0,"#662859"
123338233,lutefisk812,13,0,1,1,0.366918,0.379514,0,"#3bec00"
123358448,generaccionperu,49,2,0,2,0.438396,0.624171,0.000486,"#ff7007"
123378562,ETSIIUPM,31,1,0,1,0.668672,0.550101,0,"#3e93ff"
123390907,rubencaravaca,13,0,1,1,0.425055,0.522314,0,"#3bec00"
123471479,uclm_es,15,49,3,52,0.55371,0.63203,0.024805,"#008ebb"
123515552,ESFGALICIA,0,0,2,2,0.441237,0.427979,0.000486,"#8ecfec"
123605279,clubby73,30,0,1,1,0.4881,0.650743,0,"#ff77ff"
123606160,revistasunam,13,4,0,4,0.438847,0.348362,0.001459,"#3bec00"
123695829,elaragon,3,1,0,1,0.636431,0.57791,0,"#ffb3ff"
123715428,rmcamposvazquez,7,1,4,5,0.44249,0.358911,0.001946,"#ffb800"
123788812,jorgemartin1492,13,0,1,1,0.393774,0.446529,0,"#3bec00"
123834102,ROMERACAS,49,1,0,1,0.336135,0.642649,0,"#ff7007"
123904982,noraquirozgil,49,0,6,6,0.474041,0.552533,0.002432,"#ff7007"
123911861,gonzaloyarzun,14,0,2,2,0.647701,0.566366,0.000486,"#00eeff"
123913826,Carlos_lastra,21,0,1,1,0.168485,0.244289,0,"#c6cc85"
123944767,_apei,19,3,2,5,0.6298,0.616789,0.001946,"#00d3ff"
123949057,Enriquevillalba,31,96,45,141,0.558754,0.551542,0.068093,"#3e93ff"
123979398,soleferreiro,31,0,1,1,0.750069,0.915923,0,"#3e93ff"
124031135,GustavoSilvaV,49,1,0,1,0.376901,0.668598,0,"#ff7007"
124147306,sophiealamo,49,20,17,37,0.473584,0.556267,0.01751,"#ff7007"
124154741,UNavarra,37,1,0,1,0.622995,0.346262,0,"#006032"
124158282,portal_com,3,44,0,44,0.568869,0.635954,0.020914,"#ffb3ff"
124178932,Pato_CH,37,0,1,1,0.440804,0.669661,0,"#006032"
124182351,UdGBiblioteca,14,5,0,5,0.640786,0.550083,0.001946,"#00eeff"
124226206,QuintaBolivar,38,0,3,3,0.462705,0.458715,0.000973,"#662859"
124248002,keane3pa,13,0,1,1,0.507528,0.31091,0,"#3bec00"
124367316,funkyclaus,7,0,2,2,0.349601,0.550834,0.000486,"#ffb800"
124420482,angelschacon,8,5,0,5,0.658898,0.327172,0.001946,"#00ed5d"
124503241,j_gorrin,42,0,4,4,0.695627,0.475656,0.001459,"#66e087"
124537110,Xavier_Gimeno,7,0,1,1,0.495315,0.699781,0,"#ffb800"
124545762,mirrocafort,49,3,0,3,0.434421,0.599181,0.000973,"#ff7007"
124595534,MxAlvrz,8,0,1,1,0.344115,0.513321,0,"#00ed5d"
124810486,weorchard,34,0,2,2,0.357007,0.426284,0.000486,"#ff0d69"
124828281,patriciaosoriod,31,0,1,1,0.635262,0.50157,0,"#3e93ff"
124832857,tr3asures,36,0,1,1,0.083292,0.708426,0,"#825403"
124866877,pop3punto0,31,1,0,1,0.68277,0.53587,0,"#3e93ff"
124867377,pramacracing,49,2,0,2,0.415179,0.556566,0.000486,"#ff7007"
124888507,marlurez,3,0,1,1,0.479767,0.767355,0,"#ffb3ff"
124896940,inescasher,34,0,2,2,0.547469,0.462084,0.000486,"#ff0d69"
124911693,gabybortz,3,0,2,2,0.457749,0.527421,0.000486,"#ffb3ff"
125029284,gustapa,3,0,1,1,0.452905,0.772202,0,"#ffb3ff"
125073740,tu_profe,49,1,0,1,0.397795,0.69398,0,"#ff7007"
125075740,aeperezt,22,0,1,1,0.241087,0.690466,0,"#00e8b2"
125086015,martinked,3,2,1,3,0.433249,0.565111,0.000973,"#ffb3ff"
125112507,isaacbuzo,30,1,3,4,0.494156,0.695258,0.001459,"#ff77ff"
125138132,Isabelsilva_7,49,0,1,1,0.319916,0.303435,0,"#ff7007"
125186047,rbe_pt,3,0,1,1,0.579572,0.875228,0,"#ffb3ff"
125286452,maria_gala_,7,0,1,1,0.825861,0.551439,0,"#ffb800"
125368584,LuismiMacias,30,0,2,2,0.546513,0.61403,0.000486,"#ff77ff"
125391822,usal,58,115,16,131,0.496576,0.57729,0.06323,"#005076"
125399659,deisy_hdz,10,0,1,1,0.402436,0.295055,0,"#52d7c0"
125476656,Licocel,7,0,1,1,0.745397,0.360596,0,"#ffb800"
125492493,ivan_bomfim,36,0,2,2,0.49538,0.343851,0.000486,"#825403"
125620036,FundacionETNOR,0,2,1,3,0.259987,0.667912,0.000973,"#8ecfec"
125625907,uaberta,36,1,1,2,0.538248,0.353253,0.000486,"#825403"
125640115,univcadiz,37,4,0,4,0.592419,0.395402,0.001459,"#006032"
125716923,diegoarielvega,49,0,2,2,0.439747,0.511866,0.000486,"#ff7007"
125719131,veromadrigalr,7,0,1,1,0.851707,0.551356,0,"#ffb800"
125732577,Verbigeni,22,0,1,1,0.584741,0.625428,0,"#00e8b2"
125733124,uquipermui,22,2,4,6,0.554905,0.600384,0.002432,"#00e8b2"
125774523,ProfeLagrotta,22,0,1,1,0.725955,0.35923,0,"#00e8b2"
125790921,masharaida,22,0,1,1,0.555284,0.816705,0,"#00e8b2"
125842703,zeuzcool,49,1,0,1,0.417084,0.666562,0,"#ff7007"
125855176,BenitoHamidian,8,0,1,1,0.257794,0.262179,0,"#00ed5d"
125876955,AnaVGuerrero,13,0,2,2,0.430022,0.396499,0.000486,"#3bec00"
125951671,akramzarefi,19,1,6,7,0.631998,0.755211,0.002918,"#00d3ff"
126000155,RV1805,15,0,1,1,0.530278,0.688359,0,"#008ebb"
126046946,katrinrulokoz,49,0,1,1,0.292314,0.523815,0,"#ff7007"
126049188,UNIMINUTOSP,3,1,0,1,0.292817,0.570711,0,"#ffb3ff"
126060706,nanisaur,13,0,2,2,0.447495,0.422241,0.000486,"#3bec00"
126071411,Hatshepsut1976,30,0,3,3,0.484156,0.618561,0.000973,"#ff77ff"
126080304,nuriamolines,15,0,1,1,0.535972,0.67363,0,"#008ebb"
126114776,Paukiernan,3,0,5,5,0.47657,0.614402,0.001946,"#ffb3ff"
126115781,GustavoIbarraPy,14,0,2,2,0.626958,0.527111,0.000486,"#00eeff"
126307688,Bamma8Slamma,31,0,3,3,0.652485,0.551118,0.000973,"#3e93ff"
126318945,ArjanVanHessen,13,0,1,1,0.413338,0.409908,0,"#3bec00"
126343100,FotocopiasBarat,31,0,1,1,0.666932,0.552256,0,"#3e93ff"
126364432,ceciliaganan,22,1,1,2,0.553178,0.660717,0.000486,"#00e8b2"
126428574,Yamile_Morales,13,0,2,2,0.4555,0.381502,0.000486,"#3bec00"
126516871,eltecnofilo,34,0,1,1,0.56032,0.335353,0,"#ff0d69"
126530608,Agnoscisneme,7,11,5,16,0.429027,0.363471,0.007296,"#ffb800"
126569186,luispardo1,49,1,0,1,0.338296,0.592537,0,"#ff7007"
126649657,FundacionBarrie,55,3,2,5,0.609013,0.546793,0.001946,"#cb3f32"
126682255,EleMercury13,37,2,1,3,0.583363,0.458687,0.000973,"#006032"
126707944,ConcursoEustory,30,1,1,2,0.56586,0.318725,0.000486,"#ff77ff"
126750806,eudisjesus,49,1,2,3,0.439771,0.539071,0.000973,"#ff7007"
126774554,Becante13,30,0,6,6,0.442397,0.559762,0.002432,"#ff77ff"
126875932,Rwhistle,49,1,0,1,0.369372,0.687266,0,"#ff7007"
126906429,ARLnews,13,2,0,2,0.404893,0.475662,0.000486,"#3bec00"
126915698,kateclaytonh,30,0,1,1,0.583426,0.556924,0,"#ff77ff"
126928429,jean_bauer,13,4,13,17,0.484213,0.485275,0.007782,"#3bec00"
126935578,CharlyVerdeLeon,49,1,0,1,0.278963,0.636549,0,"#ff7007"
127002495,Arantxa2012,34,0,2,2,0.451426,0.413262,0.000486,"#ff0d69"
127021810,elotrojames,55,0,4,4,0.565912,0.496285,0.001459,"#cb3f32"
127031280,sebasarte,3,0,1,1,0.462281,0.765548,0,"#ffb3ff"
127156042,SANTOSGZAPATA,49,1,0,1,0.432831,0.674752,0,"#ff7007"
127158951,juanomarfierro,4,0,1,1,0.867662,0.226827,0,"#f4c8cf"
127161215,educacion3_0,9,4,0,4,0.485488,0.625913,0.001459,"#008f7b"
127257763,EdgarJavierHC,49,1,0,1,0.361385,0.699885,0,"#ff7007"
127295999,ecojaguar,3,0,1,1,0.448319,0.749006,0,"#ffb3ff"
127308740,alroca01,38,1,3,4,0.472577,0.430971,0.001459,"#662859"
127344027,anselmolucio,31,0,1,1,0.677965,0.544906,0,"#3e93ff"
127391928,amayorsuma,38,0,1,1,0.617081,0.357162,0,"#662859"
127427175,yesickk,49,1,0,1,0.373331,0.65141,0,"#ff7007"
127538861,dearlizarazo,38,0,3,3,0.39473,0.380159,0.000973,"#662859"
127547684,javierfsa,3,0,2,2,0.449824,0.625487,0.000486,"#ffb3ff"
127567414,culturacoyoacan,7,1,0,1,0.408238,0.308834,0,"#ffb800"
127588840,centromemoria,38,1,0,1,0.528177,0.36091,0,"#662859"
127627682,MP_Marketing,49,1,0,1,0.323682,0.638228,0,"#ff7007"
127665374,Piponalandia,39,0,1,1,0.695947,0.761047,0,"#ff77f7"
127680067,lmiguelgs,9,0,4,4,0.654642,0.614777,0.001459,"#008f7b"
127680895,panchodicri,49,1,0,1,0.355092,0.675351,0,"#ff7007"
127713947,julianlpzmtz,22,0,2,2,0.685764,0.45633,0.000486,"#00e8b2"
127799326,mestresbcn,14,0,2,2,0.747943,0.499055,0.000486,"#00eeff"
127831696,ccooandalucia,19,1,0,1,0.671512,0.768225,0,"#00d3ff"
127839245,robertoigarza,49,2,3,5,0.452387,0.550967,0.001946,"#ff7007"
127871926,juancarlosgp_,0,0,1,1,0.38499,0.564334,0,"#8ecfec"
127905882,nidiachavez,0,3,11,14,0.448341,0.523117,0.006323,"#8ecfec"
127924435,Karencitarunner,14,0,2,2,0.623321,0.520802,0.000486,"#00eeff"
127954917,Astroandrea,3,0,1,1,0.451385,0.765499,0,"#ffb3ff"
127961375,onthehumanities,30,1,0,1,0.588063,0.567118,0,"#ff77ff"
127963445,CultivateArts,41,1,0,1,0.249137,0.330732,0,"#697b00"
127973484,pfelipm,34,2,0,2,0.418573,0.449054,0.000486,"#ff0d69"
128045880,pacobib,3,0,4,4,0.545989,0.588833,0.001459,"#ffb3ff"
128094700,DayisdelaRosa,30,0,1,1,0.473067,0.678616,0,"#ff77ff"
128192592,mapibaez,30,2,0,2,0.556955,0.656393,0.000486,"#ff77ff"
128196131,triplingual,30,0,14,14,0.483736,0.489784,0.006323,"#ff77ff"
128212655,EdicionUDP,22,0,1,1,0.596449,0.687573,0,"#00e8b2"
128240058,universidata,49,1,0,1,0.363057,0.606955,0,"#ff7007"
128272929,ivanmieres,19,0,1,1,0.654375,0.787844,0,"#00d3ff"
128286711,ap4ntoja,19,3,5,8,0.598943,0.642479,0.003405,"#00d3ff"
128366820,valeria0817,38,0,1,1,0.457174,0.788355,0,"#662859"
128372940,jairbolsonaro,25,4,0,4,0.583666,0.102367,0.001459,"#f4a2ff"
128378328,Katjktp,34,2,6,8,0.464362,0.522419,0.003405,"#ff0d69"
128401189,johnfmontes,38,0,2,2,0.584007,0.356031,0.000486,"#662859"
128564410,universidad_uci,49,1,0,1,0.36496,0.728215,0,"#ff7007"
128587123,oriolamat,8,6,0,6,0.630572,0.400131,0.002432,"#00ed5d"
128598419,Luna_Abeja,38,0,1,1,0.611651,0.351174,0,"#662859"
128653307,Monumentos_cl,21,0,2,2,0.198499,0.264178,0.000486,"#c6cc85"
128686375,martynjimenez,13,0,1,1,0.445091,0.315244,0,"#3bec00"
128870762,CostanSequeiros,13,0,1,1,0.382853,0.495735,0,"#3bec00"
128882329,COACHELLAEVENTS,30,0,1,1,0.576216,0.665318,0,"#ff77ff"
128910302,eajournal,3,3,2,5,0.48324,0.524315,0.001946,"#ffb3ff"
128921155,nydiaruiz,35,0,1,1,0.727182,0.423915,0,"#00faff"
128936533,biblum,30,1,0,1,0.581674,0.561518,0,"#ff77ff"
128965799,Sandromaca,22,1,1,2,0.507204,0.607421,0.000486,"#00e8b2"
128995611,everebo1,49,1,0,1,0.389178,0.638383,0,"#ff7007"
129000751,lanuitderobbie,7,0,1,1,0.821573,0.560584,0,"#ffb800"
129009373,10MilLibros,55,1,0,1,0.490103,0.741471,0,"#cb3f32"
129253485,museoelder,30,5,0,5,0.56853,0.671839,0.001946,"#ff77ff"
129254218,gonza_andres,9,0,1,1,0.67355,0.432643,0,"#008f7b"
129376567,JMGallegosF,13,0,1,1,0.395426,0.488455,0,"#3bec00"
129458976,jordrih,30,0,1,1,0.618997,0.47652,0,"#ff77ff"
129510550,_miriku_,30,0,1,1,0.7425,0.594422,0,"#ff77ff"
129528184,esquilo_antonio,31,0,1,1,0.685994,0.518967,0,"#3e93ff"
129539781,dcartesiano,34,0,2,2,0.59359,0.419741,0.000486,"#ff0d69"
129596166,CarmeFenoll,8,1,11,12,0.637901,0.358151,0.00535,"#00ed5d"
129602359,DavidMexEs,3,0,1,1,0.685501,0.719795,0,"#ffb3ff"
129643463,JV_Rubio,38,0,1,1,0.315662,0.196738,0,"#662859"
129647202,AlexisBolbaran,21,0,1,1,0.181778,0.219642,0,"#c6cc85"
129815466,cobdcv,14,0,1,1,0.459898,0.675093,0,"#00eeff"
129834397,RazonPublica,13,7,2,9,0.545021,0.413741,0.003891,"#3bec00"
129842675,Ingridguardiola,14,6,2,8,0.655702,0.511359,0.003405,"#00eeff"
129845276,InfotecMexico,13,0,1,1,0.436462,0.412555,0,"#3bec00"
129852766,encastan,38,0,1,1,0.228224,0.582174,0,"#662859"
129922490,marinavalles,22,0,4,4,0.591703,0.544263,0.001459,"#00e8b2"
130003983,izabelxavier,36,0,2,2,0.555827,0.408085,0.000486,"#825403"
130107473,EAGuada,19,1,0,1,0.675041,0.766246,0,"#00d3ff"
130108158,gladysth,13,0,1,1,0.438289,0.310162,0,"#3bec00"
130151601,euricotu,36,0,2,2,0.541163,0.436024,0.000486,"#825403"
130173169,asolermarin,49,1,0,1,0.408502,0.643193,0,"#ff7007"
130214014,Sandalabarros,36,2,0,2,0.506288,0.344526,0.000486,"#825403"
130226550,parra1959,8,1,2,3,0.655251,0.303176,0.000973,"#00ed5d"
130233253,alecitacardenas,34,0,3,3,0.492056,0.423375,0.000973,"#ff0d69"
130237305,manuel_suarez_,13,1,2,3,0.464083,0.383842,0.000973,"#3bec00"
130298649,diariojudio,37,1,0,1,0.558975,0.361095,0,"#006032"
130300937,jperezarellano,3,3,2,5,0.459283,0.795434,0.001946,"#ffb3ff"
130348197,DoodMilan,4,0,1,1,0.852518,0.222459,0,"#f4c8cf"
130400251,lalopachenko,37,2,1,3,0.494235,0.419701,0.000973,"#006032"
130472933,Catigupe,14,2,2,4,0.683672,0.521502,0.001459,"#00eeff"
130476999,albertovargas30,49,1,0,1,0.28474,0.630991,0,"#ff7007"
130530714,emma_morlock,30,0,1,1,0.425386,0.492685,0,"#ff77ff"
130634896,jandradej,34,0,1,1,0.496267,0.373095,0,"#ff0d69"
130689980,paubelt,34,1,1,2,0.40408,0.466687,0.000486,"#ff0d69"
130718015,LesroseAmador,0,0,2,2,0.600775,0.541542,0.000486,"#8ecfec"
130719480,3dpoder,49,1,0,1,0.369908,0.62861,0,"#ff7007"
130823696,CirculolecRoma,34,0,4,4,0.500664,0.447527,0.001459,"#ff0d69"
130828533,KU_Leuven,41,3,0,3,0.362533,0.301755,0.000973,"#697b00"
130848291,zirigozacom,49,1,0,1,0.301934,0.614279,0,"#ff7007"
130864812,patron_carina,55,0,5,5,0.653181,0.670223,0.001946,"#cb3f32"
130868126,mateotw,1,1,5,6,0.443455,0.570058,0.002432,"#b6cb00"
130887370,susanagkp,55,0,2,2,0.665467,0.672791,0.000486,"#cb3f32"
130943731,CaroyCuervo,2,0,3,3,0.531105,0.509872,0.000973,"#ffa64e"
130979339,norabar,49,1,0,1,0.344937,0.660693,0,"#ff7007"
131052165,TeacherIndigo,13,0,1,1,0.513178,0.314208,0,"#3bec00"
131074305,jon_gut,36,0,2,2,0.777401,0.616499,0.000486,"#825403"
131129331,bruno_eiras,36,2,0,2,0.553514,0.428447,0.000486,"#825403"
131138085,exiliadas,31,12,1,13,0.60265,0.584982,0.005837,"#3e93ff"
131183090,gimnasiodeactor,14,0,1,1,0.393082,0.538425,0,"#00eeff"
131196823,Labuccio,13,0,2,2,0.430441,0.41497,0.000486,"#3bec00"
131197115,lucianohistoria,49,0,1,1,0.488705,0.355543,0,"#ff7007"
131209625,hugoandreffa,36,0,1,1,0.509425,0.240938,0,"#825403"
131214168,AngiieOG,38,0,1,1,0.800401,0.654114,0,"#662859"
131243393,Museologique,22,0,1,1,0.554202,0.687264,0,"#00e8b2"
131288180,casadelahuizote,13,7,6,13,0.44184,0.458337,0.005837,"#3bec00"
131362572,fortizvizuete,3,0,3,3,0.576258,0.576783,0.000973,"#ffb3ff"
131368505,argamax89,13,0,6,6,0.446583,0.478429,0.002432,"#3bec00"
131445454,usersergio,21,0,2,2,0.256716,0.225228,0.000486,"#c6cc85"
131518165,AMorenoAncillo,15,0,3,3,0.570674,0.617658,0.000973,"#008ebb"
131678020,Mash_abeja,38,0,1,1,0.115635,0.796302,0,"#662859"
131691132,Lauraagomezc,38,0,1,1,0.320934,0.17173,0,"#662859"
131720153,Edgar_Ivan_G,31,0,4,4,0.645633,0.540592,0.001459,"#3e93ff"
131787417,yskmas_k_66,2,0,2,2,0.677966,0.655439,0.000486,"#ffa64e"
131811653,dantespuppet,37,0,4,4,0.500666,0.520283,0.001459,"#006032"
131878801,vruizt,3,0,7,7,0.475997,0.603509,0.002918,"#ffb3ff"
131890013,lenardijch,42,0,1,1,0.711897,0.457443,0,"#66e087"
131901040,marianadeoz,13,0,3,3,0.479984,0.423232,0.000973,"#3bec00"
131961403,claudiohhgordo,13,0,4,4,0.496758,0.510749,0.001459,"#3bec00"
131969363,alejomantillaq,38,0,1,1,0.72677,0.317678,0,"#662859"
132035959,lamaroc,49,0,5,5,0.421694,0.482136,0.001946,"#ff7007"
132132521,CARMENBORONAT,8,1,0,1,0.669833,0.251478,0,"#00ed5d"
132147730,caavila,36,0,1,1,0.557718,0.24596,0,"#825403"
132156322,marina_izqdo,30,0,1,1,0.624993,0.607025,0,"#ff77ff"
132204002,manuel_de_leon,31,1,1,2,0.569769,0.562536,0.000486,"#3e93ff"
132231005,MichelDeLHerbe,21,0,1,1,0.181164,0.224967,0,"#c6cc85"
132238546,bobadillamaria,1,0,2,2,0.638263,0.467612,0.000486,"#b6cb00"
132272611,LillianBriseno,38,0,3,3,0.501589,0.488609,0.000973,"#662859"
132278677,pekitsch39,13,0,9,9,0.511724,0.485438,0.003891,"#3bec00"
132283137,scMFA,34,0,2,2,0.359121,0.400423,0.000486,"#ff0d69"
132310937,effusivelynerdy,34,0,8,8,0.498394,0.509313,0.003405,"#ff0d69"
132335005,guillermochave,7,0,1,1,0.36382,0.319552,0,"#ffb800"
132352604,hilodigital,30,1,21,22,0.531785,0.526642,0.010214,"#ff77ff"
132377460,bartolin2067,38,0,1,1,0.674957,0.462852,0,"#662859"
132396202,ondinabea,42,0,3,3,0.721465,0.430085,0.000973,"#66e087"
132398988,gonzalezestevez,42,0,1,1,0.854723,0.460646,0,"#66e087"
132435936,THATCampFR,30,1,0,1,0.536861,0.624644,0,"#ff77ff"
132462698,colsocpona,1,2,2,4,0.639765,0.472259,0.001459,"#b6cb00"
132500181,salazarsalgado,0,0,2,2,0.4406,0.389918,0.000486,"#8ecfec"
132527736,XPeivon,30,0,2,2,0.54617,0.598818,0.000486,"#ff77ff"
132539707,pmezama,30,0,1,1,0.503885,0.61418,0,"#ff77ff"
132576385,buhopalido,22,0,1,1,0.616511,0.613417,0,"#00e8b2"
132605018,avinc1,34,0,3,3,0.604664,0.398529,0.000973,"#ff0d69"
132631349,aguiausp,36,4,1,5,0.480924,0.350319,0.001946,"#825403"
132679292,LisiaMendes,36,0,2,2,0.505123,0.339153,0.000486,"#825403"
132721661,crb8sp,36,1,0,1,0.57597,0.394724,0,"#825403"
132765568,0swaldoAguilar,34,0,3,3,0.434546,0.477493,0.000973,"#ff0d69"
132774811,AzhaAmir,14,0,1,1,0.710906,0.039617,0,"#00eeff"
132792612,AM_ISRAEL,13,1,3,4,0.48229,0.384522,0.001459,"#3bec00"
132911490,pepcerda,15,0,4,4,0.567381,0.534699,0.001459,"#008ebb"
132916115,RubenConde_,31,0,1,1,0.628165,0.593531,0,"#3e93ff"
132930582,BecariosFLC,13,2,1,3,0.453866,0.46417,0.000973,"#3bec00"
132947177,Aggiejeria,22,0,1,1,0.612616,0.627556,0,"#00e8b2"
133004391,MargaritaNunezC,14,0,2,2,0.634401,0.532323,0.000486,"#00eeff"
133075303,Tlozferk,35,1,4,5,0.565669,0.427447,0.001946,"#00faff"
133082012,zoilacuartin,49,1,0,1,0.394285,0.658394,0,"#ff7007"
133092960,Nivardot,7,2,1,3,0.668362,0.489808,0.000973,"#ffb800"
133210608,nikepasa,14,0,1,1,0.560484,0.450001,0,"#00eeff"
133239343,ArquivoWeb_PT,36,1,0,1,0.578902,0.417792,0,"#825403"
133361792,institutomora,13,6,3,9,0.431377,0.440781,0.003891,"#3bec00"
133382202,FIMA_UB,22,8,8,16,0.577523,0.573159,0.007296,"#00e8b2"
133392251,MichaelRomeroR,38,0,1,1,0.567532,0.276727,0,"#662859"
133415058,casaoswaldocruz,36,32,2,34,0.533805,0.322992,0.016051,"#825403"
133439438,amadeupons,22,0,6,6,0.593427,0.576902,0.002432,"#00e8b2"
133490229,MfSilva70,36,0,3,3,0.535842,0.418152,0.000973,"#825403"
133552941,Ashesi,34,1,0,1,0.31496,0.416655,0,"#ff0d69"
133671326,SoniaMulero,14,3,1,4,0.673889,0.528142,0.001459,"#00eeff"
133728812,tulioalvarez,49,2,0,2,0.405698,0.620458,0.000486,"#ff7007"
133740232,ivansottoh,3,9,5,14,0.47199,0.733206,0.006323,"#ffb3ff"
133745806,loockito,21,0,2,2,0.213476,0.2528,0.000486,"#c6cc85"
133761724,carlosmallen69,7,0,1,1,0.521212,0.184571,0,"#ffb800"
133821228,Lucianowuzu,7,0,3,3,0.438499,0.365556,0.000973,"#ffb800"
133921228,MMS48,30,0,1,1,0.667966,0.830407,0,"#ff77ff"
133960413,Nacho_Vertebra,17,0,1,1,0.802819,0.216556,0,"#ff9cc7"
133973116,vlablah,13,0,2,2,0.592268,0.271593,0.000486,"#3bec00"
134037648,unizar,22,3,0,3,0.556857,0.570464,0.000973,"#00e8b2"
134242743,patrimass,21,0,2,2,0.255241,0.236194,0.000486,"#c6cc85"
134288567,jotaclavijo,38,0,1,1,0.617579,0.348451,0,"#662859"
134296976,hacklib,13,4,14,18,0.446628,0.441287,0.008268,"#3bec00"
134393845,luiscorre_a,49,0,2,2,0.41062,0.387789,0.000486,"#ff7007"
134498026,colegeografos,22,11,5,16,0.60005,0.459228,0.007296,"#00e8b2"
134518574,mapwarper,4,1,0,1,0.846225,0.222942,0,"#f4c8cf"
134555441,Jennibolivargud,49,0,3,3,0.457101,0.560439,0.000973,"#ff7007"
134754834,IN3_UOC,14,6,1,7,0.623641,0.549143,0.002918,"#00eeff"
134810685,grupoconjor,36,1,1,2,0.492167,0.356568,0.000486,"#825403"
134858092,esvinag,57,0,1,1,0.707236,0.539323,0,"#b66f7a"
134871534,MemonoMo,13,0,2,2,0.456454,0.465894,0.000486,"#3bec00"
134877355,monohernandez,34,0,1,1,0.623827,0.312678,0,"#ff0d69"
134888113,kmikast,3,0,1,1,0.707434,0.703225,0,"#ffb3ff"
134889374,DIEROX05,49,1,0,1,0.318093,0.631738,0,"#ff7007"
134899113,PhilippeMeers,31,0,1,1,0.705914,0.262477,0,"#3e93ff"
134908464,virgicinq,37,0,5,5,0.552603,0.521596,0.001946,"#006032"
134916725,ecalderonc,49,1,0,1,0.300328,0.645136,0,"#ff7007"
134921020,K_Leonard_PhD,34,0,5,5,0.403374,0.475984,0.001946,"#ff0d69"
135066776,maitemoreno19,14,0,1,1,0.411851,0.525565,0,"#00eeff"
135081147,granadadigital,31,4,6,10,0.565198,0.522409,0.004377,"#3e93ff"
135145900,laVeilleTechno,0,0,2,2,0.531641,0.430958,0.000486,"#8ecfec"
135146549,idafensp,22,0,3,3,0.563656,0.669501,0.000973,"#00e8b2"
135178777,UMontreal,30,1,0,1,0.546492,0.621473,0,"#ff77ff"
135193517,PaulinaMarfull,21,0,2,2,0.262807,0.233083,0.000486,"#c6cc85"
135204789,channelbps,49,1,0,1,0.370273,0.641983,0,"#ff7007"
135330830,jyfergon,22,0,2,2,0.54979,0.629537,0.000486,"#00e8b2"
135366432,abe_yorke,13,0,3,3,0.410213,0.397203,0.000973,"#3bec00"
135408148,jhergong,1,0,2,2,0.453265,0.703177,0.000486,"#b6cb00"
135439371,gte_uib,22,0,2,2,0.362507,0.502965,0.000486,"#00e8b2"
135441822,bodleianlibs,36,3,0,3,0.451656,0.349591,0.000973,"#825403"
135569575,CCOOMadrid,19,3,0,3,0.621219,0.759805,0.000973,"#00d3ff"
135589321,tonysantoyo,3,0,1,1,0.700747,0.710627,0,"#ffb3ff"
135628882,arteagasbtn,14,2,0,2,0.599045,0.57877,0.000486,"#00eeff"
135635051,gustavo_urbano,49,5,0,5,0.442912,0.500497,0.001946,"#ff7007"
135716096,MarcesWisdom,34,0,4,4,0.457668,0.450212,0.001459,"#ff0d69"
135733620,xhardez,49,0,4,4,0.422607,0.552691,0.001459,"#ff7007"
135797435,igarate,49,0,1,1,0.418804,0.62582,0,"#ff7007"
135828994,FBVMC,34,25,14,39,0.456877,0.503806,0.018482,"#ff0d69"
135945057,RCMLondon,22,1,0,1,0.423936,0.704408,0,"#00e8b2"
135947492,lulideperez,37,1,0,1,0.578714,0.360527,0,"#006032"
135953646,UIS,34,6,2,8,0.566463,0.314723,0.003405,"#ff0d69"
135978115,karlosamuel,13,0,1,1,0.448213,0.360557,0,"#3bec00"
136003436,Sonriend0,2,0,1,1,0.751999,0.612762,0,"#ffa64e"
136004826,HermanParraA,9,0,2,2,0.699547,0.657105,0.000486,"#008f7b"
136015474,aquieffe,4,0,2,2,0.507547,0.382768,0.000486,"#f4c8cf"
136028436,mayshida,36,0,2,2,0.475884,0.247706,0.000486,"#825403"
136072898,Thinksamuel,36,4,2,6,0.519913,0.383579,0.002432,"#825403"
136205259,FGCSIC,22,6,0,6,0.613826,0.533955,0.002432,"#00e8b2"
136243285,dariomontoya,9,1,0,1,0.712054,0.751093,0,"#008f7b"
136285682,agenciaiisi,30,5,0,5,0.570363,0.671268,0.001946,"#ff77ff"
136294318,Davmon9,34,0,2,2,0.557239,0.356429,0.000486,"#ff0d69"
136301675,MNBAChile,21,0,2,2,0.25087,0.241797,0.000486,"#c6cc85"
136301916,SoftwareSaved,34,1,0,1,0.457803,0.540033,0,"#ff0d69"
136370967,uamcuajimalpa,8,4,0,4,0.378912,0.538076,0.001459,"#00ed5d"
136372401,TolimaPacto,3,0,1,1,0.479909,0.771304,0,"#ffb3ff"
136377424,FTMovistarAr,0,0,2,2,0.439471,0.582605,0.000486,"#8ecfec"
136400177,gamadorc,7,0,1,1,0.419645,0.325931,0,"#ffb800"
136405488,EfeEmeErre,21,0,1,1,0.475574,0.944474,0,"#c6cc85"
136426609,jcpastrana,49,3,0,3,0.452358,0.557916,0.000973,"#ff7007"
136441278,adreus1,49,0,1,1,0.378358,0.604398,0,"#ff7007"
136468309,saulocolon,34,0,2,2,0.352207,0.402526,0.000486,"#ff0d69"
136478491,imasmand,37,0,2,2,0.366645,0.341858,0.000486,"#006032"
136534876,MayRolonRollet,3,1,1,2,0.462395,0.635199,0.000486,"#ffb3ff"
136556117,FCaparros,49,1,0,1,0.334148,0.640482,0,"#ff7007"
136611663,palinuro1,13,0,1,1,0.408182,0.477995,0,"#3bec00"
136683941,msdmao,38,0,1,1,0.444058,0.777332,0,"#662859"
136698973,vultriaisk,3,0,1,1,0.464971,0.754945,0,"#ffb3ff"
136721508,ismagonzalez,37,0,1,1,0.585456,0.325162,0,"#006032"
136762988,JosiasRincon,36,0,1,1,0.518016,0.284103,0,"#825403"
136773242,KropTor,58,0,1,1,0.568391,0.183907,0,"#005076"
136967114,FundacionINCYDE,14,1,0,1,0.5984,0.37204,0,"#00eeff"
136983882,dr_aguarras,34,0,4,4,0.52309,0.451677,0.001459,"#ff0d69"
137057379,JMBurns99,13,0,1,1,0.490208,0.362827,0,"#3bec00"
137061126,Mariahdzroyett,0,0,2,2,0.439733,0.390451,0.000486,"#8ecfec"
137093893,AMHRyC,14,0,3,3,0.559314,0.602206,0.000973,"#00eeff"
137107582,aandreup,15,0,1,1,0.541176,0.702351,0,"#008ebb"
137122380,Indisse,38,0,1,1,0.125765,0.805506,0,"#662859"
137145974,EuristidesDLC,13,0,2,2,0.471994,0.341813,0.000486,"#3bec00"
137149503,epyllia,49,0,3,3,0.413302,0.503709,0.000973,"#ff7007"
137170176,CamilaGallegoM,38,0,1,1,0.520618,0.318537,0,"#662859"
137224187,MTerelugo,49,0,7,7,0.443378,0.560577,0.002918,"#ff7007"
137273883,diariodeleon,22,11,0,11,0.508535,0.616146,0.004864,"#00e8b2"
137292640,mariveh,31,1,4,5,0.586523,0.529348,0.001946,"#3e93ff"
137302034,culturauma,14,6,4,10,0.591001,0.524742,0.004377,"#00eeff"
137343095,SefaradIsrael,49,1,0,1,0.359803,0.700284,0,"#ff7007"
137350618,bmetric,49,1,0,1,0.388339,0.641544,0,"#ff7007"
137410750,ValdezVera,49,1,0,1,0.418359,0.674401,0,"#ff7007"
137430700,liliana_villet,42,0,4,4,0.744298,0.437628,0.001459,"#66e087"
137465667,PerroImpostor,7,0,1,1,0.826112,0.546357,0,"#ffb800"
137472749,crisfarres,8,9,5,14,0.684659,0.286178,0.006323,"#00ed5d"
137547187,marianromiti,49,0,2,2,0.434257,0.56559,0.000486,"#ff7007"
137568918,lucasllach,37,0,1,1,0.714377,0.469543,0,"#006032"
137748287,nildagra,37,0,2,2,0.255124,0.395346,0.000486,"#006032"
137828390,CeciliaVignolo,55,0,1,1,0.69073,0.67068,0,"#cb3f32"
137842512,edgarnr,49,1,0,1,0.398142,0.685517,0,"#ff7007"
137908875,ClaudiaLopez,38,3,0,3,0.506556,0.391326,0.000973,"#662859"
137968779,SEDIC20,22,2,1,3,0.534664,0.508492,0.000973,"#00e8b2"
137977131,BUCantabria,22,2,3,5,0.518012,0.582158,0.001946,"#00e8b2"
137977787,delegaETSII,1,0,1,1,0.402127,0.711468,0,"#b6cb00"
137989918,BraisRomanino,36,6,9,15,0.576772,0.426353,0.006809,"#825403"
138002919,HectorBelloSilv,22,0,2,2,0.609862,0.622981,0.000486,"#00e8b2"
138030544,107ulafm,42,4,0,4,0.980949,0.391769,0.001459,"#66e087"
138094631,MontGut,22,0,1,1,0.495438,0.674844,0,"#00e8b2"
138113718,gabitallarico,14,0,1,1,0.670682,0.517047,0,"#00eeff"
138113865,facfedmar,49,1,0,1,0.356756,0.610868,0,"#ff7007"
138118678,lauana2,31,0,1,1,0.631829,0.498587,0,"#3e93ff"
138123368,IIUNAM,7,1,1,2,0.659899,0.355167,0.000486,"#ffb800"
138147999,fgvbmhs,36,1,0,1,0.771115,0.328647,0,"#825403"
138156270,facsouchile,49,1,1,2,0.382895,0.339138,0.000486,"#ff7007"
138161380,mbutel,34,30,22,52,0.446952,0.49572,0.024805,"#ff0d69"
138184898,diegoberardogc,49,0,2,2,0.406492,0.610629,0.000486,"#ff7007"
138202770,Jon316,49,1,0,1,0.364809,0.630838,0,"#ff7007"
138206706,alvaromsaez,38,1,0,1,0.777311,0.591164,0,"#662859"
138216755,patrinavarros,40,0,1,1,0.62117,0.033266,0,"#ff12a3"
138227940,PabloBeta,42,0,2,2,0.686828,0.436225,0.000486,"#66e087"
138233981,RubriaR,41,0,7,7,0.433727,0.438163,0.002918,"#697b00"
138252023,GIL_UNAM,13,0,3,3,0.475327,0.366224,0.000973,"#3bec00"
138282000,Zeus_Apolo,40,0,1,1,0.609166,0.018964,0,"#ff12a3"
138329816,bpradosp,31,0,5,5,0.621502,0.547202,0.001946,"#3e93ff"
138433875,Patrimoniobta,38,0,1,1,0.731623,0.374194,0,"#662859"
138458064,FILBogota,38,4,0,4,0.599874,0.493675,0.001459,"#662859"
138506563,LAPerspectives,49,0,2,2,0.439658,0.558677,0.000486,"#ff7007"
138563076,isnardokun,38,1,0,1,0.671833,0.627874,0,"#662859"
138592307,JeanC1981,40,0,1,1,0.643237,0.018102,0,"#ff12a3"
138619304,vmmonte,48,4,0,4,0.21815,0.689102,0.001459,"#ff7a78"
138712739,sobralg,36,3,0,3,0.492173,0.411755,0.000973,"#825403"
138718000,letras_ciencia,58,0,2,2,0.615269,0.310415,0.000486,"#005076"
138768881,rgcmme,22,0,1,1,0.579533,0.733609,0,"#00e8b2"
138774183,edecanrm,34,0,1,1,0.544419,0.348524,0,"#ff0d69"
138798695,jjqc,8,0,1,1,0.267229,0.246168,0,"#00ed5d"
138813955,eltonteb,49,8,8,16,0.475049,0.505969,0.007296,"#ff7007"
138814038,NandaSDamas,36,1,0,1,0.441753,0.33821,0,"#825403"
138838089,antoninoycinia,22,0,1,1,0.669314,0.574139,0,"#00e8b2"
138856734,cristiancaiza,49,1,0,1,0.365174,0.645683,0,"#ff7007"
138927041,DanielArGimenez,49,1,0,1,0.350001,0.672496,0,"#ff7007"
138952058,_CamyArias,49,0,1,1,0.238991,0.67682,0,"#ff7007"
139061771,carlosauthier,49,4,15,19,0.475199,0.540126,0.008755,"#ff7007"
139141820,laura_martinezd,13,8,34,42,0.495387,0.447408,0.019942,"#3bec00"
139148731,Apez140,22,0,1,1,0.674527,0.596984,0,"#00e8b2"
139166540,caiocmello,36,0,4,4,0.509344,0.419495,0.001459,"#825403"
139252999,hagsdemesne87,0,0,2,2,0.506577,0.428215,0.000486,"#8ecfec"
139323538,ma_crossmedia,21,1,0,1,0.649114,0.160033,0,"#c6cc85"
139402443,RojiZur,0,0,2,2,0.451759,0.391163,0.000486,"#8ecfec"
139525231,SSHRC_CRSH,34,1,0,1,0.259144,0.62516,0,"#ff0d69"
139546098,silviaalejandra,0,0,1,1,0.543746,0.706702,0,"#8ecfec"
139667728,emmamilpalabras,14,0,3,3,0.635173,0.543147,0.000973,"#00eeff"
139674614,AndaluciaComDig,49,1,0,1,0.369138,0.642918,0,"#ff7007"
139680414,UniLeipzig,13,1,0,1,0.399326,0.396057,0,"#3bec00"
139689286,unileon,37,21,5,26,0.51944,0.588531,0.01216,"#006032"
139691796,flissina,34,1,0,1,0.311638,0.511242,0,"#ff0d69"
139704156,ANPUH,36,6,1,7,0.505167,0.382881,0.002918,"#825403"
139744458,ariannabec,13,1,1,2,0.444593,0.396003,0.000486,"#3bec00"
139768937,samsacsan,49,1,0,1,0.401353,0.647786,0,"#ff7007"
139777050,UniversidadUNAD,30,5,0,5,0.67072,0.597228,0.001946,"#ff77ff"
139790180,heleferway,7,0,3,3,0.493061,0.415332,0.000973,"#ffb800"
139807269,yanitadela,21,0,1,1,0.204604,0.213471,0,"#c6cc85"
139827883,AlbertRoBer,17,0,1,1,0.826404,0.24076,0,"#ff9cc7"
139847069,biblored,38,2,0,2,0.750684,0.401868,0.000486,"#662859"
139865711,centro_news,3,2,0,2,0.443448,0.622429,0.000486,"#ffb3ff"
139890718,peich1,49,1,0,1,0.340087,0.687296,0,"#ff7007"
139911585,cielosmochis,30,1,0,1,0.359978,0.707154,0,"#ff77ff"
140062688,aurorareal,34,0,2,2,0.445628,0.532145,0.000486,"#ff0d69"
140089731,Mathelen,42,0,2,2,0.69881,0.42905,0.000486,"#66e087"
140092403,hebusto,24,5,3,8,0.220592,0.616566,0.003405,"#ff9b8f"
140139568,villanito,13,0,1,1,0.325306,0.524893,0,"#3bec00"
140152180,navarrotradmed,58,19,7,26,0.534501,0.581758,0.01216,"#005076"
140206203,JaviviRuizJ,38,0,5,5,0.517327,0.412848,0.001946,"#662859"
140245186,RamiroAriza,13,0,1,1,0.527842,0.393768,0,"#3bec00"
140246718,chars727,49,1,0,1,0.31869,0.644727,0,"#ff7007"
140281779,Mireyaarellanob,21,0,2,2,0.25172,0.235372,0.000486,"#c6cc85"
140396901,molinalec,49,1,0,1,0.354038,0.631435,0,"#ff7007"
140463683,RoaJavier,49,1,0,1,0.351435,0.687007,0,"#ff7007"
140481516,gradunav,30,1,0,1,0.671287,0.603167,0,"#ff77ff"
140593804,polifoniared,22,1,0,1,0.49216,0.67178,0,"#00e8b2"
140599820,upiicsalibre,7,0,2,2,0.425878,0.387433,0.000486,"#ffb800"
140603836,NunchakuFilosof,38,0,1,1,0.563154,0.301289,0,"#662859"
140628714,diazcayeros,34,0,1,1,0.425019,0.267718,0,"#ff0d69"
140665322,historianess,30,0,1,1,0.575625,0.680653,0,"#ff77ff"
140720477,rachellambrecht,22,0,1,1,0.582079,0.724809,0,"#00e8b2"
140723305,mavillard,13,0,2,2,0.548559,0.445144,0.000486,"#3bec00"
140765877,Rocio_Niebla,14,1,0,1,0.389978,0.815955,0,"#00eeff"
140825793,nferreras,36,0,2,2,0.489772,0.302623,0.000486,"#825403"
140836293,JayalaS_,38,0,1,1,0.534493,0.320287,0,"#662859"
140849161,pabl80,1,0,2,2,0.408139,0.545189,0.000486,"#b6cb00"
140887581,uspfflch,37,3,0,3,0.528218,0.350509,0.000973,"#006032"
140961034,isabel_serra,21,0,1,1,0.318767,0.461942,0,"#c6cc85"
140995809,jhoncaballerom,38,0,1,1,0.668499,0.420731,0,"#662859"
141074777,FJUB,42,0,2,2,0.691442,0.471301,0.000486,"#66e087"
141135344,AsianStudies,15,1,0,1,0.475301,0.643279,0,"#008ebb"
141186678,lmi_net,3,0,3,3,0.39626,0.503233,0.000973,"#ffb3ff"
141244061,tumasymejor,22,7,5,12,0.610247,0.561176,0.00535,"#00e8b2"
141250520,saraborondo,38,0,1,1,0.819398,0.639044,0,"#662859"
141251578,estebansar,20,0,1,1,0.39116,0.072091,0,"#f0be45"
141261950,HILIADA,9,0,1,1,0.726578,0.673934,0,"#008f7b"
141270905,ClaudiC2,49,0,1,1,0.282295,0.489729,0,"#ff7007"
141285637,MABANICA,7,0,1,1,0.777661,0.317004,0,"#ffb800"
141314389,haydeelugo,14,0,1,1,0.327244,0.503729,0,"#00eeff"
141319849,GerardoSosaPlat,7,0,2,2,0.428664,0.36723,0.000486,"#ffb800"
141371575,icv78,37,0,1,1,0.163269,0.610436,0,"#006032"
141392996,1MERQ,3,0,1,1,0.467547,0.76416,0,"#ffb3ff"
141454879,jorgebajo05,42,0,1,1,0.730068,0.404494,0,"#66e087"
141462475,jlso1o,13,0,4,4,0.519891,0.478968,0.001459,"#3bec00"
141472494,alfonsofierroo,30,2,2,4,0.519265,0.465542,0.001459,"#ff77ff"
141594768,CristinaValido,34,0,1,1,0.387239,0.451817,0,"#ff0d69"
141596064,Gonzalogoni,49,1,0,1,0.353165,0.653247,0,"#ff7007"
141598617,doraeliaramos,7,0,1,1,0.422554,0.204605,0,"#ffb800"
141599175,germanmarte4,49,1,0,1,0.369515,0.666051,0,"#ff7007"
141678948,rayoazull,55,0,1,1,0.547225,0.62593,0,"#cb3f32"
141720522,WizMik12,31,0,1,1,0.592734,0.470325,0,"#3e93ff"
141722279,pazoreal,15,0,1,1,0.555198,0.679139,0,"#008ebb"
141723734,ronaldfar,49,4,3,7,0.455177,0.488458,0.002918,"#ff7007"
141738236,LaNancyBoo,13,0,1,1,0.530766,0.236871,0,"#3bec00"
141775157,Jess_Alg,13,0,1,1,0.42209,0.426891,0,"#3bec00"
141936066,svshh,13,0,1,1,0.382529,0.394898,0,"#3bec00"
141981519,TajeewDR,13,0,2,2,0.455038,0.351391,0.000486,"#3bec00"
142005933,vicenele,49,0,8,8,0.494337,0.587993,0.003405,"#ff7007"
142013550,CYOLIVO,49,1,0,1,0.394521,0.680816,0,"#ff7007"
142048522,diegofloresco,21,0,1,1,0.024791,0.66046,0,"#c6cc85"
142054984,ochoa7705,18,0,2,2,0.660505,0.630958,0.000486,"#5456a6"
142108036,yudithgonzalez,37,0,2,2,0.255825,0.474718,0.000486,"#006032"
142122077,annita_cano,49,6,13,19,0.45415,0.508399,0.008755,"#ff7007"
142126509,angarita13,58,0,1,1,0.56899,0.176057,0,"#005076"
142187459,Siriox,13,0,2,2,0.444621,0.417916,0.000486,"#3bec00"
142250577,diegomolanovega,49,1,0,1,0.338449,0.713056,0,"#ff7007"
142316879,SantillanaARG,3,1,0,1,0.478387,0.666873,0,"#ffb3ff"
142331913,HUGODIAZIZQ,49,0,1,1,0.297145,0.745879,0,"#ff7007"
142367257,UAM_Lerma,13,11,0,11,0.446737,0.466112,0.004864,"#3bec00"
142387197,redhistoria,19,1,0,1,0.641434,0.792477,0,"#00d3ff"
142394469,JotaInKoelle,30,0,1,1,0.38201,0.5122,0,"#ff77ff"
142400336,FJCamachoR,13,2,1,3,0.425738,0.375302,0.000973,"#3bec00"
142437567,perezc_cesar,42,0,1,1,0.753113,0.419538,0,"#66e087"
142449385,Asumetal,21,0,1,1,0.036883,0.640068,0,"#c6cc85"
142454580,Ministerio_TIC,38,5,0,5,0.625481,0.457382,0.001946,"#662859"
142518802,rolandomera,7,0,2,2,0.430921,0.285269,0.000486,"#ffb800"
142633802,inginformatico,22,0,2,2,0.661045,0.49206,0.000486,"#00e8b2"
142752970,Tasconita,30,21,12,33,0.529483,0.529749,0.015564,"#ff77ff"
142755576,ENALLTUNAM,13,2,0,2,0.412347,0.392587,0.000486,"#3bec00"
142772226,elopezri,38,0,7,7,0.52043,0.42271,0.002918,"#662859"
142815838,idelore,1,0,2,2,0.654618,0.440365,0.000486,"#b6cb00"
142821215,TeatroColon,49,1,0,1,0.356619,0.684989,0,"#ff7007"
142877654,maryalterego,36,3,0,3,0.520903,0.369628,0.000973,"#825403"
142920354,gatofeaco,13,0,1,1,0.475351,0.391487,0,"#3bec00"
142948057,crisrie,14,0,1,1,0.651799,0.577873,0,"#00eeff"
143020388,bynzelman,22,1,0,1,0.565293,0.639117,0,"#00e8b2"
143026537,FundacionCEU,2,1,3,4,0.556969,0.508651,0.001459,"#ffa64e"
143046100,uvalderrama,21,0,1,1,0.205154,0.218003,0,"#c6cc85"
143063993,UNISABANETA,9,13,3,16,0.670023,0.868942,0.007296,"#008f7b"
143088135,danielzapater,31,0,4,4,0.579388,0.495828,0.001459,"#3e93ff"
143108509,GaboTuitero,21,0,1,1,0.324568,0.44728,0,"#c6cc85"
143157832,solarin29,1,0,2,2,0.465864,0.571015,0.000486,"#b6cb00"
143194163,MargaTwita,3,9,5,14,0.474887,0.572378,0.006323,"#ffb3ff"
143199634,JCx64,30,1,0,1,0.589297,0.561423,0,"#ff77ff"
143200370,Tatianagaudes,16,0,2,2,0.962212,0.667764,0.000486,"#c42c63"
143200737,filosofiauchile,49,30,3,33,0.422573,0.378713,0.015564,"#ff7007"
143204550,ricardo_arts,31,0,1,1,0.613491,0.459094,0,"#3e93ff"
143205639,SamZarazua,13,0,1,1,0.514983,0.309812,0,"#3bec00"
143212885,twittgloria,38,0,1,1,0.688752,0.39937,0,"#662859"
143269531,hsarayg,42,0,1,1,0.677273,0.402496,0,"#66e087"
143288428,Sositap,13,12,8,20,0.467138,0.440195,0.009241,"#3bec00"
143321650,marcelabeltranb,13,0,7,7,0.468543,0.419931,0.002918,"#3bec00"
143348687,farmamk,49,1,0,1,0.336449,0.674923,0,"#ff7007"
143402775,a_Bego_DF,1,0,1,1,0.424877,0.790813,0,"#b6cb00"
143445747,corohlarramendi,15,0,1,1,0.543337,0.750615,0,"#008ebb"
143452520,Penradock,19,0,1,1,0.63708,0.629079,0,"#00d3ff"
143467307,clam_ims_uerj,36,0,2,2,0.52663,0.306331,0.000486,"#825403"
143487781,mArc3luX,8,0,2,2,0.426582,0.769102,0.000486,"#00ed5d"
143513337,carlos_torresb,31,0,1,1,0.656204,0.549885,0,"#3e93ff"
143526833,IAPEM,30,2,0,2,0.184874,0.571547,0.000486,"#ff77ff"
143545821,canaltn8,49,1,0,1,0.429811,0.683336,0,"#ff7007"
143559488,aurelberra,36,13,12,25,0.477996,0.487848,0.011673,"#825403"
143567019,unedtudela,30,4,0,4,0.548795,0.600192,0.001459,"#ff77ff"
143579053,jorgeramos7773,17,0,1,1,0.796504,0.229027,0,"#ff9cc7"
143595762,gboscanc,58,0,1,1,0.475796,0.656709,0,"#005076"
143595832,leonterojas,40,0,1,1,0.597153,0.048286,0,"#ff12a3"
143607786,ja_monreal,1,0,2,2,0.655276,0.454475,0.000486,"#b6cb00"
143607999,PyEC_TecdeMty,37,6,0,6,0.204298,0.576698,0.002432,"#006032"
143618892,caminante_crbz,49,1,0,1,0.34558,0.643551,0,"#ff7007"
143668652,liliarabiela,17,0,1,1,0.735588,0.810316,0,"#ff9cc7"
143779169,onmedic,22,0,7,7,0.568825,0.444152,0.002918,"#00e8b2"
143789255,agomezpalacio,38,2,0,2,0.49324,0.531856,0.000486,"#662859"
143812434,forumeventos,8,0,1,1,0.265327,0.246824,0,"#00ed5d"
143833319,Juanmhermosillo,49,5,0,5,0.522449,0.660669,0.001946,"#ff7007"
143849464,PanchoMembrillo,13,0,2,2,0.461515,0.430147,0.000486,"#3bec00"
143870417,ismaInthirath,40,0,1,1,0.621651,0.012588,0,"#ff12a3"
143871466,CamLibro,38,2,1,3,0.491092,0.505985,0.000973,"#662859"
143888392,alexvivargas,41,0,1,1,0.293931,0.346029,0,"#697b00"
143909021,CNRS,22,9,0,9,0.522119,0.577168,0.003891,"#00e8b2"
143919712,lolypalquenolee,21,0,1,1,0.213566,0.216356,0,"#c6cc85"
143924206,Mineducacion,38,4,0,4,0.713341,0.479848,0.001459,"#662859"
143936165,oscarmon2473,3,0,1,1,0.463236,0.748241,0,"#ffb3ff"
143936340,jbm_91,22,0,5,5,0.578555,0.571945,0.001946,"#00e8b2"
144129466,amarotovaliente,30,0,1,1,0.502908,0.656734,0,"#ff77ff"
144158624,Igniru,30,3,1,4,0.583528,0.449115,0.001459,"#ff77ff"
144249958,alecabellom,0,0,2,2,0.418824,0.54827,0.000486,"#8ecfec"
144317493,donalejillo,7,0,1,1,0.836844,0.5608,0,"#ffb800"
144376833,FelipeCalderon,17,3,0,3,0.729998,0.209378,0.000973,"#ff9cc7"
144466006,Manuelfergom,22,0,1,1,0.608935,0.618743,0,"#00e8b2"
144547999,sevillajordi,14,2,2,4,0.569095,0.408393,0.001459,"#00eeff"
144556985,g_dacosta,49,1,0,1,0.377191,0.655121,0,"#ff7007"
144557786,IberoPuebla,31,4,0,4,0.560966,0.46206,0.001459,"#3e93ff"
144579787,jcangelu,38,0,1,1,0.438375,0.774335,0,"#662859"
144590244,librosybitios,14,20,20,40,0.538332,0.50274,0.018969,"#00eeff"
144598478,AidaBSanchez,0,7,7,14,0.552013,0.541805,0.006323,"#8ecfec"
144621025,kalutah,34,0,6,6,0.521636,0.471332,0.002432,"#ff0d69"
144627097,ARcharrisP,3,0,1,1,0.680281,0.721809,0,"#ffb3ff"
144672599,DavidSVzla,40,0,1,1,0.571717,0.015847,0,"#ff12a3"
144679447,guilhermedeoli_,36,1,0,1,0.444354,0.31981,0,"#825403"
144804999,CanalUGR,31,127,7,134,0.582046,0.542902,0.064689,"#3e93ff"
144832173,felwert,49,0,1,1,0.375225,0.472154,0,"#ff7007"
144922459,MConversadas,38,0,1,1,0.678722,0.474938,0,"#662859"
144923284,EnferEvidente,31,1,1,2,0.731948,0.544185,0.000486,"#3e93ff"
144945116,sebastiagiralt,14,0,7,7,0.552457,0.533763,0.002918,"#00eeff"
144978146,cljanita,49,0,2,2,0.383224,0.3772,0.000486,"#ff7007"
145017853,jordipujolabcn,34,0,16,16,0.501433,0.505374,0.007296,"#ff0d69"
145043218,TonnyPena,22,0,1,1,0.568469,0.644832,0,"#00e8b2"
145053036,psanchez820,13,0,2,2,0.436759,0.419612,0.000486,"#3bec00"
145078475,David_CabreraC,7,0,2,2,0.42598,0.358711,0.000486,"#ffb800"
145103233,Bu_pol_clap,36,0,3,3,0.507753,0.391565,0.000973,"#825403"
145264788,guillermosotov,34,1,1,2,0.358722,0.385096,0.000486,"#ff0d69"
145326940,esalamanca1,3,0,1,1,0.468845,0.77814,0,"#ffb3ff"
145466503,melinapiglia,49,0,3,3,0.573599,0.440821,0.000973,"#ff7007"
145489078,joltrexomar,37,0,1,1,0.451882,0.208578,0,"#006032"
145598062,confianzaonline,49,1,0,1,0.359655,0.629807,0,"#ff7007"
145614350,arquivoestadosp,36,1,0,1,0.453282,0.334689,0,"#825403"
145633220,ChendeleTeran,42,0,1,1,0.905476,0.426546,0,"#66e087"
145643087,TallerDG1,3,0,1,1,0.460612,0.664311,0,"#ffb3ff"
145667287,mktcamila,37,3,0,3,0.516722,0.404864,0.000973,"#006032"
145670919,govern,8,5,0,5,0.656829,0.324866,0.001946,"#00ed5d"
145686963,GeoCensos,7,2,4,6,0.378022,0.376796,0.002432,"#ffb800"
145730132,ElianaGarciaarb,49,1,0,1,0.375681,0.611223,0,"#ff7007"
145821305,pequemza,8,0,1,1,0.515723,0.795247,0,"#00ed5d"
145866053,rhceron,7,0,1,1,0.408448,0.72275,0,"#ffb800"
145867828,gaoxsa,5,0,1,1,0.628878,0.301277,0,"#b2dd44"
145895013,enriquevaus,31,0,1,1,0.657065,0.517206,0,"#3e93ff"
145907957,MauroPatigno,38,0,2,2,0.536395,0.427928,0.000486,"#662859"
145916398,miguelluaces,30,0,1,1,0.893101,0.539487,0,"#ff77ff"
145944593,AnaKataCarmona,38,1,0,1,0.39208,0.304585,0,"#662859"
146069877,FerminatorDLP,22,0,2,2,0.635496,0.459521,0.000486,"#00e8b2"
146103864,HURACANADO,34,0,2,2,0.506063,0.407398,0.000486,"#ff0d69"
146115612,alzarsalalm,36,1,0,1,0.452152,0.330046,0,"#825403"
146136115,Carmenpizarro,30,1,2,3,0.48582,0.61862,0.000973,"#ff77ff"
146144724,JPGrutter,37,0,1,1,0.201709,0.482425,0,"#006032"
146160135,Lolamont,30,0,1,1,0.61304,0.613011,0,"#ff77ff"
146160403,PablosanchezNov,38,0,1,1,0.655603,0.412853,0,"#662859"
146224973,sory1975,7,0,1,1,0.795747,0.317582,0,"#ffb800"
146234361,pabloolguin,13,0,1,1,0.416052,0.414488,0,"#3bec00"
146324348,AlexMFourzan,30,0,1,1,0.619892,0.61752,0,"#ff77ff"
146325435,ceciliaugalde,20,1,0,1,0.431104,0.15541,0,"#f0be45"
146362699,jomacorona,3,1,4,5,0.492423,0.568052,0.001946,"#ffb3ff"
146423318,pcsanguinetti,30,1,2,3,0.528195,0.662486,0.000973,"#ff77ff"
146435936,pent_flacso,49,7,2,9,0.68796,0.730706,0.003891,"#ff7007"
146438649,salud_na,1,1,0,1,0.727197,0.437226,0,"#b6cb00"
146476339,dchavezheras,36,0,5,5,0.460508,0.501814,0.001946,"#825403"
146488540,AVInterpreter,38,1,1,2,0.58655,0.632075,0.000486,"#662859"
146494080,ajspadial,34,9,36,45,0.51116,0.510097,0.021401,"#ff0d69"
146519689,REINA_MENCIA,15,0,3,3,0.54006,0.664206,0.000973,"#008ebb"
146534969,Nuntii_latina,37,1,0,1,0.679225,0.332823,0,"#006032"
146544977,marcoshauria,49,3,0,3,0.37845,0.559403,0.000973,"#ff7007"
146575859,keuike,49,0,1,1,0.487436,0.353906,0,"#ff7007"
146579675,Sofikowal,49,4,8,12,0.465618,0.592468,0.00535,"#ff7007"
146588375,meugeahu,21,0,1,1,0.193953,0.253437,0,"#c6cc85"
146619416,MalokaBogota,38,1,0,1,0.727973,0.473695,0,"#662859"
146626575,MiradorCUAIEED,3,1,1,2,0.517645,0.581857,0.000486,"#ffb3ff"
146773811,amaiaarroyo,31,1,6,7,0.491258,0.514753,0.002918,"#3e93ff"
146806953,lgaretio,3,1,0,1,0.638685,0.576633,0,"#ffb3ff"
146887578,USalvador,49,5,0,5,0.418834,0.540637,0.001946,"#ff7007"
146889702,Mauro_Mateos,49,0,1,1,0.247588,0.695206,0,"#ff7007"
146908488,evalezcano,30,0,4,4,0.495133,0.50787,0.001459,"#ff77ff"
147102131,NatsuSh,37,0,1,1,0.229719,0.423787,0,"#006032"
147125060,germanteruel,0,0,1,1,0.278698,0.325548,0,"#8ecfec"
147319561,cultureplex,13,52,43,95,0.507129,0.470079,0.04572,"#3bec00"
147331327,penfredo,15,0,2,2,0.53638,0.614625,0.000486,"#008ebb"
147350414,alsaro_tab,7,0,1,1,0.373926,0.33973,0,"#ffb800"
147408486,angelet72,2,0,1,1,0.673816,0.677076,0,"#ffa64e"
147522466,CopyConArte,1,0,1,1,0.465701,0.715032,0,"#b6cb00"
147545844,osvaldosalomon,49,1,0,1,0.410037,0.633918,0,"#ff7007"
147632436,hipogrifo222,38,0,1,1,0.538515,0.368008,0,"#662859"
147634213,hypertaste,14,6,7,13,0.499132,0.528643,0.005837,"#00eeff"
147732751,VictorBernalH,10,0,1,1,0.323537,0.487387,0,"#52d7c0"
147780746,VictoriaSantosM,38,0,1,1,0.134863,0.810088,0,"#662859"
147910543,KBGraubart,13,0,1,1,0.3754,0.448712,0,"#3bec00"
147950034,napoleonmendez,38,0,5,5,0.553074,0.455398,0.001946,"#662859"
147990181,vszabo,13,0,1,1,0.464293,0.406737,0,"#3bec00"
148009767,Hangar_org,14,7,3,10,0.660071,0.50894,0.004377,"#00eeff"
148015040,johnruss28,14,0,2,2,0.535925,0.482009,0.000486,"#00eeff"
148020253,Paulorius,38,0,2,2,0.541887,0.46692,0.000486,"#662859"
148054740,Lofii29,30,0,1,1,0.583871,0.536263,0,"#ff77ff"
148120542,caroduzu7,7,0,1,1,0.422967,0.330094,0,"#ffb800"
148152933,MarioRobertoP,34,0,1,1,0.614879,0.318849,0,"#ff0d69"
148157970,MapiRoa,38,0,1,1,0.301218,0.172458,0,"#662859"
148160113,ileana_Bolivar,38,0,1,1,0.51144,0.720924,0,"#662859"
148160316,NohelisRuizA,0,0,1,1,0.373677,0.562076,0,"#8ecfec"
148238680,mgarciatrevino,13,0,4,4,0.547067,0.414017,0.001459,"#3bec00"
148257522,janguerasa,49,1,0,1,0.358393,0.674783,0,"#ff7007"
148333107,karrancagroove,36,0,1,1,0.518442,0.211825,0,"#825403"
148346738,arivas7,49,0,1,1,0.765008,0.816243,0,"#ff7007"
148350045,ApofisMedellin,3,0,1,1,0.462198,0.784891,0,"#ffb3ff"
148372094,Blue_Consulting,49,1,0,1,0.421062,0.691496,0,"#ff7007"
148398438,nestormarques,2,22,9,31,0.626581,0.507189,0.014591,"#ffa64e"
148401256,pinadacorte,15,0,1,1,0.559479,0.740858,0,"#008ebb"
148442196,JorgeLizandra,31,0,1,1,0.638961,0.493983,0,"#3e93ff"
148473666,Primaveratgg,51,0,1,1,0.371275,0.177507,0,"#c44aac"
148478745,andreincolombia,38,0,1,1,0.540471,0.321658,0,"#662859"
148504027,ashura70,30,0,1,1,0.525028,0.664505,0,"#ff77ff"
148504901,RadioUdeG,3,0,2,2,0.489423,0.667292,0.000486,"#ffb3ff"
148524262,Tartufluo,49,1,0,1,0.320761,0.604989,0,"#ff7007"
148551515,ViejaPink,21,0,2,2,0.234735,0.250723,0.000486,"#c6cc85"
148722326,ibnreilly,19,2,4,6,0.634864,0.536062,0.002432,"#00d3ff"
148819696,mundoobrero,19,1,0,1,0.658344,0.773337,0,"#00d3ff"
148827745,uv_uvi,52,3,0,3,0.797021,0.643748,0.000973,"#b56eed"
148846847,gustavogallegos,4,0,1,1,0.857634,0.238036,0,"#f4c8cf"
148856035,Garber_Julian,17,0,1,1,0.935466,0.376453,0,"#ff9cc7"
148894863,_USHEBTIS,37,1,0,1,0.61679,0.336782,0,"#006032"
148926905,F_Fernandez_F,13,0,3,3,0.442509,0.454512,0.000973,"#3bec00"
149065776,vanderjamen,14,0,1,1,0.603333,0.481541,0,"#00eeff"
149074214,FundacionUNED,30,15,3,18,0.57815,0.54901,0.008268,"#ff77ff"
149086755,metacaro,30,0,1,1,0.496389,0.66526,0,"#ff77ff"
149132449,NANAPAOOVALLE,38,0,1,1,0.668503,0.353967,0,"#662859"
149171047,CasaMuseoEFM,21,0,2,2,0.220969,0.253882,0.000486,"#c6cc85"
149178822,DEMOCRACIACOLOM,49,1,0,1,0.332276,0.64625,0,"#ff7007"
149454498,JorgePortella,30,1,0,1,0.785762,0.714749,0,"#ff77ff"
149475451,jminguezc,49,1,0,1,0.424627,0.658436,0,"#ff7007"
149503543,gatasaba,21,0,2,2,0.318851,0.364823,0.000486,"#c6cc85"
149558761,lauramassimino,13,1,2,3,0.546122,0.426518,0.000973,"#3bec00"
149576006,romysant,3,0,1,1,0.483357,0.662242,0,"#ffb3ff"
149665066,IvonneestelaMtz,30,2,1,3,0.662854,0.500475,0.000973,"#ff77ff"
149674105,lecream_edu,17,0,1,1,0.819283,0.23123,0,"#ff9cc7"
149676328,ocados,49,0,1,1,0.29419,0.742222,0,"#ff7007"
149762941,ferchu992,37,0,2,2,0.253535,0.49091,0.000486,"#006032"
149974969,CataRestrepoD,38,3,7,10,0.605685,0.576533,0.004377,"#662859"
149982544,jcerquera,35,0,1,1,0.562238,0.262725,0,"#00faff"
150022354,necrobichos,38,0,2,2,0.454693,0.58253,0.000486,"#662859"
150023812,MyriamGSanz,30,0,1,1,0.493535,0.620349,0,"#ff77ff"
150032353,kappleppi,21,0,1,1,0.232149,0.211482,0,"#c6cc85"
150050899,jmorenorivero,3,0,1,1,0.600995,0.76693,0,"#ffb3ff"
150059762,AngieCabrera_,38,2,2,4,0.585772,0.537863,0.001459,"#662859"
150083991,JornadaMendoza,49,1,0,1,0.329885,0.659723,0,"#ff7007"
150109800,de_liaa,17,0,1,1,0.629365,0.279182,0,"#ff9cc7"
150191981,UAM_Iztapalapa,1,1,0,1,0.299048,0.478999,0,"#b6cb00"
150242940,abruzos,13,0,1,1,0.380142,0.457218,0,"#3bec00"
150275482,MarcaAF,49,1,0,1,0.394379,0.636566,0,"#ff7007"
150383840,UBAonline,49,3,3,6,0.376324,0.569005,0.002432,"#ff7007"
150420571,adrianasegurav,34,0,1,1,0.588418,0.312904,0,"#ff0d69"
150477572,khromati,49,1,0,1,0.361129,0.643781,0,"#ff7007"
150545002,upsystem,15,1,0,1,0.557155,0.649451,0,"#008ebb"
150550914,jpmaauad,31,0,1,1,0.761102,0.915713,0,"#3e93ff"
150671475,mch2012_,13,0,1,1,0.504285,0.316027,0,"#3bec00"
150750836,julianetienne,13,0,3,3,0.440949,0.443184,0.000973,"#3bec00"
150825425,EduaDelaHoz,38,0,1,1,0.298766,0.178277,0,"#662859"
151008495,tldominguez,37,0,1,1,0.696544,0.493451,0,"#006032"
151079667,puertodigital,38,0,6,6,0.547678,0.537111,0.002432,"#662859"
151105262,armandoLpz42,13,0,2,2,0.439457,0.416931,0.000486,"#3bec00"
151113022,PaulaenBarna,49,0,1,1,0.607699,0.585054,0,"#ff7007"
151116641,paige_roberts,13,4,3,7,0.422851,0.438587,0.002918,"#3bec00"
151132673,Marguega,17,0,1,1,0.625695,0.272732,0,"#ff9cc7"
151145907,eneso_es,14,1,0,1,0.587656,0.453142,0,"#00eeff"
151153984,Lectriz_,21,1,0,1,0.161517,0.314184,0,"#c6cc85"
151214860,ccentenoc,31,0,2,2,0.618562,0.547426,0.000486,"#3e93ff"
151233065,Susan_Franklin1,7,0,2,2,0.439238,0.412799,0.000486,"#ffb800"
151239249,GuillemCintas,22,1,0,1,0.506104,0.671559,0,"#00e8b2"
151420991,noverea,38,0,1,1,0.278777,0.626867,0,"#662859"
151425419,BBVABancaRespon,22,1,3,4,0.580566,0.525865,0.001459,"#00e8b2"
151425616,Chillca,49,1,0,1,0.431641,0.655145,0,"#ff7007"
151432376,vilaadrian,30,0,4,4,0.513983,0.520286,0.001459,"#ff77ff"
151464178,AGROAREA,49,1,0,1,0.321198,0.638883,0,"#ff7007"
151511477,emicmiranda,49,0,3,3,0.463094,0.558288,0.000973,"#ff7007"
151539380,angelitandrade,38,0,1,1,0.452742,0.778268,0,"#662859"
151652495,Maritzacol,38,0,1,1,0.445907,0.784644,0,"#662859"
151658265,GrandesMaestros,7,0,1,1,0.632391,0.380864,0,"#ffb800"
151661476,juliangomezdel,7,0,4,4,0.445723,0.407758,0.001459,"#ffb800"
151674616,egamanww,7,0,1,1,0.770519,0.630273,0,"#ffb800"
151686400,joannesfrancisc,15,0,3,3,0.509019,0.676671,0.000973,"#008ebb"
151823931,BURJC,31,4,2,6,0.578659,0.502648,0.002432,"#3e93ff"
151886860,jaimeaecheverri,14,0,1,1,0.677466,0.523986,0,"#00eeff"
151988121,serendy22,34,0,3,3,0.463172,0.444831,0.000973,"#ff0d69"
152005065,elmagazin,38,2,0,2,0.452546,0.80152,0.000486,"#662859"
152017988,IIBUNAM,13,58,17,75,0.469548,0.435986,0.035992,"#3bec00"
152030831,TomiHaurigot,13,0,1,1,0.638562,0.993666,0,"#3bec00"
152051625,heatherfro,34,28,2,30,0.475988,0.441826,0.014105,"#ff0d69"
152062669,Aur3llio,49,1,0,1,0.31649,0.652398,0,"#ff7007"
152073585,diego_dumont,49,1,0,1,0.332171,0.651473,0,"#ff7007"
152081332,GuilleMello,55,0,2,2,0.569192,0.570139,0.000486,"#cb3f32"
152093992,SebastianMFA,38,4,1,5,0.590086,0.418127,0.001946,"#662859"
152168585,andrabaltza,49,1,0,1,0.367878,0.600498,0,"#ff7007"
152291380,NachoMolano,0,0,1,1,0.791236,0.702477,0,"#8ecfec"
152307313,ilonkaPalocz,21,0,1,1,0.342108,0.277168,0,"#c6cc85"
152345847,paolaarias1110,35,0,1,1,0.32291,0.145846,0,"#00faff"
152395502,NCGOMA,13,0,1,1,0.409621,0.37877,0,"#3bec00"
152436534,SebaMStra,49,0,1,1,0.442704,0.662302,0,"#ff7007"
152478116,Ch_Villarreal,40,0,1,1,0.652609,0.049739,0,"#ff12a3"
152484427,mexcar01,49,1,0,1,0.345519,0.60063,0,"#ff7007"
152492516,aviladorador,7,0,1,1,0.528285,0.190861,0,"#ffb800"
152496302,dchiriboga,42,0,1,1,0.716376,0.437198,0,"#66e087"
152515820,pabloschiaffino,37,5,1,6,0.62782,0.469162,0.002432,"#006032"
152663628,MeganJMyers,13,6,4,10,0.450719,0.460211,0.004377,"#3bec00"
152702480,RanieSolarevisk,36,0,3,3,0.491907,0.359412,0.000973,"#825403"
152746123,zoso418,0,0,5,5,0.444112,0.507376,0.001946,"#8ecfec"
152746992,zaspiak,21,0,2,2,0.235829,0.242901,0.000486,"#c6cc85"
152760974,camiloleonreyes,1,0,1,1,0.382287,0.550659,0,"#b6cb00"
152778171,rosariorogel,41,106,64,170,0.388131,0.428963,0.082198,"#697b00"
152864770,rob_i_c,21,0,1,1,0.28195,0.225748,0,"#c6cc85"
152966491,juangun8,49,1,0,1,0.361282,0.643552,0,"#ff7007"
153001775,AnabellaBarroso,30,0,1,1,0.602767,0.683564,0,"#ff77ff"
153072128,Yamil_Cham,14,0,1,1,0.311246,0.548129,0,"#00eeff"
153101929,pedrotterres,36,0,1,1,0.479564,0.288192,0,"#825403"
153220657,Johannariverob,1,0,1,1,0.335095,0.694864,0,"#b6cb00"
153221642,taniuskaram,42,2,2,4,0.676179,0.520665,0.001459,"#66e087"
153226428,FiorGarciaM,7,0,1,1,0.397838,0.322463,0,"#ffb800"
153320725,Symposium_es,1,0,14,14,0.503272,0.564793,0.006323,"#b6cb00"
153452737,Al_Rod05,31,0,1,1,0.742248,0.918139,0,"#3e93ff"
153453487,renantomazini,36,2,6,8,0.511776,0.328426,0.003405,"#825403"
153462149,wikimediachile,49,1,0,1,0.384799,0.536314,0,"#ff7007"
153497792,pierreherrera,13,0,1,1,0.383605,0.464126,0,"#3bec00"
153519870,palabritadepape,40,0,1,1,0.597958,0.019335,0,"#ff12a3"
153543462,GermanAperezR,3,2,0,2,0.594871,0.78783,0.000486,"#ffb3ff"
153572088,simonperezW,49,0,1,1,0.34418,0.485333,0,"#ff7007"
153578620,MartinDiegoMX,35,0,1,1,0.352732,0.529056,0,"#00faff"
153604914,DavidEcheD,34,0,1,1,0.603837,0.327504,0,"#ff0d69"
153641705,RocioMantis,0,0,1,1,0.43384,0.608399,0,"#8ecfec"
153849756,cesarsortiz,14,0,5,5,0.534732,0.544509,0.001946,"#00eeff"
153855134,PlanDanza,38,0,1,1,0.591805,0.36184,0,"#662859"
153894288,RedCarolinaCol,15,2,3,5,0.566721,0.652783,0.001946,"#008ebb"
153983233,Tadahikohan,13,0,1,1,0.523212,0.455042,0,"#3bec00"
154095684,SensPublic,9,3,0,3,0.680281,0.428664,0.000973,"#008f7b"
154104960,PRUAB,49,1,0,1,0.388248,0.651454,0,"#ff7007"
154167077,Risi_6,31,0,1,1,0.477683,0.681219,0,"#3e93ff"
154198440,BibloRedBogota,38,28,8,36,0.606364,0.412686,0.017023,"#662859"
154202585,FundlaCaixa,30,1,0,1,0.586627,0.55948,0,"#ff77ff"
154244633,salalm,36,26,3,29,0.438399,0.471174,0.013619,"#825403"
154282685,historiactual,19,1,0,1,0.651299,0.796054,0,"#00d3ff"
154312901,enriqueluzuriag,20,0,1,1,0.407402,0.067823,0,"#f0be45"
154367896,angetic,38,0,1,1,0.660484,0.39418,0,"#662859"
154393527,gloriamor80,21,0,1,1,0.048197,0.65299,0,"#c6cc85"
154467273,SandraBibl,22,0,1,1,0.588204,0.589615,0,"#00e8b2"
154521121,marianperuchena,8,0,1,1,0.505285,0.799885,0,"#00ed5d"
154575126,cumbercel,14,0,2,2,0.615749,0.528281,0.000486,"#00eeff"
154580024,juanfortuna,55,0,2,2,0.637212,0.649404,0.000486,"#cb3f32"
154684162,csnegri,21,1,0,1,0.319601,0.433688,0,"#c6cc85"
154687022,egreciet,58,0,2,2,0.601939,0.29594,0.000486,"#005076"
154687673,laura64729,42,0,3,3,0.59591,0.440251,0.000973,"#66e087"
154720433,andresmsoto,38,0,1,1,0.698712,0.399232,0,"#662859"
154752685,nico_17o,21,0,1,1,0.224357,0.214886,0,"#c6cc85"
154808811,Cristian_Huepe,21,0,1,1,0.778205,0.533206,0,"#c6cc85"
154813107,pablogolpe,13,0,3,3,0.437142,0.522521,0.000973,"#3bec00"
154859558,anandkondaiah,13,0,1,1,0.356779,0.442382,0,"#3bec00"
154923518,josepablosuarez,30,0,3,3,0.560735,0.624791,0.000973,"#ff77ff"
154925267,RRdelaSerna,2,0,1,1,0.357682,0.580971,0,"#ffa64e"
154986602,Deobrigas,22,0,1,1,0.613186,0.725423,0,"#00e8b2"
155021305,nellop13,34,0,2,2,0.509966,0.410781,0.000486,"#ff0d69"
155029552,JohnTShorter,36,0,1,1,0.465986,0.278797,0,"#825403"
155031277,mariacastro1111,38,0,6,6,0.591844,0.417709,0.002432,"#662859"
155182076,enfermera2pto0,31,0,1,1,0.716687,0.538218,0,"#3e93ff"
155237591,morenopjen,42,0,1,1,0.914681,0.428796,0,"#66e087"
155428489,karenabudi,31,0,1,1,0.750833,0.925548,0,"#3e93ff"
155470822,Wikimedia_mx,13,36,8,44,0.460532,0.453461,0.020914,"#3bec00"
155476594,Laura_Prez,30,1,2,3,0.547667,0.573064,0.000973,"#ff77ff"
155525097,UniHuelva,37,3,0,3,0.562409,0.274874,0.000973,"#006032"
155544510,otriupo,22,1,1,2,0.629352,0.471845,0.000486,"#00e8b2"
155601793,Jupij79,30,0,1,1,0.708098,0.676704,0,"#ff77ff"
155613307,vjennyffer,38,5,2,7,0.597424,0.44998,0.002918,"#662859"
155615853,fdegoni,1,1,2,3,0.474002,0.607732,0.000973,"#b6cb00"
155733520,MarsiasMarsias,7,17,33,50,0.522357,0.518209,0.023833,"#ffb800"
155752166,Gilceliabr,36,0,2,2,0.526637,0.436161,0.000486,"#825403"
155798437,elmodernisimo,13,0,2,2,0.47853,0.426119,0.000486,"#3bec00"
155812498,NickoalEichmann,36,1,0,1,0.288174,0.392055,0,"#825403"
155945710,REDEMIS,14,0,1,1,0.563522,0.427213,0,"#00eeff"
155959420,COBAQ_Oficial,17,0,1,1,0.908656,0.352567,0,"#ff9cc7"
155987003,NEHgov,41,3,0,3,0.506353,0.511771,0.000973,"#697b00"
156057787,ErinSpinney,49,1,0,1,0.400965,0.529348,0,"#ff7007"
156078783,jeremythrone,30,0,4,4,0.45611,0.51494,0.001459,"#ff77ff"
156365095,Angeles_Addy,3,0,4,4,0.516596,0.662854,0.001459,"#ffb3ff"
156401711,insor_colombia,38,1,0,1,0.627371,0.444936,0,"#662859"
156448128,JulianLopezM,38,0,3,3,0.594145,0.423978,0.000973,"#662859"
156448637,fkroup,49,0,1,1,0.40892,0.601734,0,"#ff7007"
156644679,jgsanchezh27,34,0,1,1,0.602009,0.323732,0,"#ff0d69"
156655515,josemarmolp,49,1,0,1,0.427367,0.652976,0,"#ff7007"
156658740,wp_es,55,9,1,10,0.570608,0.504424,0.004377,"#cb3f32"
156660942,cmvaronc,34,3,7,10,0.491141,0.477443,0.004377,"#ff0d69"
156705052,adolfoplasencia,49,1,0,1,0.403642,0.674523,0,"#ff7007"
156713555,talleresycursos,49,1,0,1,0.435352,0.660223,0,"#ff7007"
156719746,patobarna,49,2,5,7,0.399093,0.503802,0.002918,"#ff7007"
156764014,SilvitaMentz,8,0,1,1,0.518934,0.808778,0,"#00ed5d"
156775601,birloque,30,2,2,4,0.533393,0.523389,0.001459,"#ff77ff"
157006864,desselebrada,40,0,1,1,0.599423,0.005347,0,"#ff12a3"
157015870,Olguitapizarro,49,0,1,1,0.338927,0.482843,0,"#ff7007"
157030239,victmartinez,13,0,9,9,0.461819,0.4523,0.003891,"#3bec00"
157239728,BetQueeR,0,0,3,3,0.444345,0.414745,0.000973,"#8ecfec"
157248383,jlmunozr,22,0,4,4,0.571887,0.579099,0.001459,"#00e8b2"
157383930,geo_domo,13,2,6,8,0.482924,0.495129,0.003405,"#3bec00"
157458657,qgull,42,0,1,1,0.694171,0.437415,0,"#66e087"
157586439,UxioNovo,55,0,2,2,0.582466,0.539397,0.000486,"#cb3f32"
157686896,ReneJaimez,7,0,1,1,0.383109,0.213178,0,"#ffb800"
157707424,narhval,49,2,1,3,0.467163,0.610795,0.000973,"#ff7007"
157745950,Celinawood,22,0,1,1,0.67173,0.476087,0,"#00e8b2"
157809660,juanengonzalvez,2,7,3,10,0.446596,0.576034,0.004377,"#ffa64e"
157811945,tonnoguerrero,45,0,2,2,0.670485,0.180027,0.000486,"#00e8ff"
157812285,Utopiadivina,49,1,0,1,0.37027,0.634755,0,"#ff7007"
157908700,R_de_alicantino,38,0,1,1,0.598262,0.55876,0,"#662859"
157917283,Miribuendia,31,0,3,3,0.682977,0.550641,0.000973,"#3e93ff"
157923051,leylarios,22,0,1,1,0.520945,0.750307,0,"#00e8b2"
157925546,htc_es,2,5,0,5,0.662742,0.608866,0.001946,"#ffa64e"
157981564,EU_Commission,8,5,0,5,0.646335,0.326501,0.001946,"#00ed5d"
158025428,isblagi,40,0,1,1,0.578137,0.022749,0,"#ff12a3"
158064897,JavierPeralta_,49,0,1,1,0.470823,0.722859,0,"#ff7007"
158110584,EtnasSoft,20,1,1,2,0.401147,0.093539,0.000486,"#f0be45"
158224217,beatriz_guz_m,21,0,1,1,0.270744,0.216336,0,"#c6cc85"
158287147,Spartan2709,34,0,2,2,0.435946,0.376503,0.000486,"#ff0d69"
158364195,memoriav_ch,1,3,0,3,0.464913,0.463674,0.000973,"#b6cb00"
158377129,LauraEchague,55,0,5,5,0.651038,0.667735,0.001946,"#cb3f32"
158384387,Lulibu81,38,0,1,1,0.545166,0.462768,0,"#662859"
158445401,NEH_ODH,36,40,2,42,0.458825,0.489954,0.019942,"#825403"
158448866,olisassa,36,1,2,3,0.35729,0.524422,0.000973,"#825403"
158461349,MoraVicenteLuis,30,18,7,25,0.547619,0.484251,0.011673,"#ff77ff"
158492587,FUNDACIONUNAMUN,13,0,1,1,0.43907,0.374394,0,"#3bec00"
158493824,comecyt,41,2,0,2,0.453545,0.349153,0.000486,"#697b00"
158498312,JhignnyRob,30,0,1,1,0.634464,0.573273,0,"#ff77ff"
158505485,Red__Accion,49,1,0,1,0.334417,0.635477,0,"#ff7007"
158586228,Isa_Uribe,37,0,1,1,0.371651,0.327827,0,"#006032"
158618406,iochany,21,0,2,2,0.283736,0.247766,0.000486,"#c6cc85"
158667401,FrederiqueLG,22,5,0,5,0.522534,0.512554,0.001946,"#00e8b2"
158675898,ChemaCepeda,49,1,0,1,0.422541,0.646339,0,"#ff7007"
158759266,caranda13,14,0,3,3,0.532006,0.491416,0.000973,"#00eeff"
158789163,CuevasRamon,49,1,0,1,0.399516,0.648662,0,"#ff7007"
158905314,marcearzamendia,37,0,1,1,0.209709,0.493322,0,"#006032"
158914703,pavelunes,34,0,1,1,0.478091,0.264316,0,"#ff0d69"
159065668,lrpbyzard,49,3,7,10,0.432753,0.421972,0.004377,"#ff7007"
159117645,Popularenlinea,14,1,0,1,0.462504,0.682147,0,"#00eeff"
159124060,angitel,21,0,1,1,0.236077,0.208995,0,"#c6cc85"
159143915,Soul_Doctor,34,0,1,1,0.326991,0.421021,0,"#ff0d69"
159154504,ICATUNAM,7,0,1,1,0.632851,0.378637,0,"#ffb800"
159158075,Caldera_films,21,0,2,2,0.251794,0.230398,0.000486,"#c6cc85"
159204899,NEH_Education,36,1,1,2,0.418809,0.482439,0.000486,"#825403"
159223228,nidyaemperatriz,42,0,1,1,0.756033,0.41469,0,"#66e087"
159238222,josededalus,49,2,3,5,0.431529,0.648299,0.001946,"#ff7007"
159282482,JL_SoldeLu,13,0,3,3,0.503878,0.425526,0.000973,"#3bec00"
159296955,BecariosUNAM,7,0,1,1,0.626311,0.367683,0,"#ffb800"
159444423,marisatsilva,30,0,1,1,0.4948,0.632029,0,"#ff77ff"
159578098,DeJuncoYCapuli,49,0,2,2,0.396603,0.591209,0.000486,"#ff7007"
159631280,facu_it,49,0,5,5,0.555868,0.462438,0.001946,"#ff7007"
159642266,topodata,1,0,2,2,0.676639,0.469372,0.000486,"#b6cb00"
159796963,8urghardt,13,1,0,1,0.391938,0.401323,0,"#3bec00"
159844494,pilylule,49,1,0,1,0.324779,0.608358,0,"#ff7007"
159944195,ANACOIE,30,0,1,1,0.470672,0.653878,0,"#ff77ff"
159999798,jcoulon,21,0,1,1,0.223057,0.209829,0,"#c6cc85"
160020651,FelipeDuqueCO,38,0,1,1,0.591803,0.355119,0,"#662859"
160069056,LeonardQuinde,49,1,0,1,0.365503,0.639615,0,"#ff7007"
160083636,TuQmano,37,0,2,2,0.280451,0.450506,0.000486,"#006032"
160178643,AlbertFlexas,13,0,2,2,0.593569,0.448155,0.000486,"#3bec00"
160194192,Luisjoargue,38,0,1,1,0.436367,0.769462,0,"#662859"
160222433,aline_frederico,49,1,0,1,0.422474,0.464213,0,"#ff7007"
160315099,RChavarroP,38,0,1,1,0.637713,0.38886,0,"#662859"
160345057,_avrdgz,42,0,1,1,0.712089,0.426678,0,"#66e087"
160346651,paigecmorgan,13,11,14,25,0.453004,0.473071,0.011673,"#3bec00"
160347095,carojimenezpiza,30,4,2,6,0.421593,0.456762,0.002432,"#ff77ff"
160357507,Faberrante,35,2,0,2,0.552544,0.419878,0.000486,"#00faff"
160503147,SergioJValera,0,0,1,1,0.783359,0.704755,0,"#8ecfec"
160527543,motivandomec7,8,0,1,1,0.254556,0.275487,0,"#00ed5d"
160579945,maov74,3,0,1,1,0.695728,0.655079,0,"#ffb3ff"
160648011,CRSH_SSHRC,34,1,0,1,0.260111,0.622806,0,"#ff0d69"
160648525,DCD_ES,49,1,0,1,0.413296,0.652924,0,"#ff7007"
160831087,generalitat,31,1,0,1,0.636351,0.48455,0,"#3e93ff"
160846290,bibliotecaumu,22,0,1,1,0.709294,0.725385,0,"#00e8b2"
160873540,Melabosch,49,29,0,29,0.459299,0.555659,0.013619,"#ff7007"
160933196,Leia_Jimenez,22,0,1,1,0.62249,0.590766,0,"#00e8b2"
160951738,SandraClementeP,22,0,1,1,0.513131,0.700755,0,"#00e8b2"
160998941,nascar_oz,13,0,1,1,0.506623,0.235832,0,"#3bec00"
161081949,Carlossassarini,49,1,0,1,0.345645,0.664115,0,"#ff7007"
161082811,UPMexico,22,15,0,15,0.618272,0.485093,0.006809,"#00e8b2"
161136970,visavistv,49,1,0,1,0.335847,0.633178,0,"#ff7007"
161232262,nextepRetail,49,1,0,1,0.397829,0.636947,0,"#ff7007"
161245703,toledoayto,15,6,0,6,0.566734,0.630326,0.002432,"#008ebb"
161261335,avillamudria,49,1,0,1,0.300583,0.659208,0,"#ff7007"
161324218,felicephysioc,13,0,1,1,0.396546,0.390245,0,"#3bec00"
161390775,_Melimelum_,49,0,3,3,0.398875,0.618232,0.000973,"#ff7007"
161410449,el_aijon,30,0,1,1,0.688123,0.608009,0,"#ff77ff"
161421433,advenis,38,0,2,2,0.546884,0.421843,0.000486,"#662859"
161425305,anniecanizares,14,0,2,2,0.43453,0.524467,0.000486,"#00eeff"
161471794,cneudecker,22,3,0,3,0.566294,0.704339,0.000973,"#00e8b2"
161497051,aibexint,49,0,3,3,0.413219,0.542692,0.000973,"#ff7007"
161505253,manfergon28,34,0,1,1,0.618833,0.31486,0,"#ff0d69"
161533707,alberto_diazb,7,0,1,1,0.792857,0.324702,0,"#ffb800"
161557211,fahusac,49,8,0,8,0.698124,0.726498,0.003405,"#ff7007"
161565042,GabrielVsArT,30,0,1,1,0.527233,0.627438,0,"#ff77ff"
161738914,OEAndramunio,38,0,2,2,0.59331,0.400045,0.000486,"#662859"
161770575,zoedk,22,0,2,2,0.567755,0.583819,0.000486,"#00e8b2"
161834514,lauracamilav_,14,0,2,2,0.620898,0.568546,0.000486,"#00eeff"
161848469,SeredNET,55,1,2,3,0.602503,0.518152,0.000973,"#cb3f32"
161916370,jlmac85,31,0,1,1,0.675418,0.5511,0,"#3e93ff"
162000654,soniachaconp,0,0,1,1,0.778721,0.701777,0,"#8ecfec"
162006707,Sofi_Real,36,0,1,1,0.587371,0.416095,0,"#825403"
162102227,6isellinna,7,0,1,1,0.625604,0.37302,0,"#ffb800"
162268635,CRomanZamitiz,35,0,1,1,0.581889,0.305037,0,"#00faff"
162444169,marcelalpintos,14,0,3,3,0.705121,0.513746,0.000973,"#00eeff"
162510767,caramelcianuro,13,0,1,1,0.358519,0.305399,0,"#3bec00"
162518249,carmonatierno,14,2,5,7,0.521582,0.537711,0.002918,"#00eeff"
162574146,monaperro,38,0,2,2,0.81405,0.431737,0.000486,"#662859"
162631565,CiriloGR,30,1,1,2,0.551372,0.568482,0.000486,"#ff77ff"
162667212,museudeldisseny,22,8,4,12,0.563018,0.609366,0.00535,"#00e8b2"
162693918,fhersanmi,31,3,10,13,0.566964,0.514699,0.005837,"#3e93ff"
162714394,nelis_,13,1,0,1,0.463652,0.398815,0,"#3bec00"
162767978,Jonaltuna,37,0,1,1,0.638133,0.422717,0,"#006032"
162915642,abregotron,36,0,5,5,0.46021,0.503261,0.001946,"#825403"
162970127,CescQuintero,3,0,1,1,0.44218,0.767541,0,"#ffb3ff"
163080649,mcarmengalvez,31,1,1,2,0.602316,0.533176,0.000486,"#3e93ff"
163116206,robertogarciauy,13,0,1,1,0.42023,0.495202,0,"#3bec00"
163176846,albaesli,31,0,1,1,0.62958,0.417987,0,"#3e93ff"
163196243,Vancontreras,49,0,1,1,0.242981,0.67208,0,"#ff7007"
163223581,albertoln23,13,0,1,1,0.488959,0.340997,0,"#3bec00"
163263781,jailandrade,22,0,1,1,0.398327,0.60621,0,"#00e8b2"
163315631,LuisCuauh,7,0,2,2,0.419146,0.340929,0.000486,"#ffb800"
163380043,esiiab,15,1,0,1,0.518743,0.739644,0,"#008ebb"
163417390,mabecquer,22,0,2,2,0.565552,0.614993,0.000486,"#00e8b2"
163462425,jmcmahonztown,30,1,2,3,0.682872,0.630972,0.000973,"#ff77ff"
163471233,healthdevice,22,0,3,3,0.561596,0.406169,0.000973,"#00e8b2"
163486832,Laboreiro,37,0,1,1,0.755242,0.501096,0,"#006032"
163506704,spenaf,21,0,1,1,0.196752,0.230558,0,"#c6cc85"
163550068,ifelipegarcia,38,0,1,1,0.6726,0.470046,0,"#662859"
163605791,anaisgarrell,8,2,0,2,0.669832,0.262065,0.000486,"#00ed5d"
163696775,KrenRG,25,2,0,2,0.578545,0.093568,0.000486,"#f4a2ff"
163770896,EUErasmusPlus,31,1,0,1,0.642658,0.520523,0,"#3e93ff"
163809207,estudiocreanova,49,1,0,1,0.347775,0.648306,0,"#ff7007"
163909658,barbolanero,1,0,2,2,0.441562,0.645804,0.000486,"#b6cb00"
163933146,WookieeTropical,34,0,14,14,0.474552,0.449769,0.006323,"#ff0d69"
164192043,gagarrido3,14,0,2,2,0.625874,0.534744,0.000486,"#00eeff"
164239677,errenterialib,36,0,1,1,0.337866,0.153244,0,"#825403"
164253308,clusterticgal,14,3,5,8,0.517764,0.577558,0.003405,"#00eeff"
164259878,Codicologist,13,0,1,1,0.466516,0.394735,0,"#3bec00"
164268876,Beacelaya,30,2,0,2,0.457777,0.622727,0.000486,"#ff77ff"
164290943,ericbrasiln,36,68,62,130,0.495191,0.383799,0.062743,"#825403"
164293634,Geniakagi,31,0,4,4,0.591477,0.495544,0.001459,"#3e93ff"
164307213,ColaBoraBora,18,0,1,1,0.754846,0.63025,0,"#5456a6"
164374560,pacomav,49,0,1,1,0.331987,0.393859,0,"#ff7007"
164409607,jantobe,22,0,1,1,0.621479,0.504454,0,"#00e8b2"
164450358,marioguzzzman,36,5,1,6,0.779683,0.302191,0.002432,"#825403"
164478889,1n9r1d,30,0,1,1,0.558723,0.638426,0,"#ff77ff"
164621412,MuseoTransicion,19,6,0,6,0.607041,0.686439,0.002432,"#00d3ff"
164653540,KharolusIII,49,10,17,27,0.468499,0.531125,0.012646,"#ff7007"
164737112,osestrada,41,1,0,1,0.256969,0.337232,0,"#697b00"
164741897,eldaruiz1,27,2,1,3,0.201155,0.659316,0.000973,"#7e8b76"
164761258,sincasilla,38,0,1,1,0.44399,0.762797,0,"#662859"
164777194,SigloDurango,3,7,1,8,0.457704,0.738185,0.003405,"#ffb3ff"
164814741,mpirateque,38,0,2,2,0.398011,0.458917,0.000486,"#662859"
164877642,mspillar10,36,0,9,9,0.511715,0.440014,0.003891,"#825403"
164901077,vivicascom,37,0,1,1,0.216271,0.471281,0,"#006032"
164962255,adriansalinasv,36,0,5,5,0.463143,0.501226,0.001946,"#825403"
164969574,LorenA_EP_,37,0,3,3,0.586022,0.463542,0.000973,"#006032"
165082814,DanJer1994,21,0,2,2,0.224618,0.260924,0.000486,"#c6cc85"
165190878,javieralkmista,21,0,2,2,0.212406,0.251932,0.000486,"#c6cc85"
165209100,kjmilla,40,0,1,1,0.632317,0.037452,0,"#ff12a3"
165337642,9vidas,13,1,3,4,0.527221,0.446889,0.001459,"#3bec00"
165342631,teoriantropolog,7,0,7,7,0.460592,0.44977,0.002918,"#ffb800"
165480709,nadiarevenga,34,0,2,2,0.453896,0.530936,0.000486,"#ff0d69"
165480860,ernestmaragall,8,1,0,1,0.641003,0.248589,0,"#00ed5d"
165484051,RedNel_,38,3,2,5,0.556328,0.436468,0.001946,"#662859"
165601210,editorialteseo,22,1,0,1,0.477975,0.698647,0,"#00e8b2"
165626004,DannyYahary,37,0,4,4,0.319685,0.493402,0.001459,"#006032"
165655969,SamuraiAntifa,48,0,1,1,0.211441,0.717824,0,"#ff7a78"
165724114,XavierAntich,8,5,0,5,0.639839,0.362831,0.001946,"#00ed5d"
165792584,Gomezjrs,22,0,6,6,0.516197,0.566699,0.002432,"#00e8b2"
165841068,NelVillarreal,55,0,4,4,0.682741,0.646411,0.001459,"#cb3f32"
165844715,mosqueirandres,21,0,2,2,0.274415,0.223435,0.000486,"#c6cc85"
165848423,stanfordpress,30,1,0,1,0.678307,0.599451,0,"#ff77ff"
166030592,rivaquiroga,34,36,5,41,0.479122,0.450888,0.019455,"#ff0d69"
166049809,Coloboren,37,0,1,1,0.69957,0.469913,0,"#006032"
166092912,borjarguez12,49,1,0,1,0.290359,0.622077,0,"#ff7007"
166101041,franciscoagenjo,0,0,2,2,0.471623,0.565355,0.000486,"#8ecfec"
166188195,jordifarrecoma,14,0,3,3,0.666524,0.506407,0.000973,"#00eeff"
166207562,iPurohitHarshal,3,0,1,1,0.491523,0.654023,0,"#ffb3ff"
166349871,aguirrejimena,49,0,1,1,0.377262,0.519396,0,"#ff7007"
166366818,AlbertoAlmonte,49,1,0,1,0.398663,0.671591,0,"#ff7007"
166368041,danieltperes,36,1,0,1,0.531334,0.312071,0,"#825403"
166376026,Glockenspiel2,49,1,0,1,0.399517,0.68122,0,"#ff7007"
166507237,elEconomistaes,1,5,0,5,0.669238,0.591363,0.001946,"#b6cb00"
166513773,melinamasnatta,13,1,4,5,0.44974,0.509558,0.001946,"#3bec00"
166526634,RoseliaCristina,36,0,1,1,0.519726,0.32667,0,"#825403"
166533671,ConsMadrono,31,34,24,58,0.567886,0.553587,0.027724,"#3e93ff"
166576970,esfera_publica_,35,0,6,6,0.484523,0.313918,0.002432,"#00faff"
166636785,luissandoval_ar,3,0,1,1,0.593138,0.711729,0,"#ffb3ff"
166649009,DigAmericanists,34,2,3,5,0.428713,0.428528,0.001946,"#ff0d69"
166660272,londones,2,0,2,2,0.664288,0.618248,0.000486,"#ffa64e"
166661082,bellapalomo,14,1,0,1,0.639853,0.584692,0,"#00eeff"
166681690,pechama,49,0,2,2,0.427634,0.618566,0.000486,"#ff7007"
166704830,alereclus,34,0,8,8,0.518666,0.448717,0.003405,"#ff0d69"
166755798,Jorgemet,55,1,1,2,0.699201,0.634636,0.000486,"#cb3f32"
166815728,leo_m_martinez,38,0,1,1,0.675714,0.33636,0,"#662859"
166866466,sergiogarciamor,37,0,1,1,0.209775,0.466552,0,"#006032"
166924284,ulbbonn,34,2,0,2,0.458116,0.47585,0.000486,"#ff0d69"
166946169,gothikxx,3,0,1,1,0.473822,0.769837,0,"#ffb3ff"
166961716,andreaigls,38,0,1,1,0.079428,0.427924,0,"#662859"
166970332,maria_debsas,3,2,1,3,0.442028,0.623047,0.000973,"#ffb3ff"
166976901,tengotronombre,21,0,2,2,0.243291,0.240405,0.000486,"#c6cc85"
167004627,LupitaLGarfias,35,2,249,251,0.488585,0.493698,0.121595,"#00faff"
167013320,cahercal,34,0,1,1,0.62112,0.325633,0,"#ff0d69"
167029777,BiblioBurgoa,41,6,2,8,0.370852,0.449019,0.003405,"#697b00"
167071985,jamaboto,3,0,1,1,0.470602,0.782791,0,"#ffb3ff"
167081016,RadioAnahuacAM,49,2,0,2,0.489924,0.657315,0.000486,"#ff7007"
167106534,tecnogaming,49,1,0,1,0.342984,0.599914,0,"#ff7007"
167142337,TEIconsortium,49,91,16,107,0.434885,0.487713,0.051556,"#ff7007"
167193654,EColman11,37,0,1,1,0.189328,0.475837,0,"#006032"
167207270,javierris,42,0,2,2,0.782061,0.431534,0.000486,"#66e087"
167313469,andalgeos,22,4,4,8,0.693747,0.463142,0.003405,"#00e8b2"
167447332,IsabelRMora,14,0,2,2,0.61399,0.527049,0.000486,"#00eeff"
167449613,SoyVictorCamara,7,0,1,1,0.370813,0.361144,0,"#ffb800"
167520724,RoalvaCORPS,7,0,2,2,0.577424,0.402351,0.000486,"#ffb800"
167550798,leigchile,21,0,1,1,0.251844,0.190232,0,"#c6cc85"
167656864,Rocker_Flower,7,0,2,2,0.41714,0.364799,0.000486,"#ffb800"
167744248,piapaulette,34,0,4,4,0.631583,0.415715,0.001459,"#ff0d69"
167746302,CLIOENRED,30,0,3,3,0.508451,0.587803,0.000973,"#ff77ff"
167826788,Isa_Edith,30,0,3,3,0.498939,0.574978,0.000973,"#ff77ff"
167837430,algonhermen,14,0,4,4,0.555301,0.493908,0.001459,"#00eeff"
167849254,trinikar,22,0,1,1,0.376044,0.198502,0,"#00e8b2"
167901311,anserran31,22,0,1,1,0.612662,0.622914,0,"#00e8b2"
167950063,sandvaldettaro,49,6,3,9,0.43756,0.57388,0.003891,"#ff7007"
167970253,mgonzov,0,0,3,3,0.490941,0.594898,0.000973,"#8ecfec"
168039723,danielareta,3,0,1,1,0.430725,0.740104,0,"#ffb3ff"
168141963,roju134,37,0,2,2,0.252173,0.49374,0.000486,"#006032"
168171431,paisamed022,22,0,1,1,0.593378,0.629573,0,"#00e8b2"
168290039,UNIRadioUdelaR,55,0,1,1,0.718669,0.65448,0,"#cb3f32"
168360751,MauricioAcunaE,21,0,1,1,0.05141,0.627926,0,"#c6cc85"
168369572,javi_noriega,22,1,0,1,0.514844,0.675689,0,"#00e8b2"
168447928,emilio_delrio,58,5,2,7,0.677807,0.62501,0.002918,"#005076"
168497410,micalle2666,1,0,1,1,0.311637,0.746119,0,"#b6cb00"
168508680,redlightvoices,34,2,0,2,0.455484,0.431786,0.000486,"#ff0d69"
168566657,IAmDylanLewis,34,0,1,1,0.310108,0.412185,0,"#ff0d69"
168619698,sciencespo,13,1,0,1,0.349858,0.329665,0,"#3bec00"
168621307,elydaniello,7,0,1,1,0.368521,0.402839,0,"#ffb800"
168627231,ferli90,13,0,4,4,0.479805,0.514012,0.001459,"#3bec00"
168632780,UniTeramo,30,1,1,2,0.552643,0.460332,0.000486,"#ff77ff"
168636686,BiblogTecarios,22,21,0,21,0.506084,0.612044,0.009728,"#00e8b2"
168667197,demivasques,49,1,0,1,0.388947,0.371865,0,"#ff7007"
168711837,PepUrquiza,49,0,1,1,0.374181,0.579176,0,"#ff7007"
168726403,JUANcfCORTEZ,7,0,1,1,0.393919,0.292921,0,"#ffb800"
168738035,UniversitariosR,10,1,0,1,0.283078,0.533439,0,"#52d7c0"
168787934,ericacasado,13,1,0,1,0.423824,0.492897,0,"#3bec00"
168797849,HadaMSG,31,0,1,1,0.605297,0.465997,0,"#3e93ff"
168814455,anamariahergo,30,1,0,1,0.554381,0.624231,0,"#ff77ff"
168816402,MarcRavv,19,0,1,1,0.668629,0.787166,0,"#00d3ff"
168843136,tomascaifan,13,0,1,1,0.492149,0.399736,0,"#3bec00"
168848325,sandriwisrko,13,0,1,1,0.480134,0.392876,0,"#3bec00"
168859329,edarcam,10,0,1,1,0.400244,0.290903,0,"#52d7c0"
168893034,LauraCoy,38,0,1,1,0.324015,0.19416,0,"#662859"
168964093,hellcodex,13,0,1,1,0.481071,0.386641,0,"#3bec00"
168976780,numintec,49,1,0,1,0.316011,0.652929,0,"#ff7007"
168998883,PIMEC,8,5,0,5,0.660786,0.31499,0.001946,"#00ed5d"
169035102,Camara_Malaga,14,1,0,1,0.594353,0.36695,0,"#00eeff"
169093083,RONALCHOGO,42,0,1,1,0.726892,0.432651,0,"#66e087"
169135109,onica_aguilar,13,2,4,6,0.460985,0.411682,0.002432,"#3bec00"
169147882,UniversidadEan,38,5,2,7,0.554746,0.446645,0.002918,"#662859"
169317877,josemiguelmuniz,13,2,9,11,0.416262,0.514606,0.004864,"#3bec00"
169389350,silviajulianaa,38,45,5,50,0.151462,0.771682,0.023833,"#662859"
169449440,PereiraGallardo,30,0,1,1,0.732144,0.659462,0,"#ff77ff"
169486309,mfujita1023,13,0,1,1,0.438684,0.501244,0,"#3bec00"
169538164,diariARA,8,3,0,3,0.645626,0.335754,0.000973,"#00ed5d"
169576362,alexa1607,38,0,1,1,0.906739,0.565853,0,"#662859"
169589705,windloochie,34,0,1,1,0.308256,0.414658,0,"#ff0d69"
169613688,Heckoviedo,8,0,1,1,0.273845,0.269015,0,"#00ed5d"
169665115,MarceloDenzerD,21,0,1,1,0.248993,0.215173,0,"#c6cc85"
169847941,rvalama,49,1,0,1,0.307534,0.620991,0,"#ff7007"
169860894,infoclio,13,0,1,1,0.540738,0.456776,0,"#3bec00"
169862753,juanarza,49,1,0,1,0.391566,0.674562,0,"#ff7007"
169922611,wakelet,30,5,0,5,0.658004,0.635357,0.001946,"#ff77ff"
169962449,Retiario,14,1,0,1,0.60902,0.480465,0,"#00eeff"
169991911,riveroines,31,0,1,1,0.648706,0.509209,0,"#3e93ff"
170027490,UNESCOMexico,7,0,1,1,0.508389,0.18691,0,"#ffb800"
170318610,silvinanoguera,49,0,3,3,0.456164,0.58224,0.000973,"#ff7007"
170367303,andreavmassei,49,0,2,2,0.415237,0.624884,0.000486,"#ff7007"
170493859,pedrobmh,36,0,1,1,0.509783,0.238045,0,"#825403"
170741771,CSVReel,37,1,0,1,0.535471,0.604157,0,"#006032"
170772042,RhinoMontilla,34,0,1,1,0.607655,0.328923,0,"#ff0d69"
170780382,CrisisRevista,49,1,0,1,0.391272,0.621634,0,"#ff7007"
170790316,ivetiga,41,9,4,13,0.373607,0.400321,0.005837,"#697b00"
170862655,mariaschab,37,1,0,1,0.550954,0.367919,0,"#006032"
170894519,erikakikat,34,0,2,2,0.503737,0.438156,0.000486,"#ff0d69"
170906578,__Yemaya1621,3,0,1,1,0.608391,0.704302,0,"#ffb3ff"
171014736,bibupo,1,20,17,37,0.512782,0.567705,0.01751,"#b6cb00"
171042723,torbe_,40,0,1,1,0.575261,0.025722,0,"#ff12a3"
171047449,UMU,22,14,4,18,0.652103,0.688813,0.008268,"#00e8b2"
171070954,estiru,30,0,1,1,0.488958,0.602924,0,"#ff77ff"
171119329,OfeTG,0,0,2,2,0.431267,0.594805,0.000486,"#8ecfec"
171123181,welma_reis,48,0,1,1,0.238685,0.725939,0,"#ff7a78"
171151737,HelloKommie,34,0,3,3,0.376199,0.416701,0.000973,"#ff0d69"
171179438,editorcnps,21,0,1,1,0.187154,0.403778,0,"#c6cc85"
171194740,willyzap,9,0,2,2,0.667922,0.919312,0.000486,"#008f7b"
171199032,rfflourenco,22,0,1,1,0.566542,0.676367,0,"#00e8b2"
171285443,Karibenitez34,37,0,6,6,0.280757,0.525157,0.002432,"#006032"
171293005,JPerezRolon,7,0,1,1,0.415987,0.198038,0,"#ffb800"
171319361,ArquitectoAB,36,0,4,4,0.630326,0.488232,0.001459,"#825403"
171458280,sntaemepe,30,0,1,1,0.60099,0.415895,0,"#ff77ff"
171487250,BotQueHabla,37,0,1,1,0.612167,0.55405,0,"#006032"
171607135,ENVIVOFM,1,0,1,1,0.438483,0.64596,0,"#b6cb00"
171675264,La_burgoa18,42,0,1,1,0.667306,0.398543,0,"#66e087"
171710267,rocabert,49,1,0,1,0.360961,0.65992,0,"#ff7007"
171720258,martinalalu,49,6,4,10,0.419166,0.558227,0.004377,"#ff7007"
171840366,dcortesmut,49,1,0,1,0.408858,0.700205,0,"#ff7007"
171858760,ASUS_ib,49,1,0,1,0.326257,0.653154,0,"#ff7007"
171881265,marinageli,8,9,0,9,0.655672,0.322198,0.003891,"#00ed5d"
171940424,mei_kusanabe,38,0,1,1,0.627807,0.363298,0,"#662859"
172017800,yoloquierover,7,0,1,1,0.391826,0.331135,0,"#ffb800"
172089136,delcastellano,49,2,0,2,0.428756,0.544288,0.000486,"#ff7007"
172139322,icanogar,49,9,42,51,0.483962,0.515987,0.024319,"#ff7007"
172157701,Micalchelius,7,0,1,1,0.401123,0.212981,0,"#ffb800"
172195990,LulaGF,37,0,1,1,0.464605,0.28708,0,"#006032"
172201522,champita7,13,1,0,1,0.468025,0.390406,0,"#3bec00"
172368909,BancoRepublica,13,1,3,4,0.548535,0.470429,0.001459,"#3bec00"
172371376,monicabasualdo,37,0,1,1,0.218385,0.486683,0,"#006032"
172385141,UPabierta,22,11,2,13,0.780778,0.325396,0.005837,"#00e8b2"
172387310,TraduXio,36,5,0,5,0.503941,0.419322,0.001946,"#825403"
172397304,fran_snchz,13,0,1,1,0.408587,0.416995,0,"#3bec00"
172449081,TREMEDICA,15,3,0,3,0.573882,0.459616,0.000973,"#008ebb"
172453645,Dogmazic,55,0,2,2,0.64315,0.656435,0.000486,"#cb3f32"
172516917,plazamora,13,0,1,1,0.409429,0.41696,0,"#3bec00"
172562272,raque1803,13,0,1,1,0.408464,0.468825,0,"#3bec00"
172614336,CarteleraCursos,34,0,2,2,0.637858,0.352447,0.000486,"#ff0d69"
172873047,Kelley_Kreitz,34,2,4,6,0.426232,0.446579,0.002432,"#ff0d69"
172874040,marianocabano,3,0,1,1,0.61887,0.710709,0,"#ffb3ff"
172999288,SergVisacovsky,7,0,1,1,0.81051,0.543392,0,"#ffb800"
173222388,lamartina0227,38,0,1,1,0.636008,0.385083,0,"#662859"
173301796,CSaizar,10,0,1,1,0.354344,0.501702,0,"#52d7c0"
173336573,crcc0206,7,0,1,1,0.406567,0.200028,0,"#ffb800"
173353993,laura_enriquez,36,0,2,2,0.429287,0.336053,0.000486,"#825403"
173435022,fmsilvestre,0,0,2,2,0.429692,0.577143,0.000486,"#8ecfec"
173577456,pgamalho,36,0,1,1,0.610491,0.403319,0,"#825403"
173588758,marciazeng,22,1,0,1,0.629732,0.598034,0,"#00e8b2"
173657385,karocepeda,42,0,2,2,0.684828,0.432656,0.000486,"#66e087"
173735526,CNB_CSIC,22,1,2,3,0.533734,0.54882,0.000973,"#00e8b2"
173881525,iaravps,49,2,19,21,0.512581,0.427219,0.009728,"#ff7007"
173890622,Objetivos2030,31,0,2,2,0.540448,0.502847,0.000486,"#3e93ff"
173915441,DHcenterNet,36,22,0,22,0.479301,0.507113,0.010214,"#825403"
173994333,FCHE_UN,31,1,2,3,0.473232,0.490099,0.000973,"#3e93ff"
174153339,asjular,22,0,2,2,0.216777,0.56477,0.000486,"#00e8b2"
174164762,pardalp,22,0,2,2,0.75423,0.232182,0.000486,"#00e8b2"
174192737,danicorominas,14,0,1,1,0.704875,0.459596,0,"#00eeff"
174226736,cityuni_hcid,13,0,1,1,0.492034,0.363136,0,"#3bec00"
174267583,soulsurfera,30,0,1,1,0.512158,0.623249,0,"#ff77ff"
174301293,MemoriaChilena,21,407,6,413,0.276507,0.273,0.200389,"#c6cc85"
174335979,IsaGomezA,7,0,2,2,0.435005,0.286297,0.000486,"#ffb800"
174338398,zulmaucv,37,0,1,1,0.595411,0.332272,0,"#006032"
174378912,ConectarGob,8,4,0,4,0.40535,0.717508,0.001459,"#00ed5d"
174402844,alvarezg_,12,0,2,2,0.85685,0.568975,0.000486,"#00a04a"
174502743,kikamex58,34,1,2,3,0.473731,0.365353,0.000973,"#ff0d69"
174529522,Antonio_HF,3,0,1,1,0.487228,0.663001,0,"#ffb3ff"
174553150,MeisterEckart,7,0,1,1,0.647987,0.371723,0,"#ffb800"
174618955,jm_c_r,49,1,0,1,0.400962,0.634556,0,"#ff7007"
174661911,hipermedula,22,6,2,8,0.535493,0.541371,0.003405,"#00e8b2"
174675713,ip_ciisa,49,4,0,4,0.410496,0.46072,0.001459,"#ff7007"
174677778,BoeiroNovo,40,0,1,1,0.579332,0.032454,0,"#ff12a3"
174681621,gabygalindez,49,5,0,5,0.737085,0.591416,0.001946,"#ff7007"
174691472,Iker_Erdocia,2,0,2,2,0.471933,0.630096,0.000486,"#ffa64e"
174832795,RubenGPereyra,49,0,2,2,0.41773,0.506189,0.000486,"#ff7007"
174881104,sergiommedina,38,0,1,1,0.730375,0.371969,0,"#662859"
174884978,AliciaEsponda,13,0,1,1,0.536717,0.415897,0,"#3bec00"
174973144,VillanuevaPilar,49,1,0,1,0.401578,0.631332,0,"#ff7007"
174993209,dias_nordicos,37,1,0,1,0.190511,0.425266,0,"#006032"
175071376,ElPencheSaint,7,0,2,2,0.410994,0.367415,0.000486,"#ffb800"
175105020,AlissonMontijo,49,0,1,1,0.51239,0.380284,0,"#ff7007"
175105104,MeliVenu,14,0,1,1,0.684638,0.56224,0,"#00eeff"
175130821,martiperarnau,30,1,0,1,0.534385,0.748345,0,"#ff77ff"
175179487,Fernan_Molina,7,0,4,4,0.447965,0.410707,0.001459,"#ffb800"
175229205,infoeba,49,0,1,1,0.433837,0.625163,0,"#ff7007"
175250463,Mamaguzo,37,2,0,2,0.588064,0.367574,0.000486,"#006032"
175448120,fdovisual,3,0,1,1,0.478645,0.755031,0,"#ffb3ff"
175488530,mapatilla,29,2,0,2,0.273928,0.093506,0.000486,"#1fab00"
175490493,jesusrosalesPS,3,0,3,3,0.472724,0.694061,0.000973,"#ffb3ff"
175513035,rojasinostroza,21,3,1,4,0.378201,0.336964,0.001459,"#c6cc85"
175563147,Maravillaaaa,37,0,4,4,0.307292,0.501495,0.001459,"#006032"
175597179,LoraineVigoya,2,0,2,2,0.470836,0.628556,0.000486,"#ffa64e"
175806207,agaviriau,34,3,2,5,0.562288,0.354294,0.001946,"#ff0d69"
175855427,macrispla,8,0,1,1,0.521058,0.800015,0,"#00ed5d"
176197466,juliethacrow,0,0,2,2,0.447366,0.38829,0.000486,"#8ecfec"
176278453,MARIAAGOMEZU,9,0,5,5,0.690542,0.666863,0.001946,"#008f7b"
176309728,dennischang05,22,0,1,1,0.561417,0.809637,0,"#00e8b2"
176421939,bibliochillan,21,0,2,2,0.272478,0.238611,0.000486,"#c6cc85"
176505831,andurin,21,0,1,1,0.192831,0.236839,0,"#c6cc85"
176549955,IDL_Rivera,49,2,0,2,0.452339,0.637412,0.000486,"#ff7007"
176628498,EquidadGenero,7,0,2,2,0.411189,0.363317,0.000486,"#ffb800"
176647468,Scheinsohn,30,0,1,1,0.563251,0.560409,0,"#ff77ff"
176649998,alatorrecorro,38,0,1,1,0.445001,0.788244,0,"#662859"
176670324,ROGdelaH,34,0,7,7,0.513588,0.423851,0.002918,"#ff0d69"
176733810,annettestr,30,0,13,13,0.483125,0.516329,0.005837,"#ff77ff"
176766374,franrmartinez,2,0,2,2,0.687659,0.660502,0.000486,"#ffa64e"
176808646,Btcasylecturas,21,0,2,2,0.247835,0.237989,0.000486,"#c6cc85"
176825805,EstebanZamoraDI,22,0,1,1,0.614547,0.643559,0,"#00e8b2"
176842355,marcomunica,21,0,2,2,0.266389,0.231274,0.000486,"#c6cc85"
176858341,SrTipaguaqueza,58,0,2,2,0.598633,0.310712,0.000486,"#005076"
176932593,UCBerkeley,14,13,0,13,0.570501,0.506053,0.005837,"#00eeff"
176935489,clauxvargas,21,0,1,1,0.182613,0.253333,0,"#c6cc85"
177002349,fer_cquintana,17,0,1,1,0.613214,0.277376,0,"#ff9cc7"
177153099,bucm_educacion,58,1,0,1,0.714604,0.759467,0,"#005076"
177154434,byrone19,12,5,1,6,0.787724,0.603765,0.002432,"#00a04a"
177235603,fvalsak,49,1,0,1,0.412106,0.672631,0,"#ff7007"
177252745,FiguerasAlfredo,30,0,1,1,0.532528,0.622024,0,"#ff77ff"
177254632,galindo45,7,0,1,1,0.835471,0.54903,0,"#ffb800"
177275765,fgv_emap,36,8,0,8,0.51149,0.443644,0.003405,"#825403"
177301319,ArbolHueco,22,0,1,1,0.392213,0.603805,0,"#00e8b2"
177324933,algutier55,49,1,0,1,0.355124,0.702446,0,"#ff7007"
177368645,Barbarellatweet,15,0,4,4,0.579618,0.535487,0.001459,"#008ebb"
177393677,urbavista2010,7,0,1,1,0.805842,0.550747,0,"#ffb800"
177417499,Masterenplastil,38,0,2,2,0.523138,0.368053,0.000486,"#662859"
177567220,galarzaalex,13,2,12,14,0.502081,0.476579,0.006323,"#3bec00"
177612282,patrimoniocl,21,0,2,2,0.226894,0.257275,0.000486,"#c6cc85"
177617759,garmirbcn,2,0,2,2,0.643525,0.652046,0.000486,"#ffa64e"
177638816,BaldomeroPessoa,38,0,1,1,0.153946,0.432373,0,"#662859"
177638987,xaviergarciach,22,0,2,2,0.639516,0.453444,0.000486,"#00e8b2"
177665568,CODiEAwards,49,1,0,1,0.384991,0.333268,0,"#ff7007"
177699645,fermo_rey,38,0,1,1,0.538961,0.363168,0,"#662859"
177700152,quilombificador,1,0,2,2,0.525202,0.693296,0.000486,"#b6cb00"
177729626,MissBereSanchez,17,0,1,1,0.900457,0.383606,0,"#ff9cc7"
177734181,aarojasm,21,0,2,2,0.262386,0.286977,0.000486,"#c6cc85"
177753378,briandaniela,3,0,1,1,0.322931,0.595417,0,"#ffb3ff"
177760804,LeContrefacteur,13,1,2,3,0.522461,0.464691,0.000973,"#3bec00"
177783400,TrinandoAndo,49,1,0,1,0.429579,0.652613,0,"#ff7007"
177783625,ParanoidCamilo,49,1,0,1,0.710094,0.520931,0,"#ff7007"
177827446,PabloAlcain,37,0,1,1,0.231063,0.488264,0,"#006032"
177862974,NavarraTV,1,1,0,1,0.722851,0.447311,0,"#b6cb00"
177879198,UCM_ECONOMICAS,22,0,2,2,0.665724,0.484403,0.000486,"#00e8b2"
177916054,jrlopezbenito,18,7,4,11,0.593766,0.585252,0.004864,"#5456a6"
177951337,rswharton,30,0,2,2,0.531027,0.532003,0.000486,"#ff77ff"
178029472,mpcastellanos,49,1,0,1,0.634549,0.667947,0,"#ff7007"
178038250,oscarenriquehr,13,1,5,6,0.422937,0.472398,0.002432,"#3bec00"
178148164,carguero,38,0,4,4,0.466234,0.365946,0.001459,"#662859"
178222168,ProfesorJLD,30,0,1,1,0.454168,0.596532,0,"#ff77ff"
178373330,carcely,49,1,0,1,0.400996,0.679057,0,"#ff7007"
178468034,natcorbe,49,10,19,29,0.475155,0.524979,0.013619,"#ff7007"
178505043,PucheNavarro,34,0,3,3,0.52407,0.490351,0.000973,"#ff0d69"
178699489,PPermint_Paty,21,0,1,1,0.772586,0.530704,0,"#c6cc85"
178773513,malva_visca,21,0,1,1,0.468412,0.949208,0,"#c6cc85"
178785518,yusterafa,22,1,0,1,0.231154,0.681504,0,"#00e8b2"
178833948,FJMartinLopez,30,0,1,1,0.483583,0.694607,0,"#ff77ff"
178849800,eduardo_vitalp,7,0,1,1,0.394876,0.201003,0,"#ffb800"
178900499,aancos,49,1,0,1,0.39836,0.69318,0,"#ff7007"
179205310,herkarajan,4,0,1,1,0.857753,0.228852,0,"#f4c8cf"
179454674,rbarrosgar,22,0,2,2,0.648624,0.484596,0.000486,"#00e8b2"
179542369,codices_hunter,14,1,2,3,0.530392,0.471884,0.000973,"#00eeff"
179619613,roseaneomartins,36,0,1,1,0.459803,0.263213,0,"#825403"
179629797,alaicnet,37,1,0,1,0.462103,0.348508,0,"#006032"
179633141,extranjerolocal,13,0,1,1,0.417115,0.432858,0,"#3bec00"
179633771,Luzpaochis,34,0,2,2,0.425037,0.313179,0.000486,"#ff0d69"
179697435,AncaMatioc,0,0,2,2,0.449024,0.383677,0.000486,"#8ecfec"
179733832,EliasElProfe,3,0,1,1,0.672495,0.713425,0,"#ffb3ff"
179778442,airam_ainegue,3,3,1,4,0.450355,0.599916,0.001459,"#ffb3ff"
179895086,diputacioncadiz,37,1,0,1,0.706071,0.39449,0,"#006032"
179897664,nmiro,3,1,0,1,0.41792,0.754076,0,"#ffb3ff"
180052759,eufemiaabad,49,2,0,2,0.410655,0.582612,0.000486,"#ff7007"
180114639,marespe13,7,0,1,1,0.400443,0.358426,0,"#ffb800"
180207005,andresrguez,30,0,2,2,0.573386,0.555587,0.000486,"#ff77ff"
180235044,EloyRuiz,31,0,1,1,0.720526,0.477661,0,"#3e93ff"
180272447,dgllana,58,0,1,1,0.567791,0.139328,0,"#005076"
180298000,RubenVerborgh,34,29,0,29,0.48408,0.476727,0.013619,"#ff0d69"
180342891,jmvva,30,6,8,14,0.526227,0.50919,0.006323,"#ff77ff"
180391444,gonzai17,3,0,1,1,0.445553,0.746535,0,"#ffb3ff"
180401445,superarale,31,0,2,2,0.578512,0.502909,0.000486,"#3e93ff"
180411171,antfilfon,36,2,1,3,0.518225,0.373684,0.000973,"#825403"
180489593,anamamoreno,30,4,0,4,0.52147,0.63932,0.001459,"#ff77ff"
180514577,redesdamare,36,2,0,2,0.800894,0.726738,0.000486,"#825403"
180552155,crischul,22,0,1,1,0.609436,0.625559,0,"#00e8b2"
180565776,jicriado,37,1,0,1,0.695981,0.552371,0,"#006032"
180587059,MargCalle,9,0,1,1,0.721887,0.668638,0,"#008f7b"
180591789,helissi,7,0,1,1,0.408628,0.351274,0,"#ffb800"
180643398,cdelarosa77,37,0,1,1,0.451696,0.217099,0,"#006032"
180656998,daniluna143,49,1,0,1,0.377634,0.696701,0,"#ff7007"
180782707,bitiji,0,0,10,10,0.47616,0.503081,0.004377,"#8ecfec"
180789440,egarciapastor,22,0,2,2,0.504097,0.663497,0.000486,"#00e8b2"
180798348,laesel,13,0,4,4,0.583158,0.490775,0.001459,"#3bec00"
180810338,saritaal,22,9,2,11,0.543112,0.487431,0.004864,"#00e8b2"
181034940,sergiortizramz,49,1,0,1,0.373788,0.664455,0,"#ff7007"
181194005,devenirfantasma,3,0,2,2,0.454973,0.624515,0.000486,"#ffb3ff"
181246416,JFeNegro,42,6,2,8,0.660485,0.515317,0.003405,"#66e087"
181275446,grillopez,49,5,1,6,0.494227,0.504131,0.002432,"#ff7007"
181284454,tomasgna,13,22,0,22,0.617035,0.930054,0.010214,"#3bec00"
181299784,dianabravvo,22,0,1,1,0.62529,0.499364,0,"#00e8b2"
181313244,marcmontijano,14,0,1,1,0.46851,0.662657,0,"#00eeff"
181354522,ricardocipago,38,0,2,2,0.559749,0.324601,0.000486,"#662859"
181381724,sof14g1l,7,0,2,2,0.405332,0.339914,0.000486,"#ffb800"
181404555,khetiwe24,13,0,2,2,0.391851,0.466425,0.000486,"#3bec00"
181572363,ERLYZETHF,13,0,1,1,0.433779,0.399174,0,"#3bec00"
181581081,carmenbit,14,0,1,1,0.562257,0.581392,0,"#00eeff"
181681337,danieldeaza,37,0,1,1,0.641937,0.379809,0,"#006032"
181682887,carlosfloresdie,8,0,1,1,0.345638,0.514088,0,"#00ed5d"
181810818,atobonb,37,0,3,3,0.566262,0.378111,0.000973,"#006032"
181973595,TextualScholar,14,1,23,24,0.486405,0.50199,0.011187,"#00eeff"
182055772,NUILOS,34,0,8,8,0.538618,0.420144,0.003405,"#ff0d69"
182105599,camicasi81,13,0,2,2,0.517145,0.45397,0.000486,"#3bec00"
182132760,losfilologos,22,1,0,1,0.50019,0.667414,0,"#00e8b2"
182136328,marc_sogues,14,0,4,4,0.51949,0.568303,0.001459,"#00eeff"
182364708,palomarranz,3,0,2,2,0.448879,0.56493,0.000486,"#ffb3ff"
182470010,JMonrroee,13,0,2,2,0.572864,0.390269,0.000486,"#3bec00"
182489241,hcasarin,36,0,1,1,0.525115,0.298797,0,"#825403"
182493103,ai_rivera,13,3,5,8,0.458558,0.374498,0.003405,"#3bec00"
182506391,abtrejot,13,0,1,1,0.396393,0.410047,0,"#3bec00"
182573469,lolaescreva,25,4,4,8,0.575612,0.111684,0.003405,"#f4a2ff"
182670078,andfel05,38,0,1,1,0.630349,0.361464,0,"#662859"
182718535,Deep_AG,49,1,0,1,0.333821,0.677837,0,"#ff7007"
182719517,gabherlu,4,0,1,1,0.852088,0.231231,0,"#f4c8cf"
182750372,RubenDOB,38,0,1,1,0.093332,0.426644,0,"#662859"
182825638,mamenarsenio,38,0,1,1,0.725872,0.589191,0,"#662859"
182828431,claudiamacip,30,1,2,3,0.352065,0.559099,0.000973,"#ff77ff"
182925466,FilmusDaniel,49,1,0,1,0.318196,0.600441,0,"#ff7007"
182928017,IIBI_UNAM_MX,7,11,6,17,0.424808,0.454659,0.007782,"#ffb800"
182932778,Corpoeducacion,38,5,1,6,0.580228,0.445726,0.002432,"#662859"
182976910,RAYDERGRANADA,31,0,3,3,0.619049,0.559072,0.000973,"#3e93ff"
183055078,pabloboiton,49,1,0,1,0.323452,0.605431,0,"#ff7007"
183099929,Utadeo_edu_co,38,15,0,15,0.539812,0.452013,0.006809,"#662859"
183117973,LuxAndLan,38,0,1,1,0.352527,0.177784,0,"#662859"
183121251,ElGallinazo,49,1,0,1,0.340814,0.693945,0,"#ff7007"
183183245,telefonica_ed,0,8,1,9,0.338803,0.511179,0.003891,"#8ecfec"
183242632,Monica_Benitez,38,0,1,1,0.434572,0.786671,0,"#662859"
183246423,FundacionItauAr,15,0,1,1,0.644944,0.530605,0,"#008ebb"
183262773,albercordoba,0,0,2,2,0.314033,0.578792,0.000486,"#8ecfec"
183298349,argaby2010,3,0,1,1,0.467209,0.767171,0,"#ffb3ff"
183412337,mario_ramon,21,0,1,1,0.038612,0.660421,0,"#c6cc85"
183420811,danillero,22,5,0,5,0.577859,0.604714,0.001946,"#00e8b2"
183461405,paiva_e,21,0,1,1,0.475216,0.954697,0,"#c6cc85"
183540750,Jberenike,14,0,5,5,0.485935,0.499442,0.001946,"#00eeff"
183586438,Amroman1,49,49,14,63,0.454857,0.65097,0.030156,"#ff7007"
183633494,andresgs77,22,0,1,1,0.578046,0.73606,0,"#00e8b2"
183648139,afirestarting,0,0,1,1,0.3883,0.561202,0,"#8ecfec"
183674248,unlp,49,3,0,3,0.420145,0.571409,0.000973,"#ff7007"
183706945,BibECOCFCH,36,0,7,7,0.510819,0.350277,0.002918,"#825403"
183823692,MarioRamosM,21,0,1,1,0.310882,0.437808,0,"#c6cc85"
183969483,Biblioteca_UNED,30,64,17,81,0.539442,0.546275,0.038911,"#ff77ff"
183988375,Mario_Colleoni,7,7,4,11,0.625315,0.561359,0.004864,"#ffb800"
184028646,carolAlvarezMo,31,0,2,2,0.569818,0.590336,0.000486,"#3e93ff"
184115785,jeovalle,38,0,1,1,0.599247,0.360006,0,"#662859"
184122307,jlhs86,14,0,2,2,0.595775,0.516066,0.000486,"#00eeff"
184132496,ChMutuverria,31,0,1,1,0.770468,0.913486,0,"#3e93ff"
184170370,lusr20,21,0,2,2,0.248323,0.226682,0.000486,"#c6cc85"
184186590,ALCASABAL,49,0,4,4,0.454785,0.578205,0.001459,"#ff7007"
184192133,SaraMolinaPT,14,1,1,2,0.790589,0.515138,0.000486,"#00eeff"
184290612,oropa9,7,0,6,6,0.559477,0.475383,0.002432,"#ffb800"
184319223,rleoncaraveo,7,0,1,1,0.406477,0.311329,0,"#ffb800"
184481251,LoreCastilloR,13,0,1,1,0.402016,0.469769,0,"#3bec00"
184563620,kmapesy,13,0,10,10,0.490598,0.48026,0.004377,"#3bec00"
184587889,lauramarcoccia,37,0,2,2,0.55842,0.502692,0.000486,"#006032"
184725768,Christiaanzr,30,0,1,1,0.548241,0.457927,0,"#ff77ff"
184772764,sbsociologia,36,1,0,1,0.536682,0.315042,0,"#825403"
184778484,NTARTE,49,2,0,2,0.410338,0.567016,0.000486,"#ff7007"
184810137,DrBicentenario,49,4,0,4,0.435413,0.602627,0.001459,"#ff7007"
184835744,Ed_Aldarull,49,1,0,1,0.35818,0.60081,0,"#ff7007"
184867925,pauhortal,49,1,0,1,0.321165,0.664299,0,"#ff7007"
184907381,AMLTaylor66,36,0,1,1,0.416893,0.580547,0,"#825403"
184917701,popaylove,30,0,7,7,0.460301,0.537084,0.002918,"#ff77ff"
184937619,UERNoficial,36,1,1,2,0.467085,0.330573,0.000486,"#825403"
184949908,mardoj,7,0,2,2,0.41259,0.401006,0.000486,"#ffb800"
185067423,AdrianAceGal,13,0,1,1,0.536583,0.238988,0,"#3bec00"
185166944,jmalvpal,0,3,0,3,0.295877,0.666465,0.000973,"#8ecfec"
185267188,cbchileag,13,8,0,8,0.445162,0.472887,0.003405,"#3bec00"
185289290,pacotartera,19,2,1,3,0.472433,0.544752,0.000973,"#00d3ff"
185293144,andrews_cath,34,0,4,4,0.517105,0.390292,0.001459,"#ff0d69"
185315989,Cavelibro,22,0,1,1,0.502828,0.745379,0,"#00e8b2"
185388824,GalataLudovisi,49,1,0,1,0.266261,0.543956,0,"#ff7007"
185389270,do_paulo,36,7,10,17,0.519641,0.396044,0.007782,"#825403"
185404382,glekaroz,22,0,3,3,0.559058,0.613559,0.000973,"#00e8b2"
185481868,SandyVizcaino,7,0,1,1,0.371892,0.357173,0,"#ffb800"
185567052,LIBEReurope,49,8,0,8,0.471348,0.535,0.003405,"#ff7007"
185574057,AlberWine,38,0,1,1,0.823798,0.641477,0,"#662859"
185685880,lizcar1411,58,0,2,2,0.630652,0.305813,0.000486,"#005076"
185686521,el_avecilla,21,0,1,1,0.226,0.222603,0,"#c6cc85"
185691744,ZJekely,34,0,2,2,0.377791,0.51236,0.000486,"#ff0d69"
185718824,mafolini,49,0,2,2,0.472079,0.716768,0.000486,"#ff7007"
185736211,ASLE_US,34,0,2,2,0.356531,0.407782,0.000486,"#ff0d69"
185795418,spainelong,19,0,2,2,0.617129,0.625182,0.000486,"#00d3ff"
185798667,jusicape,38,1,0,1,0.16024,0.578419,0,"#662859"
185895357,StephGarces,38,0,9,9,0.529974,0.480097,0.003891,"#662859"
185994261,itc_consultoria,49,1,0,1,0.376301,0.617741,0,"#ff7007"
186127509,unanamas,13,1,0,1,0.392534,0.405735,0,"#3bec00"
186128383,seguicollar,22,0,1,1,0.588504,0.689133,0,"#00e8b2"
186149907,Wences91,31,0,5,5,0.596308,0.521964,0.001946,"#3e93ff"
186181509,mpuntompunto,1,0,1,1,0.356996,0.746557,0,"#b6cb00"
186206937,PeM_WoW,49,1,0,1,0.364219,0.663254,0,"#ff7007"
186223142,hernandolopera,49,7,35,42,0.464533,0.539658,0.019942,"#ff7007"
186316708,QuixoticSamio,13,1,0,1,0.459466,0.400015,0,"#3bec00"
186363970,Gustavo_ValdezV,49,1,0,1,0.29609,0.645501,0,"#ff7007"
186378357,desemboltura,34,0,15,15,0.472949,0.465952,0.006809,"#ff0d69"
186388523,yolainedel,49,1,0,1,0.345235,0.609125,0,"#ff7007"
186421171,elportalvoz,30,0,1,1,0.593362,0.681591,0,"#ff77ff"
186491749,Nugadel,36,0,1,1,0.392857,0.475476,0,"#825403"
186532056,ShanddIT,49,0,1,1,0.438911,0.632923,0,"#ff7007"
186602504,campusponfe,37,1,0,1,0.536744,0.759382,0,"#006032"
186655002,zzamikk,37,0,1,1,0.373938,0.321638,0,"#006032"
186677887,AlejoGustavo,49,1,0,1,0.325538,0.669822,0,"#ff7007"
186708669,johanes27,3,0,1,1,0.4535,0.754657,0,"#ffb3ff"
186902910,nathsparkles,38,0,1,1,0.132476,0.794655,0,"#662859"
186915742,glogaralv,22,1,1,2,0.594953,0.634697,0.000486,"#00e8b2"
186916774,jascarza,30,2,0,2,0.554479,0.664505,0.000486,"#ff77ff"
187536322,JMMAYA,3,0,3,3,0.483895,0.604731,0.000973,"#ffb3ff"
187576790,Raul_MirandaG,4,0,1,1,0.498471,0.371686,0,"#f4c8cf"
187611001,mireiallop,2,1,1,2,0.661229,0.661063,0.000486,"#ffa64e"
187673118,Seth_Kane,7,0,1,1,0.52086,0.19309,0,"#ffb800"
187716389,EJorgeGlez,49,1,0,1,0.36057,0.679477,0,"#ff7007"
187829001,Leticiatilla,30,0,1,1,0.514231,0.652571,0,"#ff77ff"
187833916,stukeil,6,0,1,1,0.332282,0.745862,0,"#a67800"
187839836,pilaralberdi,30,0,1,1,0.618775,0.609647,0,"#ff77ff"
187873235,Merce_G,8,1,14,15,0.62259,0.384564,0.006809,"#00ed5d"
187956731,sirczar,34,0,2,2,0.474713,0.382605,0.000486,"#ff0d69"
187966054,alejandromx_11,13,0,5,5,0.466599,0.368694,0.001946,"#3bec00"
187970148,samedellin,7,0,2,2,0.428477,0.362794,0.000486,"#ffb800"
187975629,balkdhakal,36,0,2,2,0.540481,0.435901,0.000486,"#825403"
188008937,RevistaALCANCE,30,3,0,3,0.566148,0.531965,0.000973,"#ff77ff"
188083419,maubarrerapaz,13,0,3,3,0.506289,0.424433,0.000973,"#3bec00"
188090910,Empleosnet,49,1,0,1,0.338268,0.611227,0,"#ff7007"
188352426,martarimoldi,49,1,0,1,0.360551,0.687877,0,"#ff7007"
188354693,RRCarracedo,49,1,0,1,0.380127,0.700304,0,"#ff7007"
188368516,FBAUAQ,13,1,0,1,0.364464,0.489807,0,"#3bec00"
188405911,egiordanino,49,16,37,53,0.487287,0.548937,0.025292,"#ff7007"
188487114,MBA_AEconomia,49,1,0,1,0.362837,0.615523,0,"#ff7007"
188500621,ScholCommons,34,0,4,4,0.462217,0.449277,0.001459,"#ff0d69"
188555221,tibu774,3,0,1,1,0.687659,0.705752,0,"#ffb3ff"
188653902,raulolivan,22,12,0,12,0.600157,0.558978,0.00535,"#00e8b2"
188672931,carlacolombati,30,1,13,14,0.463156,0.540208,0.006323,"#ff77ff"
188725330,UniBarcelona,22,24,0,24,0.595755,0.549736,0.011187,"#00e8b2"
188992557,FerreiraLuisi,55,0,5,5,0.662688,0.665592,0.001946,"#cb3f32"
189140231,JRuizPalmero,2,0,1,1,0.643838,0.665647,0,"#ffa64e"
189189288,PartidoLiberal,9,0,2,2,0.679414,0.917075,0.000486,"#008f7b"
189205929,darissd,7,0,3,3,0.431302,0.356057,0.000973,"#ffb800"
189227166,GuillouGrande,49,0,3,3,0.480832,0.532302,0.000973,"#ff7007"
189228741,MineriaUNAM,7,0,1,1,0.627955,0.380255,0,"#ffb800"
189243764,analivi4,36,0,2,2,0.502443,0.300525,0.000486,"#825403"
189250817,lxdymxdnight,13,0,1,1,0.316845,0.464464,0,"#3bec00"
189266930,t_applicada,31,1,3,4,0.588556,0.547599,0.001459,"#3e93ff"
189275284,YoSoyNarrador,38,0,1,1,0.172551,0.427582,0,"#662859"
189276553,manuelm_mx,35,12,10,22,0.439714,0.522768,0.010214,"#00faff"
189287736,PRMVOZYDATOS,49,0,1,1,0.424286,0.62319,0,"#ff7007"
189436824,ferlopezuru,49,1,0,1,0.414067,0.648323,0,"#ff7007"
189459363,gallarj,49,1,0,1,0.317788,0.659173,0,"#ff7007"
189538421,bonaparte123,58,0,2,2,0.60237,0.305028,0.000486,"#005076"
189589994,neoacevedo,38,0,2,2,0.568474,0.392586,0.000486,"#662859"
189591814,alfredo_landman,7,0,1,1,0.505343,0.697361,0,"#ffb800"
189593425,Dpquinaya,34,0,1,1,0.528532,0.344406,0,"#ff0d69"
189632219,JulioAAV,5,0,1,1,0.628017,0.2969,0,"#b2dd44"
189638704,MariaPautassi,38,1,1,2,0.556364,0.475791,0.000486,"#662859"
189639484,Mauas1,0,0,2,2,0.516991,0.425301,0.000486,"#8ecfec"
189664003,roserbenavides,14,0,5,5,0.609822,0.526405,0.001946,"#00eeff"
189672854,MernySam,49,0,1,1,0.5067,0.358796,0,"#ff7007"
189682672,cgeuprrp,23,1,0,1,0.183526,0.501873,0,"#005455"
189697896,Neutinho_Edw,38,0,2,2,0.55494,0.389232,0.000486,"#662859"
189784127,bajadetunube,0,0,2,2,0.43995,0.393562,0.000486,"#8ecfec"
189834523,I_love_mornings,1,0,3,3,0.462163,0.700754,0.000973,"#b6cb00"
189920568,eduardo_anglada,30,1,0,1,0.54236,0.619588,0,"#ff77ff"
189928602,agsb_bilbao,3,2,3,5,0.530516,0.641104,0.001946,"#ffb3ff"
189960037,rafaelmdenis,49,1,0,1,0.306904,0.646142,0,"#ff7007"
189963437,rulesoff,13,1,0,1,0.487115,0.397194,0,"#3bec00"
190065979,inti_oscar,3,0,1,1,0.599856,0.7156,0,"#ffb3ff"
190163505,PatoWarheart,13,0,1,1,0.392612,0.401719,0,"#3bec00"
190197157,bbbcccnnn,3,0,1,1,0.69227,0.698809,0,"#ffb3ff"
190202376,mpiEscobar,34,1,3,4,0.489668,0.496944,0.001459,"#ff0d69"
190306004,digdialog,34,1,0,1,0.49254,0.331205,0,"#ff0d69"
190327580,Confilegal,49,1,0,1,0.335329,0.608636,0,"#ff7007"
190336857,devhrmx,0,10,6,16,0.336667,0.506615,0.007296,"#8ecfec"
190407352,vicesalles,14,0,1,1,0.69398,0.52431,0,"#00eeff"
190408401,femifemi09,22,0,3,3,0.467433,0.557113,0.000973,"#00e8b2"
190461974,acaestatodomal,34,0,1,1,0.375886,0.471854,0,"#ff0d69"
190585036,FundEuroArabe,31,0,1,1,0.6579,0.537989,0,"#3e93ff"
190585662,Mastermas,1,2,0,2,0.472644,0.558889,0.000486,"#b6cb00"
190648769,icaruseu,19,1,0,1,0.632147,0.645476,0,"#00d3ff"
190649527,FdaoMontoya,40,0,1,1,0.644282,0.00728,0,"#ff12a3"
190708746,mutantes2021,49,0,3,3,0.574354,0.587844,0.000973,"#ff7007"
190710940,FunTresCulturas,22,0,1,1,0.555884,0.686976,0,"#00e8b2"
190736341,paocorreag,38,0,1,1,0.265182,0.618157,0,"#662859"
190749432,RadioUBA,49,2,0,2,0.368858,0.565424,0.000486,"#ff7007"
190783515,HD,1,11,0,11,0.502328,0.542546,0.004864,"#b6cb00"
190844964,gansoypulpo,13,0,2,2,0.52318,0.477692,0.000486,"#3bec00"
190859914,ateneoruiz,7,0,2,2,0.433249,0.361006,0.000486,"#ffb800"
190880908,maxejara,21,0,2,2,0.193901,0.251056,0.000486,"#c6cc85"
190886946,profwernimont,34,0,13,13,0.42246,0.468272,0.005837,"#ff0d69"
190955810,CGBinformatica,49,1,0,1,0.317687,0.604717,0,"#ff7007"
190973109,iroser_RSE,22,0,3,3,0.642643,0.537247,0.000973,"#00e8b2"
190995776,joselupalacios,30,0,4,4,0.49117,0.542381,0.001459,"#ff77ff"
191127871,PepeOrtizPSOE,49,2,0,2,0.39154,0.573716,0.000486,"#ff7007"
191128381,noel123_30,17,0,1,1,0.811852,0.239176,0,"#ff9cc7"
191143493,CSIC,22,47,0,47,0.539204,0.597558,0.022374,"#00e8b2"
191211271,Amilcaracol,13,0,1,1,0.420323,0.402865,0,"#3bec00"
191225303,djangoproject,34,1,0,1,0.486545,0.377169,0,"#ff0d69"
191268920,Radio_par,38,1,1,2,0.384123,0.343788,0.000486,"#662859"
191271819,dellmrojas,37,0,1,1,0.182996,0.480142,0,"#006032"
191279165,LorenitaCofre,21,0,1,1,0.235149,0.215696,0,"#c6cc85"
191373174,marblacar,30,0,1,1,0.526842,0.624259,0,"#ff77ff"
191470544,ffyh_unc,30,4,0,4,0.452556,0.621308,0.001459,"#ff77ff"
191479929,LoriteFonta,0,1,7,8,0.512846,0.546247,0.003405,"#8ecfec"
191547334,untaltico_,34,0,1,1,0.554321,0.339389,0,"#ff0d69"
191606021,kol_t,34,0,1,1,0.470689,0.381694,0,"#ff0d69"
191682958,VSssasas,50,0,1,1,0.546101,0.013053,0,"#ff76c3"
191692150,alemoreamdp,49,0,3,3,0.522481,0.443024,0.000973,"#ff7007"
191906357,albamirando,7,0,1,1,0.621535,0.377337,0,"#ffb800"
191923719,rociomarvel,14,0,1,1,0.677688,0.640172,0,"#00eeff"
192059223,haprendiz,17,0,1,1,0.720127,0.814189,0,"#ff9cc7"
192077546,revistaluthor,49,14,2,16,0.354863,0.576321,0.007296,"#ff7007"
192089676,IGeografiaUNAM,7,1,2,3,0.507734,0.356709,0.000973,"#ffb800"
192128469,TeresaIribarren,30,1,2,3,0.46744,0.538595,0.000973,"#ff77ff"
192142654,Ignasiara,8,1,0,1,0.659075,0.246536,0,"#00ed5d"
192208402,rzarCR,3,0,1,1,0.458219,0.667432,0,"#ffb3ff"
192231998,AcidMartini,38,0,1,1,0.288288,0.174331,0,"#662859"
192268644,ALoreli,31,2,12,14,0.568525,0.526845,0.006323,"#3e93ff"
192291219,santisaborido,22,0,2,2,0.650558,0.61407,0.000486,"#00e8b2"
192294809,udominho,55,3,0,3,0.622139,0.412794,0.000973,"#cb3f32"
192411472,bibliotecasUNAM,13,0,6,6,0.431404,0.445,0.002432,"#3bec00"
192423207,moyholz,21,0,2,2,0.210928,0.257453,0.000486,"#c6cc85"
192560971,deiselacerda,36,0,1,1,0.482733,0.204746,0,"#825403"
192583570,LuisGMarcoC,49,0,1,1,0.240572,0.667176,0,"#ff7007"
192617812,azel79,36,0,2,2,0.44329,0.349094,0.000486,"#825403"
192631079,AlmudiOrg,49,1,0,1,0.426922,0.666912,0,"#ff7007"
192771739,futsanti,19,0,2,2,0.537744,0.451724,0.000486,"#00d3ff"
192811471,I3Aunizar,37,1,3,4,0.468049,0.681239,0.001459,"#006032"
192858272,BUSCUSC,30,7,11,18,0.493987,0.554616,0.008268,"#ff77ff"
192970359,Asetrad_ORG,15,0,1,1,0.541391,0.672469,0,"#008ebb"
192981712,AgEInves,30,6,0,6,0.493553,0.554548,0.002432,"#ff77ff"
193015382,suayedEconomia,13,0,1,1,0.560623,0.437859,0,"#3bec00"
193066262,robertocuadros1,1,3,6,9,0.476725,0.589223,0.003891,"#b6cb00"
193096110,rubengluengas,17,1,0,1,0.739727,0.19087,0,"#ff9cc7"
193206912,MontseOlive,31,0,4,4,0.579015,0.499945,0.001459,"#3e93ff"
193209505,OTRIUMA,14,0,2,2,0.643423,0.530616,0.000486,"#00eeff"
193221975,CMontcusi,13,0,4,4,0.518849,0.51556,0.001459,"#3bec00"
193319014,azcaKPB,22,0,1,1,0.382132,0.600673,0,"#00e8b2"
193394066,WCpato,13,0,1,1,0.403023,0.498416,0,"#3bec00"
193438091,mfornazin,36,2,0,2,0.463001,0.303175,0.000486,"#825403"
193473814,rebeccaonion,22,2,0,2,0.599522,0.583488,0.000486,"#00e8b2"
193507616,franrangelpre,30,0,1,1,0.618046,0.668649,0,"#ff77ff"
193533203,CentroMemoriaH,38,1,0,1,0.550748,0.365375,0,"#662859"
193533732,nayaroldan,13,6,2,8,0.444155,0.385286,0.003405,"#3bec00"
193654613,rcondemelguizo,22,0,3,3,0.51233,0.550092,0.000973,"#00e8b2"
193824005,aplp441,22,0,1,1,0.568507,0.843271,0,"#00e8b2"
193851497,JuanMGrana,34,0,1,1,0.416417,0.350128,0,"#ff0d69"
193908521,IGNSpain,22,1,0,1,0.587853,0.62775,0,"#00e8b2"
194023070,adomingom,49,1,0,1,0.390818,0.643919,0,"#ff7007"
194043970,elemontiel,22,6,8,14,0.552271,0.639341,0.006323,"#00e8b2"
194047322,jor_gracia,22,35,5,40,0.54717,0.654619,0.018969,"#00e8b2"
194062950,DialogoEsFr,37,1,1,2,0.672684,0.621169,0.000486,"#006032"
194192905,dedisparates,13,0,1,1,0.471171,0.39407,0,"#3bec00"
194203770,cfiesler,34,0,1,1,0.339625,0.395978,0,"#ff0d69"
194297768,_lezti_,34,0,26,26,0.497774,0.485023,0.01216,"#ff0d69"
194381848,JuanCavallero,49,2,0,2,0.369258,0.58368,0.000486,"#ff7007"
194443014,toribiorafael,31,0,2,2,0.621587,0.535801,0.000486,"#3e93ff"
194457533,UairaAty,49,1,0,1,0.343235,0.646022,0,"#ff7007"
194490531,Mariapozoes,30,0,1,1,0.50919,0.61976,0,"#ff77ff"
194491204,IAPHorienta,1,0,1,1,0.362786,0.556838,0,"#b6cb00"
194613511,bpherrero,30,0,1,1,0.267139,0.636198,0,"#ff77ff"
194621117,paucorsita,38,0,3,3,0.626052,0.390903,0.000973,"#662859"
194715814,Alorenzo1957,19,1,6,7,0.630857,0.757786,0.002918,"#00d3ff"
194816579,JimmyBoatV,30,0,3,3,0.562932,0.585689,0.000973,"#ff77ff"
194820145,un_bogota,38,6,0,6,0.495636,0.388848,0.002432,"#662859"
194831035,MinduimYDicas,48,0,2,2,0.358566,0.538304,0.000486,"#ff7a78"
194866747,ladyjohannagd,38,0,1,1,0.604577,0.369142,0,"#662859"
195012421,gv2024,30,0,2,2,0.543054,0.526619,0.000486,"#ff77ff"
195020129,Ellem_y,36,0,1,1,0.489468,0.179729,0,"#825403"
195045190,anticuaeguiara,34,0,2,2,0.510559,0.414698,0.000486,"#ff0d69"
195100950,articaonline,55,37,4,41,0.581637,0.5353,0.019455,"#cb3f32"
195150298,UNAMdigital,7,40,1,41,0.522565,0.448014,0.019455,"#ffb800"
195208586,CaroMendivilV,17,0,1,1,0.810682,0.218744,0,"#ff9cc7"
195232797,heliconide,13,0,2,2,0.369285,0.254205,0.000486,"#3bec00"
195285601,casaDcanarias,30,1,0,1,0.546778,0.621753,0,"#ff77ff"
195341223,doloresbonilla,14,0,1,1,0.662346,0.492192,0,"#00eeff"
195359126,VicenteBenitezG,10,8,2,10,0.291728,0.476907,0.004377,"#52d7c0"
195542822,moisesgallo,21,0,2,2,0.298379,0.455766,0.000486,"#c6cc85"
195581880,Vallemm,38,0,1,1,0.578008,0.276628,0,"#662859"
195727892,EmmanuelTaub,49,0,1,1,0.282332,0.589259,0,"#ff7007"
195769785,Sevig14,49,1,0,1,0.409162,0.636613,0,"#ff7007"
195775320,ADELAMX20,13,0,1,1,0.359381,0.260058,0,"#3bec00"
195777936,CEUPO,1,0,2,2,0.522926,0.615551,0.000486,"#b6cb00"
195784565,vocausp,30,0,2,2,0.534723,0.568337,0.000486,"#ff77ff"
195811909,HumanidadesTO,15,71,14,85,0.555664,0.575479,0.040856,"#008ebb"
195820318,GobiernoBTA,38,3,0,3,0.506859,0.391154,0.000973,"#662859"
195824521,DaveParedes,13,0,2,2,0.381862,0.391226,0.000486,"#3bec00"
195863904,daniperrotta,49,1,0,1,0.375531,0.647922,0,"#ff7007"
195886878,RicciuP,38,0,1,1,0.13548,0.819149,0,"#662859"
195933066,DeniseMaerker,0,2,0,2,0.280239,0.56348,0.000486,"#8ecfec"
196015866,MCHedgehog_,13,17,15,32,0.436937,0.441085,0.015078,"#3bec00"
196084078,luduschironis,22,0,2,2,0.552387,0.635736,0.000486,"#00e8b2"
196124212,alfredocorell,30,2,2,4,0.456847,0.553185,0.001459,"#ff77ff"
196147311,FerrarelliM,22,1,4,5,0.516858,0.599506,0.001946,"#00e8b2"
196178283,ram6macedo,7,0,4,4,0.494701,0.430351,0.001459,"#ffb800"
196229662,mopoza,30,2,8,10,0.504474,0.525017,0.004377,"#ff77ff"
196236616,bjpalmab,13,2,0,2,0.377086,0.411803,0.000486,"#3bec00"
196370266,reguillorarias,3,0,2,2,0.290961,0.565677,0.000486,"#ffb3ff"
196384173,INAHmx,13,16,4,20,0.474115,0.42173,0.009241,"#3bec00"
196386485,Tatalito100,22,0,2,2,0.647765,0.431436,0.000486,"#00e8b2"
196411320,antimony27,36,1,1,2,0.459575,0.39614,0.000486,"#825403"
196581588,tuciudaderestu,0,0,1,1,0.371489,0.544351,0,"#8ecfec"
196592462,GrupoAtisa,49,1,0,1,0.37254,0.62413,0,"#ff7007"
196641462,VanessaRosales_,37,2,0,2,0.579663,0.410885,0.000486,"#006032"
196723491,librewotan,37,0,1,1,0.458211,0.312215,0,"#006032"
196735628,FsieAndalucia,49,1,0,1,0.417859,0.68294,0,"#ff7007"
196736700,marinebonheur,58,0,2,2,0.639591,0.395469,0.000486,"#005076"
196783287,paulodrinot,38,1,2,3,0.515506,0.415989,0.000973,"#662859"
196799472,lindsaycthomas,49,2,0,2,0.429858,0.515433,0.000486,"#ff7007"
196959345,redeszone,49,2,0,2,0.443127,0.680882,0.000486,"#ff7007"
197026804,granadaenlared,31,5,0,5,0.614734,0.500381,0.001946,"#3e93ff"
197053957,milenanelim24,49,0,3,3,0.480381,0.415863,0.000973,"#ff7007"
197073104,cortizleon,20,2,0,2,0.434634,0.212777,0.000486,"#f0be45"
197095948,cepal_onu,13,1,0,1,0.52394,0.392248,0,"#3bec00"
197106427,fcomarquezv,31,0,1,1,0.632979,0.50971,0,"#3e93ff"
197142161,GenteConCiencia,7,1,2,3,0.453962,0.362416,0.000973,"#ffb800"
197199146,Lineamadrid,58,69,1,70,0.5708,0.250323,0.03356,"#005076"
197319897,j_p_martinez,49,1,0,1,0.319749,0.620962,0,"#ff7007"
197360202,FcodelPozo,24,0,1,1,0.155764,0.626648,0,"#ff9b8f"
197361814,ikokis,22,0,1,1,0.297586,0.664132,0,"#00e8b2"
197404705,ainiatecnologia,30,1,2,3,0.704879,0.61189,0.000973,"#ff77ff"
197421736,GiovaManrique,36,0,2,2,0.320221,0.338088,0.000486,"#825403"
197426625,alexpachecov,17,0,1,1,0.920324,0.381488,0,"#ff9cc7"
197499949,vlorarodriguez,22,0,1,1,0.671915,0.644595,0,"#00e8b2"
197544838,ali_tbl,49,1,0,1,0.396488,0.671393,0,"#ff7007"
197561927,pressbooks,31,1,0,1,0.65165,0.584597,0,"#3e93ff"
197601400,evemuseografia,42,4,0,4,0.566466,0.600314,0.001459,"#66e087"
197607452,MasCienciaChile,49,0,2,2,0.337563,0.444275,0.000486,"#ff7007"
197858668,HumanistasUCV,55,1,0,1,0.62037,0.426116,0,"#cb3f32"
197868423,jojokarlin,34,5,7,12,0.478548,0.4126,0.00535,"#ff0d69"
197870193,IvanKalderon,10,0,2,2,0.303549,0.473073,0.000486,"#52d7c0"
197876876,analogcaro,38,0,1,1,0.111989,0.819019,0,"#662859"
197905079,_Luu_Rodrigues,36,0,2,2,0.546832,0.433998,0.000486,"#825403"
197969638,brunossgodinho,36,1,0,1,0.517096,0.228392,0,"#825403"
198002325,etelfernandez,37,0,3,3,0.319983,0.501799,0.000973,"#006032"
198124987,roixepe,40,0,1,1,0.582469,0.014479,0,"#ff12a3"
198279542,iPolitologa,34,0,1,1,0.532162,0.381134,0,"#ff0d69"
198299705,FernandoHS61,19,1,0,1,0.631597,0.786525,0,"#00d3ff"
198339035,marcelaraffo,14,0,1,1,0.686474,0.557863,0,"#00eeff"
198379704,UnodelDuo,30,0,1,1,0.573756,0.544841,0,"#ff77ff"
198395033,HannuPris,37,0,1,1,0.636154,0.214535,0,"#006032"
198442204,dactilosedicion,0,3,3,6,0.445673,0.56803,0.002432,"#8ecfec"
198530615,Foro_Int,7,0,2,2,0.435789,0.359758,0.000486,"#ffb800"
198534810,Gemmadelcorral,14,0,2,2,0.669392,0.563652,0.000486,"#00eeff"
198540232,urnadecristal,38,2,1,3,0.618262,0.439108,0.000973,"#662859"
198570024,luismiyou,14,0,6,6,0.57041,0.558772,0.002432,"#00eeff"
198596112,segundopiriz,31,0,1,1,0.576656,0.618455,0,"#3e93ff"
198599663,juliuslaetus,13,0,1,1,0.535244,0.461747,0,"#3bec00"
198775720,norias69,31,0,1,1,0.714605,0.519019,0,"#3e93ff"
198795345,patrimrodilla,14,6,27,33,0.530131,0.519874,0.015564,"#00eeff"
198803317,FundacionISD,22,15,6,21,0.465903,0.513193,0.009728,"#00e8b2"
198829810,elperiodico,49,3,0,3,0.512594,0.58716,0.000973,"#ff7007"
198858266,julioabalde,30,0,1,1,0.886238,0.544549,0,"#ff77ff"
198886440,diegocitterio,49,0,3,3,0.454856,0.498643,0.000973,"#ff7007"
198887843,LaUASLP,34,11,3,14,0.475966,0.433624,0.006323,"#ff0d69"
198926150,CIIDET,34,11,1,12,0.547645,0.400229,0.00535,"#ff0d69"
198941912,CEDUAcolmex,7,1,2,3,0.432352,0.418561,0.000973,"#ffb800"
198974329,0ne_Car_Lost,30,0,1,1,0.466827,0.623094,0,"#ff77ff"
199182471,cerlope,30,4,1,5,0.535933,0.549081,0.001946,"#ff77ff"
199192115,nachrichtenlos,13,0,1,1,0.422219,0.429986,0,"#3bec00"
199301576,ixtli_unam,2,0,1,1,0.67418,0.67421,0,"#ffa64e"
199418641,MBZepedaCortes,14,0,1,1,0.64968,0.587591,0,"#00eeff"
199419691,aerRuiz,13,1,0,1,0.41851,0.466722,0,"#3bec00"
199428336,Clocchiatti,30,0,1,1,0.68704,0.626089,0,"#ff77ff"
199499966,Dreamer_T_T_,30,0,1,1,0.3611,0.43827,0,"#ff77ff"
199667065,eme_aguilar,49,0,3,3,0.325281,0.532859,0.000973,"#ff7007"
199792190,JorgeBabul,21,0,2,2,0.420852,0.486368,0.000486,"#c6cc85"
200060881,fernium_,22,0,1,1,0.599816,0.612764,0,"#00e8b2"
200118321,marafaele,22,0,3,3,0.592588,0.580741,0.000973,"#00e8b2"
200194129,XAlberte,0,0,1,1,0.384703,0.553162,0,"#8ecfec"
200248584,PepadelToro,30,0,1,1,0.615542,0.669374,0,"#ff77ff"
200277193,davidirala,37,0,1,1,0.195225,0.467548,0,"#006032"
200326766,MaritheOru,37,0,4,4,0.297362,0.502993,0.001459,"#006032"
200326841,OMCovarrubias,7,1,2,3,0.762049,0.383332,0.000973,"#ffb800"
200489345,robemorales1,30,1,1,2,0.514714,0.614333,0.000486,"#ff77ff"
200496056,JotaTIC,35,3,1,4,0.370427,0.18626,0.001459,"#00faff"
200586417,NatiRojasA,37,0,2,2,0.546234,0.357064,0.000486,"#006032"
200596493,elblogdeabel,49,1,0,1,0.391569,0.654875,0,"#ff7007"
200648205,manufa1955,49,1,0,1,0.360346,0.615079,0,"#ff7007"
200720887,WauraRodriguez,3,0,1,1,0.488061,0.769044,0,"#ffb3ff"
200731864,laumonteroc,3,0,4,4,0.456476,0.556326,0.001459,"#ffb3ff"
200770882,elemmental_com,55,12,2,14,0.515108,0.543229,0.006323,"#cb3f32"
200775737,ITESM_MTY,13,3,0,3,0.487277,0.434822,0.000973,"#3bec00"
200776624,JuanPa_M_E,31,0,1,1,0.761856,0.911234,0,"#3e93ff"
200932969,JohnMAckerman,7,2,0,2,0.1718,0.475793,0.000486,"#ffb800"
200990392,InfoDocu,22,0,2,2,0.521819,0.647446,0.000486,"#00e8b2"
200990495,mokik777,21,0,1,1,0.017562,0.648449,0,"#c6cc85"
201062957,jorgelpolanco,49,0,1,1,0.539734,0.399716,0,"#ff7007"
201194283,my_value,49,1,0,1,0.34886,0.626827,0,"#ff7007"
201401166,Morenoemmiux,14,1,2,3,0.671065,0.529285,0.000973,"#00eeff"
201413739,Mangeles_HM,14,0,4,4,0.611715,0.534456,0.001459,"#00eeff"
201669360,MikeKerln,58,0,2,2,0.604173,0.291711,0.000486,"#005076"
201756211,macondolit,38,0,1,1,0.599187,0.33902,0,"#662859"
201767437,chiomaye,4,0,1,1,0.872756,0.229274,0,"#f4c8cf"
201905382,Fer_Manzanilla,49,1,0,1,0.336052,0.66629,0,"#ff7007"
201922749,castelan12,49,1,0,1,0.383854,0.65259,0,"#ff7007"
201935267,JAriza10,38,0,4,4,0.549278,0.455186,0.001459,"#662859"
202020898,nelsymariela,30,0,1,1,0.66531,0.832656,0,"#ff77ff"
202066854,jelenwalker,22,0,1,1,0.393071,0.6086,0,"#00e8b2"
202213454,hdanielgf,34,0,1,1,0.61275,0.315307,0,"#ff0d69"
202239137,marselykehoe,31,0,3,3,0.504038,0.50066,0.000973,"#3e93ff"
202321002,rdu_unam,7,56,0,56,0.582964,0.424652,0.026751,"#ffb800"
202324411,UnedHistoria,37,1,0,1,0.629716,0.343928,0,"#006032"
202358561,NahikariSanchez,1,0,2,2,0.649739,0.441486,0.000486,"#b6cb00"
202672144,BakerTillyCL,49,1,0,1,0.329088,0.599718,0,"#ff7007"
202674135,nica_1979,49,0,1,1,0.420112,0.776613,0,"#ff7007"
202679509,gracielamoscone,49,0,3,3,0.466664,0.513429,0.000973,"#ff7007"
202814952,Caquetias,13,0,2,2,0.424906,0.397765,0.000486,"#3bec00"
202906386,munecamarce,17,0,1,1,0.825353,0.252398,0,"#ff9cc7"
202917035,red_historia,22,0,1,1,0.587483,0.639463,0,"#00e8b2"
202923037,MarthaIGuzman,4,0,1,1,0.874943,0.222444,0,"#f4c8cf"
202983379,PM4Hind,49,0,1,1,0.354938,0.469428,0,"#ff7007"
203065249,bryamrr,49,1,0,1,0.408317,0.653555,0,"#ff7007"
203145015,Educacionbogota,31,1,0,1,0.715177,0.407652,0,"#3e93ff"
203223474,JorgeWaldorf,33,0,1,1,0.240782,0.623838,0,"#ff8c00"
203249148,Sourkeyty,21,0,1,1,0.181677,0.229698,0,"#c6cc85"
203249901,GuillermoSainz,2,0,2,2,0.667422,0.656853,0.000486,"#ffa64e"
203251244,zi0rTZA,0,0,1,1,0.429269,0.385611,0,"#8ecfec"
203262579,kaosenlarednet,19,0,2,2,0.643948,0.636934,0.000486,"#00d3ff"
203286598,Lourdesgm13,38,0,1,1,0.56982,0.707523,0,"#662859"
203377061,Chargeria,36,0,1,1,0.533053,0.332808,0,"#825403"
203552183,ELQUATRE,30,0,2,2,0.519982,0.604454,0.000486,"#ff77ff"
203667099,Merceolive,49,0,1,1,0.399396,0.791469,0,"#ff7007"
203703517,jagzarandona,30,2,2,4,0.384037,0.5132,0.001459,"#ff77ff"
203801327,Marirecamier,7,0,1,1,0.402904,0.356751,0,"#ffb800"
203822396,LaMetaphysique,19,0,2,2,0.616462,0.474833,0.000486,"#00d3ff"
203871179,demagdalena,49,1,0,1,0.336762,0.691035,0,"#ff7007"
203907786,epedagogo,7,0,2,2,0.428679,0.354765,0.000486,"#ffb800"
204071829,yasir_HS,13,0,4,4,0.470425,0.465344,0.001459,"#3bec00"
204100902,PapelesDeMusica,22,10,3,13,0.448794,0.629616,0.005837,"#00e8b2"
204159425,Maguztechit,14,0,2,2,0.449125,0.532609,0.000486,"#00eeff"
204232370,mrodriguezarn,22,1,12,13,0.559555,0.528485,0.005837,"#00e8b2"
204279080,ETH_en,14,1,0,1,0.593399,0.368525,0,"#00eeff"
204489333,FIAT_IFTA,1,2,0,2,0.444765,0.55633,0.000486,"#b6cb00"
204508249,FUNDEICaracas,30,0,1,1,0.556585,0.671645,0,"#ff77ff"
204594941,Magamella,21,0,2,2,0.209783,0.240866,0.000486,"#c6cc85"
204670349,IPEditorial,0,7,4,11,0.48877,0.54406,0.004864,"#8ecfec"
204739101,josepnieto,8,0,6,6,0.680687,0.272949,0.002432,"#00ed5d"
204819072,ConexionEX,38,1,0,1,0.665365,0.630908,0,"#662859"
204946934,Cuatroochenta,0,2,2,4,0.661296,0.625908,0.001459,"#8ecfec"
204950995,katrinanavickas,34,0,2,2,0.480375,0.409816,0.000486,"#ff0d69"
204976604,groovearq,31,0,2,2,0.645712,0.544196,0.000486,"#3e93ff"
205072549,adolfoabadia,13,0,1,1,0.41819,0.418635,0,"#3bec00"
205171538,UAM_Ediciones,35,1,0,1,0.713023,0.473254,0,"#00faff"
205195655,maxplanckpress,36,7,0,7,0.517963,0.40861,0.002918,"#825403"
205228772,susanapallares,31,0,1,1,0.705843,0.546823,0,"#3e93ff"
205283098,brigitnr,14,5,0,5,0.665148,0.522566,0.001946,"#00eeff"
205303906,tarafa9,22,0,1,1,0.583351,0.607806,0,"#00e8b2"
205504548,elisakaim,22,0,2,2,0.821333,0.300689,0.000486,"#00e8b2"
205512794,DeolhonaCI,36,2,1,3,0.597909,0.275949,0.000973,"#825403"
205533808,PerioSalud,37,0,1,1,0.445996,0.664954,0,"#006032"
205640203,TE_GranEmpresa,0,21,5,26,0.426527,0.574754,0.01216,"#8ecfec"
205893304,norber130955,9,0,1,1,0.732118,0.624021,0,"#008f7b"
205969899,edo_isc,21,0,3,3,0.347678,0.332018,0.000973,"#c6cc85"
206071774,fundacionucm,58,1,1,2,0.496043,0.482421,0.000486,"#005076"
206158727,AdelasherasL,19,6,0,6,0.627337,0.765545,0.002432,"#00d3ff"
206227440,YesseniaRamosA,20,0,1,1,0.39921,0.070051,0,"#f0be45"
206227481,nereidafonsecat,0,0,3,3,0.50053,0.614357,0.000973,"#8ecfec"
206340907,martaguima,37,0,1,1,0.724152,0.342557,0,"#006032"
206364045,cadenaroa,7,2,3,5,0.567306,0.467338,0.001946,"#ffb800"
206375063,FLACSOARGENTINA,49,7,0,7,0.472676,0.476926,0.002918,"#ff7007"
206387234,twittmariamoral,8,0,1,1,0.249635,0.274624,0,"#00ed5d"
206396279,jgabelas,22,6,12,18,0.534905,0.607636,0.008268,"#00e8b2"
206582886,PAZLLORIA,0,0,3,3,0.38726,0.465204,0.000973,"#8ecfec"
206702819,DrVilledlTorre,14,0,14,14,0.503969,0.51503,0.006323,"#00eeff"
206928825,SoyNanaChilena,21,0,1,1,0.247129,0.192715,0,"#c6cc85"
206977692,othbcn,14,0,1,1,0.627175,0.537914,0,"#00eeff"
207033967,BytesAndHumans,37,0,1,1,0.563872,0.622905,0,"#006032"
207094177,daniel_58,7,0,2,2,0.470653,0.363818,0.000486,"#ffb800"
207166307,ruben_arce_s,49,1,0,1,0.419532,0.696698,0,"#ff7007"
207173690,maria_freiria,8,0,3,3,0.647277,0.280397,0.000973,"#00ed5d"
207249457,bluebirdtrini,34,0,2,2,0.345142,0.417585,0.000486,"#ff0d69"
207251577,JaimeValdesCif,49,0,1,1,0.41692,0.715647,0,"#ff7007"
207261601,BecasEstudio,1,2,0,2,0.404492,0.542563,0.000486,"#b6cb00"
207425688,Lottewilms,31,1,0,1,0.626304,0.554183,0,"#3e93ff"
207492347,wendy_elvira,30,0,3,3,0.484095,0.65542,0.000973,"#ff77ff"
207494657,anabelquanhaase,36,0,1,1,0.580771,0.421121,0,"#825403"
207534677,MediaLSE,22,2,0,2,0.356587,0.500822,0.000486,"#00e8b2"
207594924,agenciasinc,55,1,0,1,0.614486,0.56393,0,"#cb3f32"
207615942,FOTOMILTON,38,0,1,1,0.599241,0.348064,0,"#662859"
207619323,analuciaraujo_,48,2,1,3,0.379691,0.467203,0.000973,"#ff7a78"
207678895,ccgsmtwitt,49,3,0,3,0.443448,0.563509,0.000973,"#ff7007"
207681897,dream666z,40,0,1,1,0.577978,0.009461,0,"#ff12a3"
208038261,dogandel,31,0,4,4,0.603315,0.52951,0.001459,"#3e93ff"
208110733,JavierArgente,30,0,1,1,0.595363,0.677404,0,"#ff77ff"
208151941,migupelo2,14,0,3,3,0.268571,0.627591,0.000973,"#00eeff"
208157890,telonnius,14,0,2,2,0.559591,0.505276,0.000486,"#00eeff"
208168549,chusigoza,34,0,2,2,0.412021,0.537997,0.000486,"#ff0d69"
208262079,Jgb_santos,36,1,3,4,0.507376,0.348392,0.001459,"#825403"
208291902,nellysgc,42,0,7,7,0.671451,0.43858,0.002918,"#66e087"
208405755,UPVCampusGandia,22,14,2,16,0.587554,0.392792,0.007296,"#00e8b2"
208478081,gemmarojo,18,0,2,2,0.750578,0.591598,0.000486,"#5456a6"
208484261,seresco,49,1,0,1,0.354781,0.673387,0,"#ff7007"
208586222,AlejaEscobar_C,38,0,1,1,0.461038,0.787443,0,"#662859"
208646289,spirituveritate,14,0,1,1,0.605549,0.473072,0,"#00eeff"
208649728,MDmanfredi,49,1,0,1,0.406059,0.672948,0,"#ff7007"
208676931,RULibraries,36,6,0,6,0.451925,0.380167,0.002432,"#825403"
208699873,LuzDeicyF,41,0,1,1,0.338282,0.388832,0,"#697b00"
208747620,inchocordero,31,2,2,4,0.546351,0.487936,0.001459,"#3e93ff"
208756540,SrtSanz_,31,0,3,3,0.611371,0.561357,0.000973,"#3e93ff"
208915015,improbable,40,0,1,1,0.643642,0.023475,0,"#ff12a3"
208955084,eu6eni,14,1,2,3,0.679281,0.518739,0.000973,"#00eeff"
209075024,osfa_11,22,0,4,4,0.527817,0.510874,0.001459,"#00e8b2"
209081122,adrenalinacol,49,1,0,1,0.303349,0.663603,0,"#ff7007"
209093808,marilocastrillo,30,0,7,7,0.536858,0.559946,0.002918,"#ff77ff"
209130989,ESDi_Barcelona,8,34,33,67,0.636483,0.365557,0.032101,"#00ed5d"
209157274,cipeuclm,22,2,0,2,0.447726,0.641762,0.000486,"#00e8b2"
209193163,betgerber,3,1,5,6,0.460591,0.562498,0.002432,"#ffb3ff"
209336070,manuelviola,49,1,0,1,0.290655,0.649723,0,"#ff7007"
209362732,pochijuancho,49,1,0,1,0.322705,0.661524,0,"#ff7007"
209363727,gisisch,49,0,5,5,0.588761,0.653803,0.001946,"#ff7007"
209369161,PalomaCuevasR,41,0,2,2,0.352469,0.387932,0.000486,"#697b00"
209371848,sorronald,34,0,2,2,0.5317,0.395641,0.000486,"#ff0d69"
209484168,scoopit,22,59,0,59,0.543173,0.59471,0.02821,"#00e8b2"
209561487,fulmen_dei,19,0,1,1,0.642111,0.641263,0,"#00d3ff"
209598141,alfonsomezquita,0,0,1,1,0.387972,0.572198,0,"#8ecfec"
210100445,vladicol,37,0,1,1,0.660347,0.381942,0,"#006032"
210128497,cjosegarza,45,7,1,8,0.665187,0.185809,0.003405,"#00e8ff"
210169011,Caza_ranas,21,0,1,1,0.215474,0.21261,0,"#c6cc85"
210173509,CiberNahual,7,0,1,1,0.416093,0.30325,0,"#ffb800"
210184794,MomentsAND,31,0,2,2,0.630144,0.551723,0.000486,"#3e93ff"
210320595,oscarhumb,4,0,1,1,0.845822,0.227912,0,"#f4c8cf"
210371847,Vuelo7988,14,0,2,2,0.442237,0.546178,0.000486,"#00eeff"
210417199,davidrebolomaga,22,0,2,2,0.548329,0.60499,0.000486,"#00e8b2"
210552821,zapataapril3,49,1,0,1,0.375535,0.673733,0,"#ff7007"
210573453,alekellyh,34,1,0,1,0.387413,0.309741,0,"#ff0d69"
210582008,jmarrese,49,1,0,1,0.37361,0.618072,0,"#ff7007"
210588274,o_xico,19,0,2,2,0.571375,0.612534,0.000486,"#00d3ff"
210636056,RobertoAriasHi,4,0,1,1,0.843261,0.249919,0,"#f4c8cf"
210655901,kmjimenezv,20,0,2,2,0.422017,0.152724,0.000486,"#f0be45"
210660373,UNTREF,37,7,0,7,0.348518,0.389756,0.002918,"#006032"
210680403,thiagonovaes79,36,1,0,1,0.486682,0.327094,0,"#825403"
210719134,filosofo56,14,0,2,2,0.635555,0.531401,0.000486,"#00eeff"
210751463,claubolio,7,0,2,2,0.391869,0.356859,0.000486,"#ffb800"
210771113,pastorams,22,1,0,1,0.667726,0.532116,0,"#00e8b2"
210808779,vriverareyes,1,0,1,1,0.416323,0.612723,0,"#b6cb00"
210887151,Mar7na,0,3,0,3,0.923554,0.702341,0.000973,"#8ecfec"
210989442,ninonllano,34,0,2,2,0.482381,0.417751,0.000486,"#ff0d69"
210992600,eurolobo,42,1,0,1,0.783815,0.433786,0,"#66e087"
210996391,sociobservermex,34,0,4,4,0.609316,0.370886,0.001459,"#ff0d69"
211001112,san_ti_llan,3,0,1,1,0.497247,0.751264,0,"#ffb3ff"
211107172,baquerosanchez,49,2,0,2,0.385826,0.57609,0.000486,"#ff7007"
211178314,gmastrantonio,49,1,0,1,0.414925,0.65606,0,"#ff7007"
211299754,FRodriguezJimen,19,1,14,15,0.58149,0.634109,0.006809,"#00d3ff"
211373182,AyeDic,38,0,5,5,0.487235,0.413512,0.001946,"#662859"
211429992,alvarosomoza,22,0,1,1,0.465957,0.588673,0,"#00e8b2"
211546264,jd_celis,9,0,2,2,0.674497,0.921824,0.000486,"#008f7b"
211561779,pablocarmenado,1,0,2,2,0.66778,0.446051,0.000486,"#b6cb00"
211582602,ColpisaNoticias,14,0,2,2,0.641714,0.826646,0.000486,"#00eeff"
211584648,mimssodesign,22,0,2,2,0.329755,0.737333,0.000486,"#00e8b2"
211592433,GIMENADELRIO,34,1,0,1,0.482478,0.358658,0,"#ff0d69"
211596533,dgesm,14,0,1,1,0.676601,0.575438,0,"#00eeff"
211629576,busta1970,55,0,2,2,0.569937,0.572664,0.000486,"#cb3f32"
211656278,MalonsoLedesma,22,0,1,1,0.609424,0.596886,0,"#00e8b2"
211696953,DiegoANajeraM,17,0,1,1,0.825742,0.237616,0,"#ff9cc7"
211763566,codice_informa,13,3,2,5,0.427091,0.512507,0.001946,"#3bec00"
211830307,cienciacanaria,30,0,5,5,0.580991,0.643493,0.001946,"#ff77ff"
211855077,EscribeAQ,30,0,2,2,0.448328,0.536835,0.000486,"#ff77ff"
211855125,anakarineg,36,0,3,3,0.468475,0.347016,0.000973,"#825403"
211891571,antroastronomo,7,1,0,1,0.793048,0.614872,0,"#ffb800"
211950987,agilchristpike,13,0,1,1,0.372315,0.37726,0,"#3bec00"
211989452,naidenmen,34,0,4,4,0.475053,0.293044,0.001459,"#ff0d69"
211993540,martalmcomposer,42,0,1,1,0.730299,0.498498,0,"#66e087"
212051454,libraaliviada,22,0,1,1,0.272729,0.453116,0,"#00e8b2"
212067864,MarioOjedaRevah,34,0,1,1,0.486919,0.372926,0,"#ff0d69"
212086069,corazondepoeta_,3,1,0,1,0.626178,0.570944,0,"#ffb3ff"
212170817,pacodelatorrep,14,1,0,1,0.625935,0.545514,0,"#00eeff"
212179420,MarileoV,22,1,2,3,0.537065,0.70863,0.000973,"#00e8b2"
212179973,isidore___,13,3,3,6,0.488613,0.552033,0.002432,"#3bec00"
212243918,Km_Sabogal,37,13,26,39,0.543424,0.429488,0.018482,"#006032"
212244069,MU_gep,18,1,0,1,0.764359,0.632507,0,"#5456a6"
212248472,ernstherrera,38,0,2,2,0.655152,0.282587,0.000486,"#662859"
212297066,_CLACSO,3,22,6,28,0.393311,0.512086,0.013132,"#ffb3ff"
212312757,iberisTICs,36,5,4,9,0.709205,0.477921,0.003891,"#825403"
212418005,Elsa_Razo1,3,0,2,2,0.492628,0.611822,0.000486,"#ffb3ff"
212432679,Elhombremagma,38,0,1,1,0.812195,0.64624,0,"#662859"
212467786,luciadelaserna,34,0,1,1,0.485953,0.266683,0,"#ff0d69"
212569176,teacherinside,36,1,3,4,0.737148,0.516492,0.001459,"#825403"
212657060,PilarSalasQ,15,0,1,1,0.560674,0.678554,0,"#008ebb"
212742565,ponteUFPR,36,0,2,2,0.538431,0.436398,0.000486,"#825403"
212759893,puentevaldivia,38,5,4,9,0.493591,0.41113,0.003891,"#662859"
212827104,leydi_caballero,49,2,0,2,0.422755,0.542881,0.000486,"#ff7007"
212953573,isisleall,36,2,0,2,0.489817,0.334144,0.000486,"#825403"
212974469,alezamce,0,0,3,3,0.414786,0.549587,0.000973,"#8ecfec"
212980906,Reyes_Queen,22,0,2,2,0.576866,0.588226,0.000486,"#00e8b2"
213023965,Azulvictoria,21,0,2,2,0.22078,0.24259,0.000486,"#c6cc85"
213099694,elquellegatarde,31,19,9,28,0.552503,0.538224,0.013132,"#3e93ff"
213158232,criscitarojas,49,1,0,1,0.411313,0.699275,0,"#ff7007"
213264156,raquelsastrecom,8,1,2,3,0.647126,0.301014,0.000973,"#00ed5d"
213307991,FMORENOFDEZ,2,0,2,2,0.474247,0.633037,0.000486,"#ffa64e"
213348479,jmwemcr,38,0,1,1,0.659707,0.363543,0,"#662859"
213353752,LaMoriano,37,0,1,1,0.622602,0.629425,0,"#006032"
213400899,AmericanObserva,31,0,1,1,0.765651,0.908974,0,"#3e93ff"
213436495,paoreyr,38,0,1,1,0.405901,0.380429,0,"#662859"
213474460,CreativiTIC,18,5,2,7,0.566677,0.574415,0.002918,"#5456a6"
213575812,lornarichardson,13,0,1,1,0.353951,0.444292,0,"#3bec00"
213705993,mafaldaenred,14,0,2,2,0.692121,0.55198,0.000486,"#00eeff"
213793319,librlaurie,13,0,2,2,0.435656,0.456369,0.000486,"#3bec00"
213803771,mjsanchezperez,22,0,1,1,0.666549,0.478307,0,"#00e8b2"
213951114,bettocan,7,0,1,1,0.699805,0.488438,0,"#ffb800"
214116875,Madreabadesa,14,0,2,2,0.565469,0.528951,0.000486,"#00eeff"
214169882,Rayo_Verde,15,1,1,2,0.527883,0.652198,0.000486,"#008ebb"
214177703,v_depablo,3,0,1,1,0.622066,0.763285,0,"#ffb3ff"
214230658,j_murillo_arias,22,0,1,1,0.676087,0.35868,0,"#00e8b2"
214275191,Razonyre,49,1,0,1,0.414148,0.628501,0,"#ff7007"
214292881,fmorales1980,34,8,5,13,0.428092,0.274086,0.005837,"#ff0d69"
214317322,barbie_zml,3,0,1,1,0.708193,0.700929,0,"#ffb3ff"
214386768,marisol_bcn69,16,0,3,3,0.789376,0.623551,0.000973,"#c42c63"
214634977,sekleinman,49,0,1,1,0.406445,0.509593,0,"#ff7007"
214705194,metalcolica,13,0,1,1,0.424118,0.497353,0,"#3bec00"
214733756,IC_Manila,15,0,4,4,0.519087,0.607566,0.001459,"#008ebb"
214778997,udec_oficial,34,1,0,1,0.409756,0.253528,0,"#ff0d69"
214804845,alumni_unav,1,0,1,1,0.6775,0.480037,0,"#b6cb00"
214815360,Dani_Varo,1,0,1,1,0.409503,0.783546,0,"#b6cb00"
214901927,CluMejia,37,0,1,1,0.588044,0.330084,0,"#006032"
214937685,MJesus_Saff,31,0,1,1,0.704435,0.409608,0,"#3e93ff"
214965900,CampusMDelibes,22,3,13,16,0.500379,0.561493,0.007296,"#00e8b2"
214985668,lluisgesa,14,0,3,3,0.630914,0.547156,0.000973,"#00eeff"
215040673,culturpunk,31,2,0,2,0.683384,0.591551,0.000486,"#3e93ff"
215127555,Manelbelzonti,36,0,2,2,0.512626,0.34115,0.000486,"#825403"
215175701,bphavitia,3,0,2,2,0.463364,0.659041,0.000486,"#ffb3ff"
215205937,mangela_celis,15,37,33,70,0.534059,0.55282,0.03356,"#008ebb"
215386783,juang44,40,0,1,1,0.595319,0.013525,0,"#ff12a3"
215457947,angelesglezc,10,0,2,2,0.316487,0.476562,0.000486,"#52d7c0"
215640863,PCavaHarinero,15,0,1,1,0.531865,0.724575,0,"#008ebb"
215659070,gemmagaldon,0,0,2,2,0.440022,0.398007,0.000486,"#8ecfec"
215793735,rivkagreen,22,1,9,10,0.522137,0.541733,0.004377,"#00e8b2"
215889088,mexidedonato,38,0,1,1,0.434324,0.870973,0,"#662859"
215903147,JilCos,15,0,1,1,0.548623,0.658383,0,"#008ebb"
215910028,iasoto,8,0,1,1,0.353374,0.509206,0,"#00ed5d"
215922074,ToniCasado,15,1,1,2,0.613485,0.637625,0.000486,"#008ebb"
215929485,ESAT_Valencia,31,1,2,3,0.598023,0.511275,0.000973,"#3e93ff"
215968373,unavbiblioteca,1,2,15,17,0.541851,0.539685,0.007782,"#b6cb00"
216072658,stratesys,18,4,2,6,0.437889,0.718845,0.002432,"#5456a6"
216106179,CulturaNacionAR,49,1,0,1,0.372294,0.723118,0,"#ff7007"
216110778,lacajonera,2,0,3,3,0.667873,0.580219,0.000973,"#ffa64e"
216303854,eomalea,14,0,2,2,0.486711,0.569954,0.000486,"#00eeff"
216311007,javierales,1,3,2,5,0.47589,0.611737,0.001946,"#b6cb00"
216334526,Draconary,14,0,3,3,0.565804,0.525986,0.000973,"#00eeff"
216334777,MECpy,37,18,0,18,0.302042,0.521586,0.008268,"#006032"
216362822,CeDiS_FU_Berlin,13,1,0,1,0.454041,0.298589,0,"#3bec00"
216383420,OSPAAALTRI,49,1,0,1,0.414395,0.67844,0,"#ff7007"
216415212,jorsugar,49,0,2,2,0.367197,0.533926,0.000486,"#ff7007"
216426141,MonicaMolanes,14,0,2,2,0.473897,0.564611,0.000486,"#00eeff"
216427970,arquivista2,19,3,4,7,0.563951,0.481439,0.002918,"#00d3ff"
216526330,eduescar,13,0,7,7,0.417244,0.458935,0.002918,"#3bec00"
216581267,DivineDis,7,0,2,2,0.428439,0.358954,0.000486,"#ffb800"
216625209,antoniohuesa,30,0,3,3,0.530446,0.535845,0.000973,"#ff77ff"
216739115,elpaisinenglish,36,4,0,4,0.49897,0.440791,0.001459,"#825403"
216761923,leboixta,30,0,1,1,0.5257,0.655151,0,"#ff77ff"
216784453,saberucv,42,1,0,1,0.743002,0.381101,0,"#66e087"
216788785,CokeMeza,21,0,2,2,0.215502,0.255864,0.000486,"#c6cc85"
216824024,Asvogra,22,0,1,1,0.378413,0.196287,0,"#00e8b2"
216847904,AVEPHENIXVUELA,30,0,1,1,0.626739,0.469022,0,"#ff77ff"
216943505,pdrza,36,0,3,3,0.532071,0.372772,0.000973,"#825403"
217078361,1954candanga,49,1,0,1,0.368503,0.638544,0,"#ff7007"
217119841,uelramon,30,0,1,1,0.623242,0.477449,0,"#ff77ff"
217143831,JLOntalba,38,0,1,1,0.103071,0.437256,0,"#662859"
217166221,Georgina_BC,8,1,12,13,0.644702,0.358644,0.005837,"#00ed5d"
217194302,ElenaVozmediano,30,0,1,1,0.553094,0.727862,0,"#ff77ff"
217225558,sade196436,37,0,1,1,0.187693,0.487029,0,"#006032"
217595740,Educadoramx,9,0,1,1,0.488613,0.70544,0,"#008f7b"
217739266,NandoBetancorP,3,0,2,2,0.454107,0.611534,0.000486,"#ffb3ff"
217745211,leonidasarjona,0,0,2,2,0.828434,0.433477,0.000486,"#8ecfec"
217804739,Facebook,30,5,0,5,0.496142,0.536036,0.001946,"#ff77ff"
217851514,deturismoytradu,31,0,1,1,0.662489,0.544878,0,"#3e93ff"
217885674,iyepes0120,13,0,4,4,0.4816,0.440797,0.001459,"#3bec00"
217915394,mmelgarejo3300,30,0,2,2,0.747455,0.666674,0.000486,"#ff77ff"
217927035,kedelsg,9,1,6,7,0.538282,0.581015,0.002918,"#008f7b"
217942223,Misky2010,31,0,1,1,0.630359,0.500246,0,"#3e93ff"
217968523,Beth_enlinea,3,0,1,1,0.471579,0.671987,0,"#ffb3ff"
218022095,juancolmeda,13,0,1,1,0.410414,0.405584,0,"#3bec00"
218083367,visualoop,49,1,0,1,0.445408,0.613999,0,"#ff7007"
218243042,Alma_Athenea,7,0,1,1,0.387172,0.295206,0,"#ffb800"
218288230,Alejandro_PV,7,0,2,2,0.377167,0.372748,0.000486,"#ffb800"
218310618,adriaramaral,36,0,2,2,0.497313,0.234398,0.000486,"#825403"
218330700,dabautistac,34,7,18,25,0.53353,0.477956,0.011673,"#ff0d69"
218379543,Ashot_,34,0,3,3,0.498377,0.42155,0.000973,"#ff0d69"
218480903,Areandina,49,5,0,5,0.476176,0.607138,0.001946,"#ff7007"
218519907,Juaki63,0,0,1,1,0.272484,0.500007,0,"#8ecfec"
218530146,pmgooding,49,0,3,3,0.456112,0.535151,0.000973,"#ff7007"
218683150,Fuzzka,7,0,1,1,0.410968,0.296879,0,"#ffb800"
218716744,welcufe,21,0,2,2,0.230475,0.244638,0.000486,"#c6cc85"
218731620,analiazygier,49,3,0,3,0.451719,0.584593,0.000973,"#ff7007"
218735748,morenoroberto77,7,0,1,1,0.400983,0.208348,0,"#ffb800"
218830003,emchateau,36,0,8,8,0.478984,0.491087,0.003405,"#825403"
218832661,jonaltunairaola,18,0,2,2,0.707784,0.633476,0.000486,"#5456a6"
218840424,Concha5115,0,0,1,1,0.373154,0.557647,0,"#8ecfec"
218944600,JuanPangulo,13,1,0,1,0.570511,0.428615,0,"#3bec00"
219084872,yaelboublil,36,0,2,2,0.565293,0.402748,0.000486,"#825403"
219128411,DiegoCastiblaNT,37,0,3,3,0.596453,0.404064,0.000973,"#006032"
219170484,alexandrerenoir,14,0,1,1,0.586584,0.482124,0,"#00eeff"
219193753,PauliPliego,37,2,0,2,0.583286,0.372024,0.000486,"#006032"
219244612,macosas,37,0,3,3,0.566304,0.484752,0.000973,"#006032"
219267671,medicblasto,40,0,1,1,0.596709,0.033039,0,"#ff12a3"
219339577,Canalteleamiga,38,1,0,1,0.622601,0.350448,0,"#662859"
219408746,ricpluss,49,1,1,2,0.436347,0.519316,0.000486,"#ff7007"
219453923,Universijazz,0,0,1,1,0.530477,0.401615,0,"#8ecfec"
219472652,figuereous,43,0,1,1,0.702976,0.556592,0,"#fcae7e"
219562937,Patosalt,20,0,2,2,0.42344,0.148196,0.000486,"#f0be45"
219592309,Il3ni4,36,0,1,1,0.848356,0.343065,0,"#825403"
219623688,Juliamancon,31,0,3,3,0.662792,0.462758,0.000973,"#3e93ff"
219645411,m_antiguo,37,1,0,1,0.636362,0.337909,0,"#006032"
219678666,UnPerrit0,21,0,1,1,0.212519,0.207503,0,"#c6cc85"
220054422,polivia1,7,1,1,2,0.403418,0.552906,0.000486,"#ffb800"
220180748,titinamonina,13,1,5,6,0.499791,0.413234,0.002432,"#3bec00"
220247368,novanay33,7,0,1,1,0.778008,0.314116,0,"#ffb800"
220271264,fnietomorales,7,39,3,42,0.420346,0.276278,0.019942,"#ffb800"
220277203,parreshia,22,0,2,2,0.625732,0.460443,0.000486,"#00e8b2"
220315022,TalismaneBooks,22,0,1,1,0.670038,0.569604,0,"#00e8b2"
220352451,BecConv,1,2,0,2,0.403345,0.538265,0.000486,"#b6cb00"
220369647,PATRICARBALLO,49,1,0,1,0.411792,0.662609,0,"#ff7007"
220381602,OrriolsRosa,8,0,2,2,0.662446,0.300929,0.000486,"#00ed5d"
220635766,ComillasTurismo,22,1,2,3,0.565917,0.661106,0.000973,"#00e8b2"
220697710,joangv66,15,0,2,2,0.645931,0.424481,0.000486,"#008ebb"
220768736,journalifez,0,0,1,1,0.379361,0.547309,0,"#8ecfec"
220827516,enclaveele,1,0,1,1,0.434697,0.792985,0,"#b6cb00"
220843345,Priscilamateini,49,0,10,10,0.469484,0.47615,0.004377,"#ff7007"
220895923,spineda69,9,0,1,1,0.717292,0.676117,0,"#008f7b"
220911015,sandroidefilos,13,14,53,67,0.498786,0.476871,0.032101,"#3bec00"
220966558,sfpieuv,31,0,2,2,0.637108,0.342239,0.000486,"#3e93ff"
220972438,OpenLibra,20,2,0,2,0.384277,0.038569,0.000486,"#f0be45"
221050142,FyL_UAM,37,28,4,32,0.618074,0.509736,0.015078,"#006032"
221074594,conejodeluna,0,0,2,2,0.445942,0.392357,0.000486,"#8ecfec"
221087730,BDMEX,13,1,0,1,0.443823,0.361106,0,"#3bec00"
221088789,JL_Mico,37,0,1,1,0.509626,0.245397,0,"#006032"
221091942,revistatdigital,58,0,3,3,0.578636,0.465604,0.000973,"#005076"
221124227,nebulousflynn,2,0,2,2,0.688899,0.65292,0.000486,"#ffa64e"
221149961,GemaLobillo,14,0,1,1,0.649364,0.559835,0,"#00eeff"
221300231,Portela_Silvia,36,0,1,1,0.334241,0.148307,0,"#825403"
221313572,enlight_ED,0,22,8,30,0.440501,0.534287,0.014105,"#8ecfec"
221358827,ueu_orokorra,22,1,0,1,0.620819,0.943647,0,"#00e8b2"
221381873,myriamsoteras,14,0,1,1,0.65391,0.574034,0,"#00eeff"
221427986,raquelenUVa,31,0,1,1,0.610466,0.720334,0,"#3e93ff"
221441528,rulp91,31,0,2,2,0.598435,0.524352,0.000486,"#3e93ff"
221510878,anvcscalar,13,2,2,4,0.407644,0.408757,0.001459,"#3bec00"
221540591,diagonalesweb,49,4,0,4,0.433987,0.580216,0.001459,"#ff7007"
221569343,thematcardozo,15,0,1,1,0.721807,0.595403,0,"#008ebb"
221758681,ecoAula,1,0,1,1,0.731654,0.621572,0,"#b6cb00"
221769359,DIGITALpuntoED,13,0,1,1,0.329463,0.49957,0,"#3bec00"
221796313,divulgaciond,58,3,0,3,0.453754,0.632093,0.000973,"#005076"
221843522,bituur_esztreym,30,0,1,1,0.585905,0.526164,0,"#ff77ff"
221876473,iecamarabahia,36,0,1,1,0.58749,0.286472,0,"#825403"
222099372,conciti,22,0,2,2,0.657587,0.488279,0.000486,"#00e8b2"
222104264,VeronicaVdV,31,0,1,1,0.590967,0.422568,0,"#3e93ff"
222109723,untiporaro,34,0,13,13,0.493632,0.474878,0.005837,"#ff0d69"
222184943,conradogbw,7,0,1,1,0.685503,0.596961,0,"#ffb800"
222244502,JohaGalG,38,0,1,1,0.556668,0.400833,0,"#662859"
222269705,Ibangarciadb,37,7,6,13,0.563381,0.595883,0.005837,"#006032"
222296230,abramovay,36,5,2,7,0.113484,0.684215,0.002918,"#825403"
222325929,Jcvaldi,3,0,1,1,0.517687,0.764095,0,"#ffb3ff"
222548988,andresortegon2,3,0,1,1,0.471432,0.745445,0,"#ffb3ff"
222685475,napsterofpuppet,22,0,1,1,0.589439,0.609651,0,"#00e8b2"
222691945,antropologiaucv,31,0,1,1,0.648684,0.522584,0,"#3e93ff"
222693301,VilchesLaura,49,2,0,2,0.407944,0.567605,0.000486,"#ff7007"
222765418,rmounce,13,1,0,1,0.49696,0.364011,0,"#3bec00"
222793240,juliarevilla,31,0,1,1,0.646072,0.510264,0,"#3e93ff"
222800006,igfenoll,1,0,1,1,0.46797,0.601627,0,"#b6cb00"
222867974,manuelmqc,58,0,1,1,0.601882,0.267679,0,"#005076"
222878258,txapucabor,40,0,1,1,0.599479,0.03087,0,"#ff12a3"
222923493,5RAZ0N,30,0,1,1,0.579023,0.672358,0,"#ff77ff"
222937952,vgutierrezsanz,30,3,6,9,0.468052,0.550131,0.003891,"#ff77ff"
222950058,caedare,34,0,6,6,0.495087,0.436221,0.002432,"#ff0d69"
222964139,TaniaBallocolel,19,3,0,3,0.652912,0.741249,0.000973,"#00d3ff"
223235151,Nana_Cutzin,7,1,14,15,0.466825,0.477465,0.006809,"#ffb800"
223239313,joaquineku,14,0,1,1,0.672027,0.494083,0,"#00eeff"
223279139,ccdinarte2010,7,2,6,8,0.737898,0.563097,0.003405,"#ffb800"
223286539,arq_csouza,36,0,1,1,0.545902,0.303868,0,"#825403"
223316227,roxanaceci,8,0,3,3,0.558006,0.633926,0.000973,"#00ed5d"
223380941,jlvazpol,58,1,1,2,0.541138,0.49752,0.000486,"#005076"
223472601,DisfrutemosBA,49,9,0,9,0.279489,0.656771,0.003891,"#ff7007"
223580411,MauricioTexcoco,30,1,3,4,0.250849,0.561255,0.001459,"#ff77ff"
223593253,GomezBalza,42,4,6,10,0.629641,0.451304,0.004377,"#66e087"
223598917,german_sierra,13,0,4,4,0.455382,0.480651,0.001459,"#3bec00"
223694721,pywirrarika,13,0,1,1,0.431768,0.336652,0,"#3bec00"
223806636,marquezmoy,37,0,1,1,0.750794,0.494345,0,"#006032"
223834901,sallesto,49,31,13,44,0.487517,0.50187,0.020914,"#ff7007"
223858370,danisanchzm,38,0,1,1,0.113387,0.809641,0,"#662859"
223870101,marsabbatini,31,2,1,3,0.551092,0.460888,0.000973,"#3e93ff"
223940532,Hortoneda,14,0,2,2,0.620964,0.531992,0.000486,"#00eeff"
223948107,isamaima,38,0,1,1,0.554565,0.303644,0,"#662859"
223981374,Fortelena,30,0,1,1,0.48332,0.647824,0,"#ff77ff"
223983199,CindyCamilaP,20,0,1,1,0.399657,0.065246,0,"#f0be45"
223992841,DANIELUPEGUIRD,49,1,0,1,0.387412,0.648074,0,"#ff7007"
224049859,Mell_Chahdz,38,0,1,1,0.145021,0.807917,0,"#662859"
224182685,sifopcarm,22,0,2,2,0.437553,0.654064,0.000486,"#00e8b2"
224289167,Beba_Perez,2,2,5,7,0.659974,0.595815,0.002918,"#ffa64e"
224331457,juvelas,13,7,2,9,0.472022,0.316266,0.003891,"#3bec00"
224355972,jhinfinito,34,6,13,19,0.54343,0.462625,0.008755,"#ff0d69"
224389102,CFNani,14,0,3,3,0.517618,0.560217,0.000973,"#00eeff"
224392992,sofia_valenzuel,21,4,1,5,0.250788,0.420307,0.001946,"#c6cc85"
224453537,OscarCumbicus,34,0,2,2,0.433555,0.459536,0.000486,"#ff0d69"
224487782,e_yendis,37,0,1,1,0.723152,0.276523,0,"#006032"
224495471,ConversationEDU,38,1,0,1,0.295472,0.288886,0,"#662859"
224600567,WilferMontes,38,0,1,1,0.404711,0.772826,0,"#662859"
224631899,figshare,13,3,1,4,0.525478,0.481968,0.001459,"#3bec00"
224655386,currobasagoiti,31,0,3,3,0.529706,0.505185,0.000973,"#3e93ff"
224679591,SIGdeletras,14,0,2,2,0.586514,0.583521,0.000486,"#00eeff"
224713074,SebastianReyesE,34,0,1,1,0.53689,0.382884,0,"#ff0d69"
224734204,moengel,13,0,1,1,0.423102,0.522897,0,"#3bec00"
224741510,RosaTristan,49,1,0,1,0.32998,0.645602,0,"#ff7007"
224756069,Sylet66,3,0,1,1,0.508232,0.753141,0,"#ffb3ff"
224830396,CarlsHist,48,0,1,1,0.221939,0.719854,0,"#ff7a78"
224889538,Suzurusu,13,0,1,1,0.489483,0.316178,0,"#3bec00"
225001462,grafosfera,14,26,33,59,0.532359,0.500109,0.02821,"#00eeff"
225021960,JoanClotet,49,2,1,3,0.5196,0.58138,0.000973,"#ff7007"
225066068,LinaCWills,38,5,6,11,0.541598,0.419971,0.004864,"#662859"
225075639,Griceldap,13,0,1,1,0.426776,0.424471,0,"#3bec00"
225144089,elcolsan,13,19,11,30,0.462751,0.418864,0.014105,"#3bec00"
225214534,judiosenmexico,37,1,0,1,0.561377,0.369432,0,"#006032"
225253432,Hopenoespera,38,0,2,2,0.60017,0.40144,0.000486,"#662859"
225453405,Clarafatri,1,0,4,4,0.309603,0.560296,0.001459,"#b6cb00"
225780568,MontseCasanovas,31,0,2,2,0.649846,0.526909,0.000486,"#3e93ff"
225903619,NDavid_R,3,0,1,1,0.471135,0.762695,0,"#ffb3ff"
225934888,BVEdiciones,13,0,1,1,0.420081,0.499459,0,"#3bec00"
225956969,milo_osorio1,38,0,1,1,0.426268,0.77899,0,"#662859"
225967427,HorrorandScF,30,0,3,3,0.499073,0.517044,0.000973,"#ff77ff"
226024604,katospiegel,31,0,3,3,0.649359,0.547867,0.000973,"#3e93ff"
226052456,HOrangeDreamer,7,0,3,3,0.593612,0.452932,0.000973,"#ffb800"
226212235,amesassy,13,4,37,41,0.484774,0.485965,0.019455,"#3bec00"
226228479,pinedavaquer,14,0,1,1,0.630247,0.6605,0,"#00eeff"
226289870,Antequerajose,49,1,0,1,0.430202,0.671032,0,"#ff7007"
226298617,doloresalozano,34,0,2,2,0.346842,0.416358,0.000486,"#ff0d69"
226300051,e_duperly,38,0,1,1,0.333884,0.16052,0,"#662859"
226387687,PabloNavarroooo,49,0,1,1,0.236933,0.699438,0,"#ff7007"
226402159,Lacasadeazul,7,0,2,2,0.384117,0.340566,0.000486,"#ffb800"
226521252,claraimc,30,0,1,1,0.527897,0.631328,0,"#ff77ff"
226634691,Cultureduca,37,0,2,2,0.568329,0.599921,0.000486,"#006032"
226659444,vivangm,5,0,1,1,0.64326,0.298592,0,"#b2dd44"
226688040,Oscar_Campos19,38,0,1,1,0.525679,0.311006,0,"#662859"
226713255,tatianaduplat,38,5,5,10,0.630177,0.43058,0.004377,"#662859"
226716159,alesarrett,13,0,1,1,0.478511,0.368449,0,"#3bec00"
226739048,barri58,40,0,1,1,0.6536,0.039357,0,"#ff12a3"
226790871,BPPiloto,38,3,1,4,0.335472,0.542163,0.001459,"#662859"
227090031,MJesusCanizares,8,3,2,5,0.717996,0.247322,0.001946,"#00ed5d"
227264918,adgfad,22,8,4,12,0.573829,0.617534,0.00535,"#00e8b2"
227292821,eldialp,49,1,0,1,0.373211,0.610225,0,"#ff7007"
227358393,unil,53,8,0,8,0.503103,0.575286,0.003405,"#008bdd"
227368346,IC_Bruselas,1,14,6,20,0.45019,0.671882,0.009241,"#b6cb00"
227372172,jhom79,38,0,1,1,0.624589,0.352625,0,"#662859"
227433686,yhnmtrn,38,0,1,1,0.33393,0.163658,0,"#662859"
227462620,bulaborando,13,0,1,1,0.474642,0.341531,0,"#3bec00"
227539872,josegeeklml,38,18,27,45,0.482209,0.44025,0.021401,"#662859"
227677247,jennycyta18,38,0,1,1,0.586203,0.335608,0,"#662859"
227691824,JJDavalosFEUNAM,37,0,1,1,0.369147,0.323651,0,"#006032"
227740473,0818gavi,38,0,1,1,0.430696,0.773858,0,"#662859"
227898986,maybel65,1,0,2,2,0.450559,0.607609,0.000486,"#b6cb00"
227993907,Nosolodeyod,1,3,0,3,0.487782,0.592999,0.000973,"#b6cb00"
228057112,Alexherregil,38,1,3,4,0.303427,0.537426,0.001459,"#662859"
228066025,Miguelvalbuenam,22,0,1,1,0.573898,0.688002,0,"#00e8b2"
228101125,JamesAGPerry,4,0,1,1,0.505944,0.374407,0,"#f4c8cf"
228117613,MQAsuramerica,49,1,0,1,0.357279,0.594606,0,"#ff7007"
228160510,OscarBG22,49,1,0,1,0.400431,0.63869,0,"#ff7007"
228170045,FBernalP,30,0,1,1,0.420162,0.634369,0,"#ff77ff"
228317338,AndaluciaTECH,14,3,4,7,0.541208,0.521186,0.002918,"#00eeff"
228378589,enavarro3,14,0,1,1,0.666424,0.617579,0,"#00eeff"
228402125,SunriseAtTheSky,14,1,9,10,0.481912,0.540403,0.004377,"#00eeff"
228474912,EMITRZNA,16,0,2,2,0.947852,0.678266,0.000486,"#c42c63"
228661503,GrupoEIP,55,0,2,2,0.630881,0.5551,0.000486,"#cb3f32"
228677817,Carlos_AlmanzaA,3,0,1,1,0.513139,0.752138,0,"#ffb3ff"
228764592,lenguajeclaroed,49,1,1,2,0.564873,0.712151,0.000486,"#ff7007"
228767187,ComicsGrid,14,0,3,3,0.616757,0.479557,0.000973,"#00eeff"
228875500,lema2r,30,22,40,62,0.515395,0.5253,0.029669,"#ff77ff"
229059335,GaleEMEA,36,5,0,5,0.455332,0.358694,0.001946,"#825403"
229127266,MarcMaciaFarre,38,0,11,11,0.529921,0.532657,0.004864,"#662859"
229147709,jorgedegeneffe,30,0,1,1,0.510997,0.635534,0,"#ff77ff"
229161407,prodriguezpapp,31,1,1,2,0.461812,0.612591,0.000486,"#3e93ff"
229198574,gema_bueno,30,0,3,3,0.504651,0.59307,0.000973,"#ff77ff"
229298953,emartinezgil,8,2,1,3,0.550758,0.457432,0.000973,"#00ed5d"
229382581,Xet07,30,1,0,1,0.580334,0.571463,0,"#ff77ff"
229724313,jduss4,34,0,1,1,0.390623,0.444162,0,"#ff0d69"
229837949,GabrielaTafur,38,3,0,3,0.335901,0.397915,0.000973,"#662859"
229915038,cocoyito140402,5,0,1,1,0.647599,0.305555,0,"#b2dd44"
229935065,pcayuqueo,21,0,2,2,0.25304,0.240157,0.000486,"#c6cc85"
230045755,estevaogustavo,36,1,0,1,0.533484,0.18132,0,"#825403"
230125016,BBVAWorld,22,2,0,2,0.698136,0.376263,0.000486,"#00e8b2"
230145544,xandascousas,49,1,0,1,0.366646,0.657975,0,"#ff7007"
230180270,SaberesDocentes,49,0,1,1,0.387152,0.304995,0,"#ff7007"
230247826,ikyvelaz,1,0,2,2,0.662153,0.443632,0.000486,"#b6cb00"
230271402,KimCaceres,49,1,0,1,0.319751,0.597347,0,"#ff7007"
230303484,Lycia83,8,0,1,1,0.512832,0.797474,0,"#00ed5d"
230348147,HistoriaActual,19,1,0,1,0.607291,0.772667,0,"#00d3ff"
230474195,RafaXambo,40,0,1,1,0.611791,0.046394,0,"#ff12a3"
230499882,raclateral,36,0,1,1,0.495933,0.27364,0,"#825403"
230500370,arquideologica,19,0,1,1,0.631124,0.411417,0,"#00d3ff"
230597659,MiguelBenlloch,31,0,2,2,0.599186,0.54558,0.000486,"#3e93ff"
230823610,Aleph43,9,0,6,6,0.619066,0.563051,0.002432,"#008f7b"
230902213,tejiendomemoria,34,3,0,3,0.438958,0.442827,0.000973,"#ff0d69"
231008973,Montagut5,22,0,2,2,0.575415,0.540839,0.000486,"#00e8b2"
231058762,Kandemarrero,30,0,1,1,0.493006,0.623959,0,"#ff77ff"
231114338,therfer,13,0,1,1,0.403084,0.48953,0,"#3bec00"
231144760,ferranet2,34,14,7,21,0.544028,0.427887,0.009728,"#ff0d69"
231203958,luisignaciotid,49,3,0,3,0.420758,0.603011,0.000973,"#ff7007"
231204463,latinategua,30,3,1,4,0.254907,0.601425,0.001459,"#ff77ff"
231216249,LetraUrbana,49,1,1,2,0.454128,0.666907,0.000486,"#ff7007"
231261891,Ipsorai,13,6,6,12,0.436223,0.424579,0.00535,"#3bec00"
231317966,GMiastral,13,0,1,1,0.382385,0.384949,0,"#3bec00"
231411941,ivan_hombre,14,0,4,4,0.589435,0.590966,0.001459,"#00eeff"
231495872,EPLaRioja,14,3,1,4,0.503475,0.458415,0.001459,"#00eeff"
231534714,ojeancarlo,34,0,3,3,0.450945,0.444543,0.000973,"#ff0d69"
231577324,NetflixLAT,35,7,0,7,0.445366,0.510509,0.002918,"#00faff"
231730356,thejodireeves,36,0,3,3,0.405284,0.412105,0.000973,"#825403"
231754040,magpano,15,0,1,1,0.490471,0.730342,0,"#008ebb"
231761216,carmeniglesiasb,30,0,3,3,0.535552,0.568728,0.000973,"#ff77ff"
231787884,JAdelSazN,1,9,19,28,0.496828,0.553884,0.013132,"#b6cb00"
231852828,Senyoretairene,13,0,1,1,0.435512,0.488082,0,"#3bec00"
232042459,josiasraph,36,1,0,1,0.439131,0.221856,0,"#825403"
232270046,acasasm,14,0,4,4,0.543934,0.48035,0.001459,"#00eeff"
232312176,ratservidor,13,5,12,17,0.482777,0.45181,0.007782,"#3bec00"
232337097,dhcambron,13,1,2,3,0.405548,0.373549,0.000973,"#3bec00"
232629381,yolvistupac3,31,0,8,8,0.558716,0.555131,0.003405,"#3e93ff"
232681569,caribouwireless,34,0,4,4,0.365568,0.453316,0.001459,"#ff0d69"
232772875,pavltarin,22,1,1,2,0.46218,0.607981,0.000486,"#00e8b2"
232885702,SarahRafaGarcia,34,5,5,10,0.413461,0.431406,0.004377,"#ff0d69"
232886744,renanpaivinha,36,1,0,1,0.513712,0.269855,0,"#825403"
233107654,cantavest,49,1,29,30,0.47585,0.51364,0.014105,"#ff7007"
233140003,Alcarendor,22,0,1,1,0.390946,0.599085,0,"#00e8b2"
233204912,netievalage,36,0,4,4,0.454017,0.494715,0.001459,"#825403"
233318916,_JuanAlvarez_,38,7,2,9,0.539714,0.439789,0.003891,"#662859"
233443807,jadesdelgado,42,12,4,16,0.69611,0.440148,0.007296,"#66e087"
233476466,Rev_Comunicar,13,13,2,15,0.510255,0.443079,0.006809,"#3bec00"
233583871,AgustinFloresV,7,0,3,3,0.515841,0.388976,0.000973,"#ffb800"
233613473,utopiagw,22,2,0,2,0.436463,0.612588,0.000486,"#00e8b2"
233636142,LiliEstupinanAc,38,0,1,1,0.308424,0.19423,0,"#662859"
233678953,ElBastdel95,21,0,1,1,0.179949,0.239582,0,"#c6cc85"
233731854,cesar_moheno,34,2,11,13,0.498593,0.432702,0.005837,"#ff0d69"
233802090,jzarateaguilar,31,0,1,1,0.758521,0.923308,0,"#3e93ff"
233805479,nacidaunviernes,55,0,1,1,0.614346,0.428702,0,"#cb3f32"
233904373,gemaesteve,0,0,1,1,0.426281,0.556933,0,"#8ecfec"
233912683,LolliPopnRoll,49,1,0,1,0.4119,0.680638,0,"#ff7007"
233951759,FabianAcunaC,38,0,1,1,0.536761,0.391755,0,"#662859"
234022429,claudia_carpio,19,0,1,1,0.646189,0.634288,0,"#00d3ff"
234070241,LuisHOlivera,19,1,0,1,0.667876,0.679298,0,"#00d3ff"
234220382,eme_pe,38,2,0,2,0.63618,0.645032,0.000486,"#662859"
234229423,barrosodiezz,17,0,1,1,0.808278,0.231368,0,"#ff9cc7"
234234865,elgabomx,13,0,5,5,0.48354,0.443362,0.001946,"#3bec00"
234246274,radiosofando,49,1,0,1,0.345667,0.606937,0,"#ff7007"
234283437,alexandracanet,14,9,2,11,0.594517,0.527605,0.004864,"#00eeff"
234326623,Reeditor_com,49,1,0,1,0.371431,0.70255,0,"#ff7007"
234359501,JulianoMejia,7,0,1,1,0.790525,0.633851,0,"#ffb800"
234385035,oscarequivelre,7,0,1,1,0.338532,0.36185,0,"#ffb800"
234452196,El_Estadista,49,1,0,1,0.413781,0.68891,0,"#ff7007"
234462288,MAlejTo,49,0,3,3,0.732267,0.754948,0.000973,"#ff7007"
234475505,carilavada,38,0,1,1,0.325732,0.187737,0,"#662859"
234529505,Tosgriju,1,0,1,1,0.428339,0.636263,0,"#b6cb00"
234630992,aquisertmucho,38,0,1,1,0.307998,0.163479,0,"#662859"
234631196,QQQQRRRROOOO,13,0,2,2,0.371632,0.455442,0.000486,"#3bec00"
234671493,nkivilcimyavuz,41,0,1,1,0.381412,0.402842,0,"#697b00"
234690778,Juan_Ll1,22,0,1,1,0.376298,0.594564,0,"#00e8b2"
234785771,Voz_Estudiantil,49,1,0,1,0.42822,0.674338,0,"#ff7007"
234801531,Klaudiagglez,14,0,2,2,0.528378,0.587821,0.000486,"#00eeff"
234827036,nereatts,31,2,0,2,0.537551,0.684472,0.000486,"#3e93ff"
234827436,andreshax,21,0,2,2,0.206391,0.2123,0.000486,"#c6cc85"
234847173,gustavo_tyn,49,1,0,1,0.360361,0.610596,0,"#ff7007"
234911507,maymonides,14,0,6,6,0.545548,0.380284,0.002432,"#00eeff"
235115302,marcpeig_,14,0,2,2,0.538766,0.507364,0.000486,"#00eeff"
235162264,stgocultura,21,0,2,2,0.224743,0.247521,0.000486,"#c6cc85"
235192379,lasalleorg,30,1,1,2,0.590816,0.665172,0.000486,"#ff77ff"
235232731,aquinisima,49,0,5,5,0.515835,0.578234,0.001946,"#ff7007"
235249931,gemmalluch,14,0,2,2,0.56601,0.478081,0.000486,"#00eeff"
235261861,rstudio,36,4,0,4,0.444678,0.437194,0.001459,"#825403"
235269347,mocatcal,37,10,5,15,0.469915,0.366872,0.006809,"#006032"
235292598,abyectos,7,0,3,3,0.47303,0.483747,0.000973,"#ffb800"
235341003,davidamichelson,14,0,2,2,0.560883,0.494804,0.000486,"#00eeff"
235406256,soluterionte,49,1,0,1,0.342446,0.657466,0,"#ff7007"
235509711,euwikipedia,22,1,0,1,0.617282,0.946179,0,"#00e8b2"
235531566,imaniwadud,34,0,4,4,0.470042,0.447821,0.001459,"#ff0d69"
235605731,cbarruetex,21,0,1,1,0.173049,0.227686,0,"#c6cc85"
235680320,pepacana,40,0,1,1,0.610923,0.01211,0,"#ff12a3"
235788291,AAparicioDeN,38,0,5,5,0.491253,0.467148,0.001946,"#662859"
235952612,queondashei,10,0,1,1,0.347006,0.504053,0,"#52d7c0"
236097971,Rednaki,14,0,1,1,0.668781,0.498969,0,"#00eeff"
236314953,Condesadedia,22,0,1,1,0.516543,0.683053,0,"#00e8b2"
236332897,juanpiorange,49,1,0,1,0.383934,0.623803,0,"#ff7007"
236424217,_odc,22,1,0,1,0.511437,0.673847,0,"#00e8b2"
236483222,juanmunguia,0,1,0,1,0.367334,0.572033,0,"#8ecfec"
236509959,Ladysupertramp,19,0,6,6,0.641195,0.752838,0.002432,"#00d3ff"
236533688,stonca01,13,0,2,2,0.42816,0.458943,0.000486,"#3bec00"
236580539,TooboringStay,49,0,4,4,0.495621,0.606093,0.001459,"#ff7007"
236602067,elsoldepuebla1,49,1,0,1,0.334803,0.686151,0,"#ff7007"
236624354,FTelefonicaMX,0,6,0,6,0.38522,0.557526,0.002432,"#8ecfec"
236679973,VforVianetta,13,0,1,1,0.51879,0.316306,0,"#3bec00"
236763232,leconomic,8,5,0,5,0.653974,0.312851,0.001946,"#00ed5d"
236769859,portcc,36,1,0,1,0.590853,0.426384,0,"#825403"
236804558,jprdelgado,2,1,1,2,0.644671,0.661308,0.000486,"#ffa64e"
236841182,JavierAyllon,15,0,1,1,0.578854,0.689572,0,"#008ebb"
237029616,veronica__more,3,0,3,3,0.479308,0.602234,0.000973,"#ffb3ff"
237064206,DannyBaVel,3,0,2,2,0.466719,0.584394,0.000486,"#ffb3ff"
237281086,NulanFCEyS,49,1,1,2,0.918925,0.255822,0.000486,"#ff7007"
237314529,josvale777,13,0,2,2,0.399142,0.435576,0.000486,"#3bec00"
237346881,nodocultura,31,2,2,4,0.477157,0.572585,0.001459,"#3e93ff"
237348098,unipotsdam,49,2,0,2,0.443828,0.480019,0.000486,"#ff7007"
237434844,SPGG_RS,36,0,1,1,0.566673,0.248042,0,"#825403"
237457233,Zumo_de_frutas,49,1,0,1,0.305234,0.676606,0,"#ff7007"
237565009,bentaco,13,0,3,3,0.409988,0.394381,0.000973,"#3bec00"
237605449,clonopio,13,0,1,1,0.428407,0.422075,0,"#3bec00"
237622139,angelesBBAA,31,1,0,1,0.635671,0.49072,0,"#3e93ff"
237694164,Murdockmaiz,22,0,1,1,0.571588,0.601928,0,"#00e8b2"
237803388,unedbarbastro,30,1,0,1,0.541771,0.660856,0,"#ff77ff"
237871753,jotaelecruz,49,1,0,1,0.380107,0.640045,0,"#ff7007"
237901719,MurrFuga,13,3,3,6,0.508785,0.430901,0.002432,"#3bec00"
237902760,pmuinos,55,1,1,2,0.605055,0.544863,0.000486,"#cb3f32"
238056242,emre_ozmen,13,0,1,1,0.39043,0.500983,0,"#3bec00"
238066344,IRCVM,22,3,3,6,0.520493,0.636696,0.002432,"#00e8b2"
238071345,RafanoMarquez,49,1,0,1,0.41439,0.65612,0,"#ff7007"
238122756,eboyanoalo,14,0,1,1,0.490018,0.581128,0,"#00eeff"
238214682,tvunam,13,3,0,3,0.507525,0.515318,0.000973,"#3bec00"
238234179,moreajr,31,0,2,2,0.535516,0.499936,0.000486,"#3e93ff"
238253188,igalina,13,162,33,195,0.502908,0.476918,0.094358,"#3bec00"
238533832,inesdelcast,15,0,2,2,0.586661,0.608985,0.000486,"#008ebb"
238654146,empleadapublica,21,0,2,2,0.261408,0.244631,0.000486,"#c6cc85"
238673302,Vmartinz71,31,0,3,3,0.586999,0.467279,0.000973,"#3e93ff"
238847633,graboispedro,36,0,1,1,0.479738,0.212055,0,"#825403"
239045311,mariaeg242,19,0,1,1,0.644967,0.790158,0,"#00d3ff"
239046450,MELUS_Society,35,4,0,4,0.439061,0.460518,0.001459,"#00faff"
239062625,juancarlosclara,49,1,0,1,0.399167,0.632102,0,"#ff7007"
239091569,rafaminer,2,0,2,2,0.453049,0.533526,0.000486,"#ffa64e"
239155355,manucamuller,36,0,1,1,0.546332,0.232153,0,"#825403"
239210275,MarfCarf,21,0,1,1,0.191985,0.218054,0,"#c6cc85"
239217798,gelenir,49,1,0,1,0.37035,0.705011,0,"#ff7007"
239244269,llaullipoma,31,0,5,5,0.574218,0.333186,0.001946,"#3e93ff"
239320162,reis_alexandre,36,0,1,1,0.520043,0.33494,0,"#825403"
239356646,Calfuman1,8,0,1,1,0.504587,0.802169,0,"#00ed5d"
239357978,infouex,30,12,0,12,0.576273,0.594672,0.00535,"#ff77ff"
239488786,GerardEncabo,49,1,0,1,0.369188,0.68972,0,"#ff7007"
239608780,felixbahon,13,0,1,1,0.425718,0.40596,0,"#3bec00"
239628609,jjassol,7,0,2,2,0.375728,0.360307,0.000486,"#ffb800"
239635837,ArnoldLeonSa,34,0,1,1,0.610307,0.395438,0,"#ff0d69"
239831900,anamarinosa,30,2,1,3,0.466461,0.735879,0.000973,"#ff77ff"
239846241,suarez_juanluis,13,25,9,34,0.546087,0.49165,0.016051,"#3bec00"
239852483,denishrios,17,0,1,1,0.812918,0.236658,0,"#ff9cc7"
240012302,elravignani,49,13,8,21,0.366004,0.533716,0.009728,"#ff7007"
240100680,santiagoprofdr,38,0,1,1,0.534126,0.369775,0,"#662859"
240144758,ojanespelt,22,0,1,1,0.578787,0.627473,0,"#00e8b2"
240205118,lusiettados,31,1,5,6,0.594456,0.530977,0.002432,"#3e93ff"
240359738,TeresaDelgadoS,22,0,3,3,0.494606,0.639776,0.000973,"#00e8b2"
240393857,CorferiasBogota,9,1,1,2,0.712926,0.608286,0.000486,"#008f7b"
240405634,ilihutsy,34,0,4,4,0.46015,0.434567,0.001459,"#ff0d69"
240410210,aprendizbennet,31,0,2,2,0.60987,0.513097,0.000486,"#3e93ff"
240481298,horroris,49,1,0,1,0.398807,0.689215,0,"#ff7007"
240523553,MJ_Inos,21,0,2,2,0.248114,0.223044,0.000486,"#c6cc85"
240550842,zariacim,7,0,1,1,0.836926,0.546804,0,"#ffb800"
240631660,MyriamHT,31,0,7,7,0.579707,0.519329,0.002918,"#3e93ff"
240669823,Alfiemamelas,13,0,1,1,0.423017,0.427198,0,"#3bec00"
240753052,bilbao_udala,18,2,0,2,0.751477,0.639276,0.000486,"#5456a6"
240803202,GeoPUCV,37,1,0,1,0.698383,0.289903,0,"#006032"
240814476,Nieve111,49,1,0,1,0.343406,0.624508,0,"#ff7007"
240818804,SitesConscience,38,1,0,1,0.542359,0.363454,0,"#662859"
240836165,rrii_fccee_ugr,49,1,0,1,0.374813,0.696405,0,"#ff7007"
240867878,eduardboada,14,0,1,1,0.270918,0.574046,0,"#00eeff"
240873128,L0laya,38,0,1,1,0.57058,0.463002,0,"#662859"
240906479,Xiomara_Araujo,34,0,1,1,0.5475,0.33245,0,"#ff0d69"
240918302,IkerP54,13,0,6,6,0.54058,0.420306,0.002432,"#3bec00"
241054908,jitt_guide,36,2,0,2,0.582344,0.424112,0.000486,"#825403"
241079136,CARTO,55,2,0,2,0.571574,0.558318,0.000486,"#cb3f32"
241116398,DaliaGuerreiro,36,60,59,119,0.526488,0.476815,0.057393,"#825403"
241145916,Gloriafm1,22,0,3,3,0.536696,0.603936,0.000973,"#00e8b2"
241148344,cclivaz,36,0,1,1,0.422618,0.58819,0,"#825403"
241159729,mabelvillaescus,3,1,1,2,0.722736,0.601722,0.000486,"#ffb3ff"
241177941,udesc_faed,49,1,0,1,0.536481,0.374608,0,"#ff7007"
241191056,UPFBarcelona,22,6,0,6,0.582348,0.58172,0.002432,"#00e8b2"
241192205,CANAL44TV,3,4,1,5,0.487143,0.671017,0.001946,"#ffb3ff"
241304293,Jesricardo07,38,1,0,1,0.423567,0.157922,0,"#662859"
241311642,elfitash,22,0,1,1,0.586268,0.691258,0,"#00e8b2"
241496609,dvilasuero,22,3,2,5,0.571902,0.638147,0.001946,"#00e8b2"
241600244,jpescamez,16,0,3,3,0.921913,0.67556,0.000973,"#c42c63"
241615872,covadongaporrua,0,3,0,3,0.911372,0.706632,0.000973,"#8ecfec"
241685105,macrossssss,37,0,1,1,0.446004,0.613338,0,"#006032"
241856872,jttorres1,31,0,1,1,0.632529,0.514551,0,"#3e93ff"
241873745,Mirroque,36,5,4,9,0.54407,0.472195,0.003891,"#825403"
241915390,mrcbueno,36,0,1,1,0.517833,0.265783,0,"#825403"
241967006,ian_sparky,13,1,0,1,0.537371,0.411606,0,"#3bec00"
241984387,enriccanela,8,10,10,20,0.659298,0.331616,0.009241,"#00ed5d"
242006989,reddish2,21,0,1,1,0.019201,0.643709,0,"#c6cc85"
242131701,abichuelix,41,1,0,1,0.389281,0.388577,0,"#697b00"
242227332,cheersjyj,36,0,1,1,0.428433,0.590227,0,"#825403"
242311942,ferpeirano,49,1,0,1,0.367917,0.613199,0,"#ff7007"
242343224,educaciongob,30,6,0,6,0.551793,0.49224,0.002432,"#ff77ff"
242346649,jivargase,1,0,3,3,0.65345,0.482224,0.000973,"#b6cb00"
242376556,dapetiteri,22,0,1,1,0.371579,0.600327,0,"#00e8b2"
242410169,lmrhody,34,4,9,13,0.453758,0.423855,0.005837,"#ff0d69"
242469598,VictoRiosq,3,0,3,3,0.476816,0.696409,0.000973,"#ffb3ff"
242549712,elisaarmendariz,49,1,0,1,0.312363,0.628591,0,"#ff7007"
242556878,mahvillegas,5,0,1,1,0.634953,0.294621,0,"#b2dd44"
242580194,oxitobrands,3,0,1,1,0.454257,0.658092,0,"#ffb3ff"
242623138,Patricia_Patron,7,0,1,1,0.82575,0.543936,0,"#ffb800"
242665621,FundacionMalaga,14,2,2,4,0.596788,0.47978,0.001459,"#00eeff"
242677985,yyansays,22,0,1,1,0.650899,0.407018,0,"#00e8b2"
242702347,mvinet_a,21,0,1,1,0.219223,0.21227,0,"#c6cc85"
242722764,CristinaArroniz,49,1,0,1,0.319068,0.689045,0,"#ff7007"
242737903,soniulis,22,0,1,1,0.713001,0.616032,0,"#00e8b2"
242751849,entreotrasideas,15,2,2,4,0.476416,0.674867,0.001459,"#008ebb"
242804983,patriciaydalgo,2,0,2,2,0.473493,0.629297,0.000486,"#ffa64e"
242821538,lectordebarthes,31,3,4,7,0.571561,0.533553,0.002918,"#3e93ff"
242850608,soniascheuren,42,0,2,2,0.697169,0.43148,0.000486,"#66e087"
242865161,Orionfelson,30,2,0,2,0.529841,0.487682,0.000486,"#ff77ff"
242886677,Ibanezgp,30,0,1,1,0.602718,0.672646,0,"#ff77ff"
242962661,nubesdepalabras,30,0,1,1,0.497397,0.630792,0,"#ff77ff"
242969111,ardakissoyan,49,1,0,1,0.377194,0.687652,0,"#ff7007"
243029876,LauraIsabelHP,13,0,2,2,0.478227,0.359733,0.000486,"#3bec00"
243097480,saloensenyament,8,4,1,5,0.619684,0.421564,0.001946,"#00ed5d"
243098241,salofutura,8,2,0,2,0.685452,0.320869,0.000486,"#00ed5d"
243098744,ssfibla,30,0,1,1,0.426523,0.698216,0,"#ff77ff"
243173962,MEpublicaciones,49,1,0,1,0.281516,0.61482,0,"#ff7007"
243184568,magarli,22,0,2,2,0.61182,0.503234,0.000486,"#00e8b2"
243227030,Jose_A_Alonso,22,0,2,2,0.416786,0.505722,0.000486,"#00e8b2"
243305866,Shodako,49,0,1,1,0.340849,0.560316,0,"#ff7007"
243316295,jsmartos,31,0,2,2,0.640349,0.545786,0.000486,"#3e93ff"
243359278,crisreboso,1,0,2,2,0.467855,0.707227,0.000486,"#b6cb00"
243364477,FabrizioDelDong,22,0,1,1,0.572593,0.624644,0,"#00e8b2"
243372020,caanalri95,35,5,6,11,0.552277,0.471139,0.004864,"#00faff"
243381107,GooglePlay,55,3,0,3,0.550363,0.549437,0.000973,"#cb3f32"
243397501,albarpinto,13,0,1,1,0.46811,0.23951,0,"#3bec00"
243489462,Nadez_C,14,0,2,2,0.422681,0.535973,0.000486,"#00eeff"
243530353,UExDivulga,19,1,0,1,0.622341,0.704722,0,"#00d3ff"
243546672,SIGMA_AIE,30,0,1,1,0.505532,0.657565,0,"#ff77ff"
243549234,CemedUGR,31,3,0,3,0.700665,0.533225,0.000973,"#3e93ff"
243585004,JuanPastorBus,31,4,1,5,0.680893,0.559812,0.001946,"#3e93ff"
243608028,JotDownSpain,2,1,0,1,0.750951,0.615063,0,"#ffa64e"
243649793,louisefalcini,34,0,2,2,0.461775,0.411431,0.000486,"#ff0d69"
243749650,nuevoabolengo,58,0,2,2,0.607985,0.297895,0.000486,"#005076"
243763595,smunozroncero,14,0,3,3,0.585636,0.590194,0.000973,"#00eeff"
243770181,PUMAGUA,7,0,1,1,0.640296,0.373795,0,"#ffb800"
243770388,LiteraturaUNAM,7,2,0,2,0.430351,0.328109,0.000486,"#ffb800"
243785339,PalomaCuenca,22,2,2,4,0.517944,0.732963,0.001459,"#00e8b2"
243807141,Xabi207,4,0,4,4,0.930054,0.245089,0.001459,"#f4c8cf"
243810702,VarelaRakel,22,0,1,1,0.654786,0.405027,0,"#00e8b2"
244006029,sergseb,30,1,0,1,0.575658,0.642829,0,"#ff77ff"
244024817,mo1ina,37,1,0,1,0.703864,0.502383,0,"#006032"
244102858,mdmartos,14,7,0,7,0.526318,0.53323,0.002918,"#00eeff"
244111483,karl_moz,0,0,2,2,0.353688,0.589306,0.000486,"#8ecfec"
244157742,ctschroeder,36,2,1,3,0.422141,0.386218,0.000973,"#825403"
244170872,blabalade,14,0,3,3,0.670817,0.507695,0.000973,"#00eeff"
244200244,crcodina,15,0,3,3,0.576933,0.538273,0.000973,"#008ebb"
244206716,geofumadas,55,1,1,2,0.58638,0.493402,0.000486,"#cb3f32"
244241836,_herstoriaan,7,0,1,1,0.404392,0.315879,0,"#ffb800"
244248019,jbolmarcich,13,0,2,2,0.461785,0.407569,0.000486,"#3bec00"
244251469,mj77mu,30,3,0,3,0.53573,0.592355,0.000973,"#ff77ff"
244258275,REMMY_ROMAN,7,0,1,1,0.408677,0.301069,0,"#ffb800"
244311817,infoling,49,17,0,17,0.476111,0.598686,0.007782,"#ff7007"
244328658,pescaditarroyo,7,0,1,1,0.353591,0.361003,0,"#ffb800"
244339432,mgmglobal,7,0,1,1,0.374547,0.352959,0,"#ffb800"
244371808,Zjbb,49,0,3,3,0.440075,0.404497,0.000973,"#ff7007"
244445859,llnoguera,14,0,1,1,0.700625,0.456373,0,"#00eeff"
244452650,efustero,49,1,0,1,0.36711,0.653588,0,"#ff7007"
244459746,alizardx,49,0,6,6,0.446023,0.536388,0.002432,"#ff7007"
244584238,AgendaLiteraria,49,1,0,1,0.311915,0.654775,0,"#ff7007"
244585083,zuperpike,40,0,1,1,0.597534,0.007509,0,"#ff12a3"
244634363,jmgarciavazquez,58,0,1,1,0.659338,0.684615,0,"#005076"
244688753,elisahergueta,22,2,3,5,0.506807,0.685159,0.001946,"#00e8b2"
244703684,julianacreativa,49,1,0,1,0.30613,0.605501,0,"#ff7007"
244710262,paitooperdomo,3,0,1,1,0.839986,0.74578,0,"#ffb3ff"
244862989,elesaura,30,0,3,3,0.509441,0.588346,0.000973,"#ff77ff"
244893364,RafaRValdes,22,0,2,2,0.662901,0.677161,0.000486,"#00e8b2"
244925950,culturaula,42,0,7,7,0.752691,0.439752,0.002918,"#66e087"
245012645,montsemurianor,14,0,6,6,0.525133,0.527211,0.002432,"#00eeff"
245079892,LUCIATELLODIAZ,14,11,2,13,0.397713,0.540459,0.005837,"#00eeff"
245096772,miquelessomba,8,1,0,1,0.646837,0.251045,0,"#00ed5d"
245125563,avalderruten,14,0,1,1,0.610855,0.498823,0,"#00eeff"
245141415,MissAkathisia,38,0,1,1,0.547888,0.315451,0,"#662859"
245153343,AlonsoRaya_,49,1,0,1,0.341543,0.622219,0,"#ff7007"
245275687,jucagm,38,1,4,5,0.504973,0.585385,0.001946,"#662859"
245309351,alem1954,19,0,2,2,0.625528,0.66202,0.000486,"#00d3ff"
245326439,anarpacheco,30,1,13,14,0.499334,0.566103,0.006323,"#ff77ff"
245326471,bibhumeli,30,0,1,1,0.526609,0.619805,0,"#ff77ff"
245376824,Aon_Espana,30,2,2,4,0.519488,0.585608,0.001459,"#ff77ff"
245398538,jlandaverd,34,1,2,3,0.49348,0.50152,0.000973,"#ff0d69"
245405126,lumicaso,3,0,1,1,0.455228,0.746237,0,"#ffb3ff"
245413049,CatedraAR,10,29,3,32,0.436892,0.505488,0.015078,"#52d7c0"
245449406,ceiich_unam,7,0,1,1,0.398103,0.731589,0,"#ffb800"
245500748,ArqueoRojo,38,0,2,2,0.69283,0.590874,0.000486,"#662859"
245660654,Lfmroldan,21,0,5,5,0.601876,0.208884,0.001946,"#c6cc85"
245727361,bibliounizar,22,0,2,2,0.464492,0.634304,0.000486,"#00e8b2"
245737269,nicolapolloni,19,1,0,1,0.700788,0.562068,0,"#00d3ff"
245741737,montsegorchsm,22,0,1,1,0.60696,0.610754,0,"#00e8b2"
245768250,retuiqueen,38,0,1,1,0.065951,0.43539,0,"#662859"
245798822,tustovsky,37,0,1,1,0.285618,0.472271,0,"#006032"
245820777,NetApp_es,49,1,0,1,0.318654,0.631508,0,"#ff7007"
245851957,ftorres2706,38,0,2,2,0.565822,0.435326,0.000486,"#662859"
245913450,CDCHTA,42,1,3,4,0.937719,0.412909,0.001459,"#66e087"
245917381,emiliocanod,14,6,3,9,0.517617,0.592919,0.003891,"#00eeff"
245941316,JosepBargallo,8,1,0,1,0.67634,0.253467,0,"#00ed5d"
245974070,vrupu,40,0,2,2,0.100484,0.40693,0.000486,"#ff12a3"
245981058,tecnoloxiajorge,49,1,0,1,0.342407,0.67473,0,"#ff7007"
246009942,Clersus_,14,0,2,2,0.56426,0.51202,0.000486,"#00eeff"
246053325,usuario_twi,13,0,2,2,0.421532,0.405219,0.000486,"#3bec00"
246100302,monsefernandezv,31,0,1,1,0.608777,0.718787,0,"#3e93ff"
246113535,librocrepusculo,34,0,2,2,0.481984,0.368672,0.000486,"#ff0d69"
246219770,euriborempleo,49,2,0,2,0.412393,0.622497,0.000486,"#ff7007"
246340119,Rogerioarqueo,36,0,3,3,0.499443,0.346268,0.000973,"#825403"
246369119,VICENTXAVIER,30,0,1,1,0.693545,0.610173,0,"#ff77ff"
246376418,sercanesp,14,0,3,3,0.526128,0.513731,0.000973,"#00eeff"
246406098,Desinformemonos,47,6,0,6,0.57281,0.253749,0.002432,"#a091c4"
246412003,cfievalladolid,2,19,3,22,0.640111,0.443941,0.010214,"#ffa64e"
246479683,montseguitert,31,0,1,1,0.640415,0.498386,0,"#3e93ff"
246582321,leonelaraiza,35,0,1,1,0.357667,0.535934,0,"#00faff"
246629511,JaviCruche,14,4,1,5,0.548503,0.512245,0.001946,"#00eeff"
246717099,DdVilella,3,0,3,3,0.526081,0.590452,0.000973,"#ffb3ff"
246720396,Edicirculorojo,30,2,0,2,0.56209,0.654559,0.000486,"#ff77ff"
246751440,empleo_idi,2,0,1,1,0.646622,0.728408,0,"#ffa64e"
246770071,Juliorbis,14,0,1,1,0.628973,0.600457,0,"#00eeff"
246835890,LocosxBecas,1,2,0,2,0.406456,0.538582,0.000486,"#b6cb00"
246867643,FIUPM,31,0,13,13,0.563867,0.560852,0.005837,"#3e93ff"
246911714,PMProuk,49,0,1,1,0.339011,0.32278,0,"#ff7007"
246933613,Faith_S_Harden,13,0,1,1,0.38672,0.439746,0,"#3bec00"
246966216,RedUNIRED,29,8,0,8,0.3825,0.226793,0.003405,"#1fab00"
246974122,mograempire,49,1,0,1,0.332276,0.607754,0,"#ff7007"
246989480,valemejiasz,38,0,1,1,0.114224,0.814042,0,"#662859"
247064887,luisge7,38,0,4,4,0.449351,0.354107,0.001459,"#662859"
247139482,Organizadatos,19,0,2,2,0.595081,0.489541,0.000486,"#00d3ff"
247370192,unstablearchive,13,25,13,38,0.48375,0.464276,0.017996,"#3bec00"
247430796,isagranada,31,0,5,5,0.605053,0.533533,0.001946,"#3e93ff"
247446447,UMichLibrary,49,2,1,3,0.433322,0.580341,0.000973,"#ff7007"
247461859,isaiaspenag,38,0,3,3,0.523489,0.439984,0.000973,"#662859"
247491996,mplheredia,14,0,1,1,0.718648,0.51051,0,"#00eeff"
247511562,MeryChV,38,0,1,1,0.410082,0.380335,0,"#662859"
247521457,barb_rivera,49,8,21,29,0.443765,0.497972,0.013619,"#ff7007"
247541496,paqui123,23,0,2,2,0.187452,0.498215,0.000486,"#005455"
247594540,quadrismegistus,49,1,2,3,0.441508,0.520932,0.000973,"#ff7007"
247705940,manelmarquez,19,0,2,2,0.625538,0.642565,0.000486,"#00d3ff"
247818403,Mariane1524,29,0,1,1,0.351365,0.154954,0,"#1fab00"
247837515,ralonsoreyes,43,0,3,3,0.756762,0.541419,0.000973,"#fcae7e"
247914216,candy68,0,0,1,1,0.314012,0.572774,0,"#8ecfec"
247989648,ElPibeFaulkner,49,1,0,1,0.274642,0.549076,0,"#ff7007"
248160076,MiquiOtero,0,1,1,2,0.458262,0.601986,0.000486,"#8ecfec"
248187309,Simmbad2,14,2,0,2,0.722538,0.568927,0.000486,"#00eeff"
248338509,merismith10,14,0,3,3,0.461746,0.543773,0.000973,"#00eeff"
248378892,andreusuleduesa,22,7,0,7,0.568298,0.569919,0.002918,"#00e8b2"
248405561,sennateixeira,36,1,1,2,0.4803,0.320657,0.000486,"#825403"
248406236,VICTORIAGR24,3,0,1,1,0.46869,0.769267,0,"#ffb3ff"
248526629,EduardoBarrios_,13,0,1,1,0.426224,0.417126,0,"#3bec00"
248580251,pcusal,58,0,1,1,0.229558,0.518602,0,"#005076"
248631775,aranchaserantes,55,43,43,86,0.563579,0.535423,0.041342,"#cb3f32"
248654466,nicanorjc,30,0,1,1,0.513741,0.614919,0,"#ff77ff"
248724562,josemagalan6,37,0,2,2,0.679804,0.355142,0.000486,"#006032"
248726890,Miralonatural9,30,0,1,1,0.61562,0.481551,0,"#ff77ff"
248809120,crazzymath,22,0,1,1,0.387687,0.596043,0,"#00e8b2"
248854474,MJGarciaFolgado,1,0,10,10,0.495217,0.574092,0.004377,"#b6cb00"
248965136,googlearts,13,2,0,2,0.492048,0.580813,0.000486,"#3bec00"
249005175,hekglez,49,1,0,1,0.362428,0.704981,0,"#ff7007"
249007164,digital2011b,13,1,35,36,0.487312,0.510455,0.017023,"#3bec00"
249019070,MathiasIIJ,13,0,1,1,0.356,0.385726,0,"#3bec00"
249020331,BWDarligUlv,13,1,16,17,0.507851,0.448507,0.007782,"#3bec00"
249065273,scinoptica,13,0,1,1,0.496034,0.369117,0,"#3bec00"
249220120,balabinnovacion,49,0,8,8,0.456819,0.582076,0.003405,"#ff7007"
249272537,lmoncampos,31,0,1,1,0.698329,0.545182,0,"#3e93ff"
249275021,FIUNAM_MX,7,0,1,1,0.634145,0.371724,0,"#ffb800"
249307945,iiydugr,22,0,2,2,0.520293,0.698909,0.000486,"#00e8b2"
249332376,mariano_ure,3,1,0,1,0.43252,0.74139,0,"#ffb3ff"
249475327,rgluisalfonso,30,1,19,20,0.518465,0.551988,0.009241,"#ff77ff"
249560970,MariaSolerSala,13,0,1,1,0.526275,0.45963,0,"#3bec00"
249574429,PepaGOliva,31,0,3,3,0.56065,0.605859,0.000973,"#3e93ff"
249574942,PaulinoVallejo,22,1,1,2,0.544528,0.61337,0.000486,"#00e8b2"
249592951,yanezmr,7,0,2,2,0.387735,0.350419,0.000486,"#ffb800"
249665665,kamchatkagara,40,0,1,1,0.629488,0.052609,0,"#ff12a3"
249685646,MJesusTarrat,0,0,1,1,0.423044,0.6026,0,"#8ecfec"
249748466,nova_fcsh,36,15,3,18,0.526987,0.463998,0.008268,"#825403"
249774990,Escarimbagaro,13,0,2,2,0.434965,0.473532,0.000486,"#3bec00"
249868717,DianaAsturiana,22,1,0,1,0.622656,0.690676,0,"#00e8b2"
249973139,DaniVeiraF,55,0,5,5,0.568608,0.48838,0.001946,"#cb3f32"
250002667,gonzaleztejeda,58,0,2,2,0.594861,0.306973,0.000486,"#005076"
250003806,therpez,0,0,2,2,0.570869,0.647602,0.000486,"#8ecfec"
250035743,mabelrupe,30,0,1,1,0.59203,0.657961,0,"#ff77ff"
250051868,gimenez_cong,8,5,1,6,0.695799,0.413759,0.002432,"#00ed5d"
250065028,anacuquerella,22,14,4,18,0.577082,0.521244,0.008268,"#00e8b2"
250109006,fundacionava,31,0,1,1,0.660083,0.565959,0,"#3e93ff"
250144104,dimebarcelona,1,0,1,1,0.438132,0.794949,0,"#b6cb00"
250211022,separdoc,7,0,1,1,0.376678,0.409828,0,"#ffb800"
250215833,mono_pensante,22,2,4,6,0.62366,0.485825,0.002432,"#00e8b2"
250253685,Nino_Mundaca,21,0,2,2,0.189497,0.259185,0.000486,"#c6cc85"
250339392,EvelyneJardin,36,0,2,2,0.432086,0.479216,0.000486,"#825403"
250349674,alejandraRR_,31,3,3,6,0.55664,0.551404,0.002432,"#3e93ff"
250387200,aga_mun,2,0,6,6,0.600764,0.561012,0.002432,"#ffa64e"
250530184,anamaesobr,31,0,3,3,0.57758,0.470246,0.000973,"#3e93ff"
250535644,mmmmmmpc,22,0,1,1,0.230072,0.689104,0,"#00e8b2"
250558059,Mareike2405,13,0,1,1,0.434067,0.517024,0,"#3bec00"
250573376,dbuendiac,31,0,1,1,0.59327,0.476877,0,"#3e93ff"
250623441,arteupo,1,8,4,12,0.571209,0.562041,0.00535,"#b6cb00"
250655439,ACuboC,58,0,2,2,0.613434,0.300349,0.000486,"#005076"
250715174,juanmeriguetm,49,1,0,1,0.382308,0.662222,0,"#ff7007"
250739724,Crisloo5,58,0,1,1,0.462446,0.638095,0,"#005076"
250774883,loverofclio,30,0,1,1,0.70739,0.606007,0,"#ff77ff"
250809048,LopezVillaverde,19,1,6,7,0.616332,0.702278,0.002918,"#00d3ff"
250823815,RaRaRaEditores,0,0,1,1,0.662753,0.630914,0,"#8ecfec"
251044879,A_MERELO,1,0,2,2,0.511625,0.786316,0.000486,"#b6cb00"
251208154,josefmerino,58,0,1,1,0.438197,0.637411,0,"#005076"
251242833,davidjl95,58,0,2,2,0.595837,0.294151,0.000486,"#005076"
251284441,eldiarioinforma,22,0,1,1,0.714608,0.356975,0,"#00e8b2"
251289264,FedericoJovine,49,1,0,1,0.322033,0.656991,0,"#ff7007"
251326344,OtherAle,34,0,1,1,0.392473,0.462538,0,"#ff0d69"
251386846,jflopezct,2,0,1,1,0.685024,0.679376,0,"#ffa64e"
251394188,jgtorremolinos,49,1,0,1,0.320969,0.670784,0,"#ff7007"
251676365,Zifarestevez,31,0,4,4,0.545738,0.563918,0.001459,"#3e93ff"
251699535,cibertecaria,49,2,3,5,0.421395,0.531461,0.001946,"#ff7007"
251705046,fc_conesa,4,2,0,2,0.552287,0.690446,0.000486,"#f4c8cf"
251752944,rmunozmansilla,30,0,3,3,0.532384,0.588996,0.000973,"#ff77ff"
251833636,Tom_Arctus,3,0,1,1,0.469385,0.759795,0,"#ffb3ff"
251855271,SOSCarabanchel,19,6,2,8,0.583716,0.649916,0.003405,"#00d3ff"
251873217,revbiolmar,49,0,1,1,0.33389,0.481652,0,"#ff7007"
252125904,ajalexadri,1,0,2,2,0.658193,0.44259,0.000486,"#b6cb00"
252134272,CanalCapital,38,1,0,1,0.604406,0.3542,0,"#662859"
252160277,CNDH,49,1,0,1,0.358324,0.65623,0,"#ff7007"
252183691,chayoborrero,38,0,1,1,0.640348,0.60825,0,"#662859"
252317961,albadeamerica,13,0,2,2,0.531125,0.444871,0.000486,"#3bec00"
252449010,Dirugu,34,0,4,4,0.505355,0.457948,0.001459,"#ff0d69"
252546355,cmmmlg,31,0,2,2,0.613821,0.541814,0.000486,"#3e93ff"
252578994,lujangp,22,0,1,1,0.545669,0.682307,0,"#00e8b2"
252688382,j_a_cascos,18,0,3,3,0.405266,0.763154,0.000973,"#5456a6"
252694859,alanhermoset,7,0,2,2,0.430956,0.340226,0.000486,"#ffb800"
252715855,pflama,13,2,0,2,0.464567,0.410227,0.000486,"#3bec00"
252724327,AsociacionACAL,19,8,6,14,0.610367,0.549734,0.006323,"#00d3ff"
252781097,RICARDOALBERTO_,49,1,0,1,0.438608,0.685664,0,"#ff7007"
252805212,claudiaranjos,36,0,2,2,0.486435,0.23665,0.000486,"#825403"
252846667,Deninson_Angulo,38,0,1,1,0.175703,0.425049,0,"#662859"
252848690,OlgaLuCortes,13,0,6,6,0.592255,0.448364,0.002432,"#3bec00"
252882980,asovele,1,1,0,1,0.403103,0.704711,0,"#b6cb00"
252912120,mdcs87,34,14,61,75,0.472189,0.427198,0.035992,"#ff0d69"
252916288,rebarquera,7,0,2,2,0.45228,0.406339,0.000486,"#ffb800"
252972038,lagemmamas,22,0,1,1,0.612809,0.605192,0,"#00e8b2"
253012159,patri4x4,31,0,1,1,0.645101,0.506091,0,"#3e93ff"
253061056,jodas11,38,0,2,2,0.566192,0.447602,0.000486,"#662859"
253107450,e_c_miscellany,36,1,0,1,0.435363,0.295939,0,"#825403"
253144556,moniquitri,13,5,2,7,0.417703,0.452528,0.002918,"#3bec00"
253202067,arekun8000,13,0,2,2,0.518162,0.424998,0.000486,"#3bec00"
253213098,alisonfchapman,49,0,2,2,0.41089,0.508112,0.000486,"#ff7007"
253258079,historiaoralarg,36,2,0,2,0.551349,0.557494,0.000486,"#825403"
253261955,Andrs53102635,49,1,0,1,0.383275,0.646111,0,"#ff7007"
253261986,gagperiodista,44,0,1,1,0.964101,0.628893,0,"#6c241e"
253276820,CamiloMurciaG,38,3,11,14,0.487728,0.449711,0.006323,"#662859"
253340650,_JUAM_,49,0,2,2,0.420221,0.579952,0.000486,"#ff7007"
253414611,joaowi,36,0,3,3,0.494504,0.362043,0.000973,"#825403"
253434425,ProduccionesFC,49,1,0,1,0.37113,0.632483,0,"#ff7007"
253490462,Ivbayo,49,1,0,1,0.373344,0.664658,0,"#ff7007"
253504634,svallejovera,36,0,1,1,0.564664,0.291425,0,"#825403"
253541892,LiceusSL,49,18,5,23,0.493227,0.594829,0.0107,"#ff7007"
253557878,patatatai,14,0,1,1,0.58049,0.480241,0,"#00eeff"
253560712,carolinalechado,49,0,1,1,0.295478,0.306246,0,"#ff7007"
253571173,ComandoSB,49,1,0,1,0.341312,0.6895,0,"#ff7007"
253633089,zayek3000,49,1,0,1,0.291885,0.626084,0,"#ff7007"
253666280,vidalicio,45,0,2,2,0.674857,0.187104,0.000486,"#00e8ff"
253683163,TeresaLPellisa,14,14,6,20,0.587658,0.551653,0.009241,"#00eeff"
253686841,klingstadt,31,3,0,3,0.589283,0.605728,0.000973,"#3e93ff"
253768845,Jagospierre,30,0,1,1,0.609101,0.662555,0,"#ff77ff"
253809765,carolinaporras_,14,0,1,1,0.72899,0.52381,0,"#00eeff"
253865251,elikaortega,13,103,33,136,0.453687,0.48112,0.065661,"#3bec00"
253955945,Silvyamiga,0,2,2,4,0.416786,0.556435,0.001459,"#8ecfec"
254043467,terbolatzur,22,0,1,1,0.610017,0.599013,0,"#00e8b2"
254081060,cienciaplus,22,1,0,1,0.509265,0.680747,0,"#00e8b2"
254111888,irepolvera,22,0,3,3,0.582277,0.638444,0.000973,"#00e8b2"
254144118,CeDInCI,49,2,0,2,0.374685,0.587369,0.000486,"#ff7007"
254152921,angelessoletic,49,13,14,27,0.433518,0.54136,0.012646,"#ff7007"
254205241,RodolfoADP,15,0,1,1,0.558317,0.674421,0,"#008ebb"
254268566,LimaChely,31,3,1,4,0.547365,0.51641,0.001459,"#3e93ff"
254421887,maite_martin,30,2,6,8,0.479165,0.546917,0.003405,"#ff77ff"
254537665,tereaxe78,55,0,1,1,0.691268,0.690233,0,"#cb3f32"
254553602,xtianolive,2,16,0,16,0.676312,0.424627,0.007296,"#ffa64e"
254615487,egzu,1,0,2,2,0.662462,0.452285,0.000486,"#b6cb00"
254641726,Nornilandia,46,0,1,1,0.49203,0.149807,0,"#403538"
254793053,libropesia,14,20,48,68,0.50417,0.50551,0.032588,"#00eeff"
254817698,miunicanacion,49,1,0,1,0.342542,0.649209,0,"#ff7007"
254865613,AlexWermerColan,34,0,1,1,0.333167,0.430324,0,"#ff0d69"
255001254,DSHjournal,13,6,0,6,0.50938,0.459777,0.002432,"#3bec00"
255115521,Yambo_LSG,15,0,1,1,0.530641,0.679301,0,"#008ebb"
255139519,alesfe92,58,0,2,2,0.629915,0.397104,0.000486,"#005076"
255145256,ConcheiroL,13,3,0,3,0.512567,0.42976,0.000973,"#3bec00"
255171159,williamandolina,49,0,1,1,0.415571,0.719156,0,"#ff7007"
255182410,semiramis_glez,14,1,2,3,0.644864,0.527552,0.000973,"#00eeff"
255213300,sissimpm,7,0,1,1,0.385862,0.724095,0,"#ffb800"
255312054,kaohu11,13,0,1,1,0.38743,0.444682,0,"#3bec00"
255493070,LHistorica,30,38,9,47,0.631192,0.58337,0.022374,"#ff77ff"
255518434,DeVerdadDigital,49,1,0,1,0.416723,0.660447,0,"#ff7007"
255543371,irenebenegas,49,0,1,1,0.325747,0.572384,0,"#ff7007"
255609804,DeJaNMc,36,1,1,2,0.502647,0.340621,0.000486,"#825403"
255611202,UAM_Comunidad,13,1,1,2,0.369241,0.45501,0.000486,"#3bec00"
255681367,ianmilligan1,34,45,4,49,0.477167,0.474544,0.023346,"#ff0d69"
255704774,mtermens,22,0,5,5,0.600349,0.538066,0.001946,"#00e8b2"
255737940,rosmi54,30,0,2,2,0.542717,0.61748,0.000486,"#ff77ff"
255784266,geekwire,13,1,0,1,0.476207,0.640107,0,"#3bec00"
255831528,NicoleCubi,10,0,1,1,0.303463,0.399542,0,"#52d7c0"
255834669,melinsane,3,1,0,1,0.43557,0.642596,0,"#ffb3ff"
255952257,FICYT,22,4,2,6,0.489048,0.540228,0.002432,"#00e8b2"
255955176,ulrichtadajeu,30,1,0,1,0.535096,0.621897,0,"#ff77ff"
255955200,FProgresoysalud,22,2,1,3,0.639521,0.432995,0.000973,"#00e8b2"
255964870,DigitalCSIC,22,8,1,9,0.525085,0.545355,0.003891,"#00e8b2"
255979725,goliverg77,2,0,1,1,0.676898,0.384755,0,"#ffa64e"
256000290,Carlos_MolinerF,49,1,0,1,0.331566,0.677131,0,"#ff7007"
256041184,cristobalvega,42,0,1,1,0.919939,0.433726,0,"#66e087"
256061975,AlbertoVelaP,7,0,1,1,0.411793,0.206341,0,"#ffb800"
256062568,CarolinaProfe,21,0,1,1,0.196637,0.238675,0,"#c6cc85"
256089280,EducaRedPE,31,1,0,1,0.567653,0.252348,0,"#3e93ff"
256128069,UDGVirtual_SUV,13,6,1,7,0.474198,0.480084,0.002918,"#3bec00"
256173249,ula_tv,42,7,0,7,0.743304,0.463965,0.002918,"#66e087"
256185025,elenautica,42,0,1,1,0.714428,0.453258,0,"#66e087"
256218292,Juanfra_87,19,7,7,14,0.622259,0.713827,0.006323,"#00d3ff"
256226223,angelsimon_,30,9,0,9,0.463707,0.620816,0.003891,"#ff77ff"
256234747,Natz091,17,0,1,1,0.90832,0.369538,0,"#ff9cc7"
256265100,Gosha_Sans,13,0,4,4,0.46151,0.49058,0.001459,"#3bec00"
256268231,glo_ri_sa_,31,0,1,1,0.653988,0.553412,0,"#3e93ff"
256366872,TOLTECATLn,7,1,5,6,0.257812,0.411205,0.002432,"#ffb800"
256534249,Hovenduck,22,0,1,1,0.370936,0.595925,0,"#00e8b2"
256535671,UFLOuniversidad,49,1,0,1,0.283815,0.485219,0,"#ff7007"
256577185,xrubiocampillo,4,3,5,8,0.533955,0.59673,0.003405,"#f4c8cf"
256592553,kepasarasola,30,3,1,4,0.484149,0.523112,0.001459,"#ff77ff"
256593579,lcs_uaq,13,1,0,1,0.370728,0.484568,0,"#3bec00"
256605027,imaginarial,13,0,3,3,0.599308,0.527091,0.000973,"#3bec00"
256614452,GracielaGFG,22,0,1,1,0.705155,0.622958,0,"#00e8b2"
256690289,cparedesr,3,0,1,1,0.668959,0.70467,0,"#ffb3ff"
256693041,lylyflower2007,3,0,1,1,0.519652,0.761816,0,"#ffb3ff"
256734088,casalibroUANL,3,0,1,1,0.297314,0.599194,0,"#ffb3ff"
256911800,Lcasaux,40,0,2,2,0.084413,0.409201,0.000486,"#ff12a3"
256919155,ireandce,37,3,2,5,0.454943,0.512168,0.001946,"#006032"
256964884,buenosdiachaco,49,1,0,1,0.330969,0.619784,0,"#ff7007"
257038975,casahumanidades,7,44,19,63,0.437183,0.38076,0.030156,"#ffb800"
257047712,erimbau,49,1,0,1,0.359914,0.692381,0,"#ff7007"
257072125,ZoeEdzk,42,0,1,1,0.694181,0.445079,0,"#66e087"
257103036,souviron,14,1,1,2,0.648872,0.561372,0.000486,"#00eeff"
257120941,kmpenner,49,1,2,3,0.425708,0.4888,0.000973,"#ff7007"
257297589,sergi_acosta,13,0,1,1,0.525756,0.389835,0,"#3bec00"
257344494,Martin_Gendler,49,0,1,1,0.590036,0.400181,0,"#ff7007"
257440915,fejaruiz,3,16,0,16,0.464465,0.580014,0.007296,"#ffb3ff"
257473807,AlberCerezuela,30,0,1,1,0.595646,0.730455,0,"#ff77ff"
257478147,MemoriaGuada,19,2,0,2,0.670746,0.750157,0.000486,"#00d3ff"
257496780,Rusatahi,58,0,16,16,0.547316,0.567808,0.007296,"#005076"
257501551,solabarca,21,0,1,1,0.209256,0.228474,0,"#c6cc85"
257518057,veraseoa,2,0,1,1,0.655666,0.652157,0,"#ffa64e"
257535555,Natawillow,3,0,1,1,0.491526,0.749127,0,"#ffb3ff"
257540879,vickynotwittea,3,0,2,2,0.434692,0.648,0.000486,"#ffb3ff"
257669731,gortegaj,0,0,2,2,0.43701,0.394603,0.000486,"#8ecfec"
257722705,PrensaComunitar,13,3,2,5,0.44638,0.452274,0.001946,"#3bec00"
257723907,maoro2005,49,2,0,2,0.392973,0.583417,0.000486,"#ff7007"
257913282,torralba59,30,1,0,1,0.587799,0.571437,0,"#ff77ff"
258047255,vicotemora,4,0,1,1,0.867279,0.246918,0,"#f4c8cf"
258068061,maesus1,14,0,2,2,0.607242,0.465668,0.000486,"#00eeff"
258099723,Luciikelly,36,0,4,4,0.587006,0.255268,0.001459,"#825403"
258409062,FJavier_Sanchez,30,9,6,15,0.317147,0.593592,0.006809,"#ff77ff"
258464998,ajavierlopez,14,1,0,1,0.606582,0.470174,0,"#00eeff"
258517874,herman_it,0,0,2,2,0.511224,0.430342,0.000486,"#8ecfec"
258521540,pedromazonb,3,0,1,1,0.691967,0.703507,0,"#ffb3ff"
258522197,inhakiluke,40,0,1,1,0.592319,0.022004,0,"#ff12a3"
258549760,Oximoronico,36,2,3,5,0.495272,0.245341,0.001946,"#825403"
258711424,nohmeza,13,1,4,5,0.444997,0.490053,0.001946,"#3bec00"
258829547,javierdejasso,1,0,2,2,0.655735,0.458931,0.000486,"#b6cb00"
258831565,SIBI_UFRJ,36,3,2,5,0.50956,0.253597,0.001946,"#825403"
258856485,abobey7,40,0,1,1,0.626221,0.045768,0,"#ff12a3"
258948032,Ohienart_,22,0,1,1,0.529036,0.64857,0,"#00e8b2"
258975653,constanzanecu,49,0,4,4,0.580801,0.603851,0.001459,"#ff7007"
259126602,luscus9,30,5,0,5,0.520012,0.511574,0.001946,"#ff77ff"
259174992,USALTV,58,5,1,6,0.481573,0.619239,0.002432,"#005076"
259256881,malterehbein,36,2,0,2,0.591573,0.443017,0.000486,"#825403"
259293263,anacarrillop,19,3,1,4,0.581385,0.647516,0.001459,"#00d3ff"
259301275,FrueheNeuzeit,49,0,4,4,0.41971,0.469262,0.001459,"#ff7007"
259392691,judtalita,34,0,1,1,0.497992,0.377667,0,"#ff0d69"
259470216,lauraitzeel,13,0,1,1,0.452502,0.237254,0,"#3bec00"
259625864,CharlesOppenh,13,3,0,3,0.439162,0.431359,0.000973,"#3bec00"
259664201,Carmelucky,0,1,5,6,0.411018,0.590478,0.002432,"#8ecfec"
259671425,CMaciaBarber,37,0,1,1,0.748243,0.644748,0,"#006032"
259823746,Begolarte,31,0,1,1,0.645938,0.600816,0,"#3e93ff"
259824220,kalatasoy,30,0,1,1,0.584926,0.681826,0,"#ff77ff"
259847676,LauMRL,7,0,3,3,0.435578,0.406683,0.000973,"#ffb800"
259951219,dianecreate,3,0,1,1,0.662066,0.699298,0,"#ffb3ff"
259973594,kamilejandra,21,0,1,1,0.022861,0.654699,0,"#c6cc85"
260139276,naodamores,58,3,2,5,0.4899,0.555285,0.001946,"#005076"
260163642,PFolgueira,30,3,3,6,0.533631,0.422304,0.002432,"#ff77ff"
260255457,mariaacaso,2,0,1,1,0.746718,0.526675,0,"#ffa64e"
260271280,elewisumw,13,0,1,1,0.367513,0.457248,0,"#3bec00"
260275207,esTUlankide,18,7,1,8,0.731154,0.593783,0.003405,"#5456a6"
260283111,asplaces,14,1,0,1,0.633592,0.582977,0,"#00eeff"
260320481,simoneve2401,58,0,6,6,0.492578,0.536205,0.002432,"#005076"
260325619,dessdoblada,40,0,1,1,0.624928,0.050357,0,"#ff12a3"
260327003,condedemaldoror,13,0,11,11,0.487673,0.485492,0.004864,"#3bec00"
260328354,rosagarciatwitt,0,2,0,2,0.313195,0.575161,0.000486,"#8ecfec"
260334942,JLBracamonte,22,1,0,1,0.617764,0.697642,0,"#00e8b2"
260344193,juanrin425,3,0,1,1,0.44994,0.755575,0,"#ffb3ff"
260442884,iggolia,49,0,1,1,0.421423,0.729006,0,"#ff7007"
260445777,sastreh,31,0,5,5,0.578593,0.581064,0.001946,"#3e93ff"
260492029,Lucia_Achigar,55,0,2,2,0.625512,0.565618,0.000486,"#cb3f32"
260682807,FondationMSH,9,5,1,6,0.666125,0.653784,0.002432,"#008f7b"
260803714,NineMontenegro,57,0,2,2,0.708086,0.535664,0.000486,"#b66f7a"
260811642,gomezenbrasil,49,0,1,1,0.437712,0.672086,0,"#ff7007"
260913533,2011pau,14,0,1,1,0.755472,0.749132,0,"#00eeff"
260950444,leirione,15,1,2,3,0.459928,0.655375,0.000973,"#008ebb"
260967332,martincaeiro,14,2,2,4,0.519951,0.519036,0.001459,"#00eeff"
261234494,ConsolConlluvia,8,0,1,1,0.796643,0.192628,0,"#00ed5d"
261248039,corpoinmemoriam,38,0,2,2,0.541627,0.4111,0.000486,"#662859"
261264417,joan_tamayo,19,0,2,2,0.649216,0.635146,0.000486,"#00d3ff"
261275004,JavierBenayas,37,0,1,1,0.648244,0.492155,0,"#006032"
261463678,nk_uvaluna,0,0,1,1,0.418371,0.391966,0,"#8ecfec"
261488974,allenpg,34,0,4,4,0.466941,0.447046,0.001459,"#ff0d69"
261567919,aniuxa,13,0,1,1,0.380356,0.397338,0,"#3bec00"
261650023,AzaharaTIC,31,0,10,10,0.56175,0.524529,0.004377,"#3e93ff"
261702955,varelapma,22,0,2,2,0.491453,0.572534,0.000486,"#00e8b2"
261714419,albeirocuesta,38,0,1,1,0.428864,0.7575,0,"#662859"
261786006,Albertoxvenegas,38,41,6,47,0.63766,0.564488,0.022374,"#662859"
261813008,jmlucia,30,32,2,34,0.522812,0.502791,0.016051,"#ff77ff"
261821671,judithvaci,55,0,5,5,0.650896,0.638796,0.001946,"#cb3f32"
261895053,lucamobu,38,0,1,1,0.343375,0.170819,0,"#662859"
261906267,red_parlamenta,49,1,0,1,0.348338,0.615703,0,"#ff7007"
261979829,noelhv,55,0,5,5,0.659575,0.666089,0.001946,"#cb3f32"
262013143,tazadeazucar,4,0,1,1,0.870099,0.220142,0,"#f4c8cf"
262029585,UritRamirez,34,2,15,17,0.487848,0.45417,0.007782,"#ff0d69"
262279998,BelNuria,30,0,31,31,0.509278,0.512206,0.014591,"#ff77ff"
262323157,emmadelara,0,0,3,3,0.433757,0.567954,0.000973,"#8ecfec"
262332862,DHQuarterly,36,26,0,26,0.491603,0.497113,0.01216,"#825403"
262437564,ciberprofesor,14,0,5,5,0.56756,0.479904,0.001946,"#00eeff"
262549968,silexediciones,22,1,0,1,0.535638,0.649832,0,"#00e8b2"
262559534,golpeafuerte,0,0,2,2,0.65647,0.628543,0.000486,"#8ecfec"
262586567,AleSunnyAle,0,0,2,2,0.538541,0.656602,0.000486,"#8ecfec"
262586647,AdeA_Documental,22,0,2,2,0.539959,0.588207,0.000486,"#00e8b2"
262636685,paname65,15,1,0,1,0.51095,0.737701,0,"#008ebb"
262642892,korine2002,14,0,1,1,0.674782,0.514984,0,"#00eeff"
262675168,loreinsanchez,19,0,1,1,0.638125,0.643484,0,"#00d3ff"
262707711,angyroxas,1,0,3,3,0.42544,0.567041,0.000973,"#b6cb00"
262773101,AntonioRoblesML,2,0,2,2,0.652878,0.659585,0.000486,"#ffa64e"
262790097,SitaPons,1,0,2,2,0.648793,0.445765,0.000486,"#b6cb00"
262852337,claranubol,2,0,1,1,0.745351,0.530937,0,"#ffa64e"
263044687,oeg_upm,22,33,14,47,0.550986,0.607426,0.022374,"#00e8b2"
263064260,susanasanchezex,31,0,1,1,0.67311,0.539081,0,"#3e93ff"
263108959,perayson,36,0,1,1,0.572578,0.393396,0,"#825403"
263144590,todopatrimonio,31,1,5,6,0.582992,0.531327,0.002432,"#3e93ff"
263164484,i_lernin,1,0,1,1,0.429394,0.781514,0,"#b6cb00"
263223468,javi_valls,31,8,4,12,0.612826,0.542431,0.00535,"#3e93ff"
263231769,laumylife,49,1,0,1,0.480601,0.609511,0,"#ff7007"
263247123,EvaNubol,2,0,1,1,0.750337,0.525429,0,"#ffa64e"
263271990,ReseauUQ,49,1,0,1,0.33808,0.458909,0,"#ff7007"
263275439,jserravi,8,0,10,10,0.649857,0.341966,0.004377,"#00ed5d"
263302564,CasaLeonMadrid,37,1,0,1,0.558743,0.755144,0,"#006032"
263489034,Afranciscosp,49,0,1,1,0.415377,0.736488,0,"#ff7007"
263500161,magoandresito,14,0,1,1,0.684266,0.526143,0,"#00eeff"
263558868,Alafont2011,58,0,2,2,0.604053,0.310261,0.000486,"#005076"
263745995,SergioCrespoGil,1,1,0,1,0.443981,0.645584,0,"#b6cb00"
263781815,EAguadoL,13,0,6,6,0.466082,0.37262,0.002432,"#3bec00"
263902033,horaciojardon,41,0,1,1,0.326394,0.375126,0,"#697b00"
263906729,RaquelBlascoR,14,3,0,3,0.54115,0.69215,0.000973,"#00eeff"
263952675,sca2684,21,0,1,1,0.487025,0.944475,0,"#c6cc85"
264001846,Hermeneiatweets,36,1,2,3,0.433868,0.491256,0.000973,"#825403"
264045214,SonidoPaginas,49,1,0,1,0.492622,0.68182,0,"#ff7007"
264147018,LinternaTrad,15,1,0,1,0.538438,0.671637,0,"#008ebb"
264216837,NandaMangi,49,0,2,2,0.421235,0.551535,0.000486,"#ff7007"
264235464,sefis,49,1,0,1,0.343627,0.670402,0,"#ff7007"
264258142,gbus_,13,0,1,1,0.505447,0.233298,0,"#3bec00"
264298433,Lorenap43,7,0,2,2,0.433383,0.350696,0.000486,"#ffb800"
264384901,lic_jen,49,0,1,1,0.797222,0.576977,0,"#ff7007"
264435668,rmairal,30,29,25,54,0.512524,0.570029,0.025778,"#ff77ff"
264451561,camicardonam,37,1,0,1,0.640706,0.291677,0,"#006032"
264511360,bethbrea,49,0,1,1,0.48043,0.354126,0,"#ff7007"
264522999,ImagiMaria,37,1,1,2,0.425581,0.174549,0.000486,"#006032"
264529969,LaPorres,22,0,1,1,0.378794,0.201117,0,"#00e8b2"
264602370,ArmaMadrigal,13,0,2,2,0.520784,0.42756,0.000486,"#3bec00"
264676860,UCLDIS,13,0,1,1,0.437727,0.41392,0,"#3bec00"
264773015,MadonnaBeatrice,22,0,1,1,0.373149,0.591783,0,"#00e8b2"
264803550,alfredohdezdiaz,31,0,1,1,0.538795,0.69524,0,"#3e93ff"
264891196,acorralmatute,31,0,2,2,0.796762,0.378407,0.000486,"#3e93ff"
264980672,rafaelacritica,49,1,0,1,0.390009,0.65072,0,"#ff7007"
265029238,feedgruber,13,0,1,1,0.378565,0.442425,0,"#3bec00"
265118791,ugogarciap,3,0,1,1,0.451645,0.744062,0,"#ffb3ff"
265175059,stilettobrarian,36,1,0,1,0.290716,0.388164,0,"#825403"
265220322,Cicmty,7,2,0,2,0.355833,0.332126,0.000486,"#ffb800"
265297725,jobahe,14,1,2,3,0.462151,0.547228,0.000973,"#00eeff"
265297898,aordonez8,0,0,2,2,0.580343,0.650992,0.000486,"#8ecfec"
265332039,ajuano,30,0,1,1,0.484945,0.634475,0,"#ff77ff"
265395749,Epicteto66,0,0,1,1,0.383697,0.550375,0,"#8ecfec"
265456496,luizacdsantos,36,3,6,9,0.532247,0.385155,0.003891,"#825403"
265568993,SalvadorRos,30,1,0,1,0.582383,0.569851,0,"#ff77ff"
265640100,jpenaibanez,8,0,3,3,0.751276,0.562303,0.000973,"#00ed5d"
265646087,CCCdeNY,1,2,1,3,0.442829,0.610269,0.000973,"#b6cb00"
265647806,ibcaen,49,1,0,1,0.31398,0.625896,0,"#ff7007"
265678657,JoseCeRre,7,0,1,1,0.405805,0.28683,0,"#ffb800"
265682468,juliussinmundo,31,0,1,1,0.631461,0.509602,0,"#3e93ff"
265686170,ingandres00,34,0,1,1,0.553536,0.330577,0,"#ff0d69"
265764242,dilefante,21,0,1,1,0.31589,0.43597,0,"#c6cc85"
265921819,anabenlop,22,0,1,1,0.642909,0.454412,0,"#00e8b2"
265953469,AlbertoTenaC,40,0,2,2,0.107649,0.404942,0.000486,"#ff12a3"
265963543,JessicaBuelga,30,0,2,2,0.664224,0.588594,0.000486,"#ff77ff"
265974136,jm_bueno,13,0,1,1,0.412653,0.480315,0,"#3bec00"
265977979,ubupil,14,0,1,1,0.651654,0.602707,0,"#00eeff"
265979858,mayrbu,22,0,1,1,0.609156,0.616068,0,"#00e8b2"
266006324,knarfzevahc,38,0,3,3,0.522859,0.482557,0.000973,"#662859"
266117937,Quetzal_mdz,13,3,16,19,0.441105,0.466444,0.008755,"#3bec00"
266132067,fciencias,7,10,2,12,0.502974,0.262227,0.00535,"#ffb800"
266208045,rehimeargentina,49,1,0,1,0.360725,0.618218,0,"#ff7007"
266212060,JaviTannhauser,49,1,0,1,0.297149,0.631717,0,"#ff7007"
266226471,fer_escudero_,49,0,1,1,0.321007,0.466904,0,"#ff7007"
266239701,drnandico,34,0,1,1,0.333383,0.426296,0,"#ff0d69"
266309036,atcaccs,21,0,1,1,0.222742,0.22536,0,"#c6cc85"
266374581,jlaguirresuarez,4,0,1,1,0.840119,0.230421,0,"#f4c8cf"
266386398,icary84,17,0,1,1,0.636944,0.277955,0,"#ff9cc7"
266494761,linkeddataspain,30,1,0,1,0.548097,0.659136,0,"#ff77ff"
266508103,fliebc,31,0,7,7,0.592284,0.524966,0.002918,"#3e93ff"
266510425,fundacionmarch,31,1,0,1,0.650211,0.583803,0,"#3e93ff"
266544890,UA_Universidad,34,4,0,4,0.441997,0.567011,0.001459,"#ff0d69"
266555165,UA_Universitat,34,6,0,6,0.316179,0.570352,0.002432,"#ff0d69"
266571892,VFanderl,30,0,1,1,0.567587,0.635774,0,"#ff77ff"
266669687,euronewses,22,1,0,1,0.491131,0.693493,0,"#00e8b2"
266724218,caropoderosa,49,2,0,2,0.394481,0.566332,0.000486,"#ff7007"
266793929,CristianChisaba,37,0,3,3,0.588241,0.334611,0.000973,"#006032"
267026450,UNOint,3,1,0,1,0.446865,0.654208,0,"#ffb3ff"
267064889,bibliotecaubu,37,2,0,2,0.688431,0.395196,0.000486,"#006032"
267110606,InstCervantes,1,8,4,12,0.473342,0.603339,0.00535,"#b6cb00"
267111341,CDE_USPCEU,31,3,0,3,0.689346,0.350313,0.000973,"#3e93ff"
267128233,meollar,1,26,31,57,0.502526,0.536224,0.027237,"#b6cb00"
267131105,carmelapmontes,22,0,1,1,0.646499,0.605722,0,"#00e8b2"
267148280,emartinezgar,30,0,1,1,0.454823,0.619174,0,"#ff77ff"
267190897,ivanruga,49,1,0,1,0.372311,0.613455,0,"#ff7007"
267190904,PatriRibas,30,0,5,5,0.516274,0.556005,0.001946,"#ff77ff"
267289786,drotorrent,31,11,16,27,0.52378,0.599869,0.012646,"#3e93ff"
267296913,creacDempresas,49,1,0,1,0.388336,0.689986,0,"#ff7007"
267372565,marielacuadro,49,1,0,1,0.330998,0.609914,0,"#ff7007"
267477201,marioprades,13,0,2,2,0.517794,0.461524,0.000486,"#3bec00"
267548396,eflorescastro,49,0,1,1,0.09038,0.63787,0,"#ff7007"
267573150,ByRoNe14,12,1,0,1,0.784896,0.746625,0,"#00a04a"
267620219,SIJI_CSIC,22,5,0,5,0.56668,0.640176,0.001946,"#00e8b2"
267633081,anabotnico,34,1,0,1,0.56332,0.353617,0,"#ff0d69"
267663712,er_lasterra,2,0,1,1,0.759484,0.515042,0,"#ffa64e"
267725747,euskoikaskuntza,24,5,0,5,0.348188,0.589991,0.001946,"#ff9b8f"
267749341,UBUEstudiantes,37,5,4,9,0.591248,0.452466,0.003891,"#006032"
267899504,unedasturias,30,0,2,2,0.552337,0.615634,0.000486,"#ff77ff"
267904058,tatuillo,1,0,1,1,0.418785,0.785277,0,"#b6cb00"
267942553,Karidoscopia,21,0,1,1,0.484107,0.952566,0,"#c6cc85"
267984962,moratsukamoto,13,0,1,1,0.631525,0.983623,0,"#3bec00"
267988806,virbrussa,49,41,30,71,0.478461,0.542938,0.034047,"#ff7007"
268192461,kingsdh,14,19,4,23,0.52308,0.495567,0.0107,"#00eeff"
268330161,haydeerosalyn,31,0,2,2,0.571283,0.486011,0.000486,"#3e93ff"
268331551,Paolita_New,13,0,3,3,0.548361,0.365613,0.000973,"#3bec00"
268388407,ElenaGB,14,2,0,2,0.505822,0.479119,0.000486,"#00eeff"
268397728,ivanmontenegrot,3,0,1,1,0.501732,0.782039,0,"#ffb3ff"
268441633,EstelaMarGar,19,4,2,6,0.617608,0.628603,0.002432,"#00d3ff"
268455349,ks7000,49,1,0,1,0.373087,0.677773,0,"#ff7007"
268500979,theladythinks,36,0,2,2,0.382095,0.431151,0.000486,"#825403"
268517062,crisgutval,14,0,1,1,0.690627,0.512357,0,"#00eeff"
268577873,NomissReport,21,0,1,1,0.230048,0.207789,0,"#c6cc85"
268622182,florserale,49,1,0,1,0.420252,0.687331,0,"#ff7007"
268633817,Braulioaq,49,1,0,1,0.381919,0.63276,0,"#ff7007"
268921084,miljeveco,38,0,2,2,0.550023,0.484778,0.000486,"#662859"
269086715,bertaballester,31,0,1,1,0.664769,0.543212,0,"#3e93ff"
269200604,almapaleta,19,1,0,1,0.638093,0.795734,0,"#00d3ff"
269206076,HeLenLLaniLLo,49,1,0,1,0.306549,0.613316,0,"#ff7007"
269294539,paulgrandpsg,2,0,2,2,0.677559,0.651,0.000486,"#ffa64e"
269483046,felixramartinez,38,0,9,9,0.511188,0.443392,0.003891,"#662859"
269534959,hectoralma,37,0,1,1,0.67994,0.328617,0,"#006032"
269607851,carofiguerf,22,1,0,1,0.507272,0.670736,0,"#00e8b2"
269684186,esnogales,30,20,5,25,0.554787,0.546496,0.011673,"#ff77ff"
269794765,GRESAMGRUPO,15,0,2,2,0.532565,0.60864,0.000486,"#008ebb"
269860126,UWDigHum,30,1,0,1,0.539364,0.627819,0,"#ff77ff"
270030271,devenirmujer,13,0,1,1,0.408258,0.412411,0,"#3bec00"
270032310,carlosads77,49,1,0,1,0.345012,0.633498,0,"#ff7007"
270084912,mattacerna,0,0,2,2,0.451714,0.386138,0.000486,"#8ecfec"
270085843,HDColombia,49,1,0,1,0.347873,0.635681,0,"#ff7007"
270278439,elenaescocia,0,0,5,5,0.4488,0.575813,0.001946,"#8ecfec"
270285519,Julia_Carreno,49,0,3,3,0.426899,0.578112,0.000973,"#ff7007"
270414709,RUstaAnaSevilla,49,1,0,1,0.380768,0.615109,0,"#ff7007"
270486379,santigomezruiz,2,0,2,2,0.646408,0.719443,0.000486,"#ffa64e"
270709570,darcalabazas,3,1,1,2,0.440945,0.630982,0.000486,"#ffb3ff"
270789053,edaguil,30,1,1,2,0.40088,0.553936,0.000486,"#ff77ff"
270858103,UOCAndalucia,14,0,1,1,0.698013,0.56426,0,"#00eeff"
270865298,AlexWildWildest,49,2,0,2,0.406306,0.570537,0.000486,"#ff7007"
270868000,virojasma,0,0,1,1,0.285304,0.578306,0,"#8ecfec"
270883549,UOCmadrid,14,2,4,6,0.563713,0.541641,0.002432,"#00eeff"
270886714,UOCCValenciana,14,1,2,3,0.583548,0.522876,0.000973,"#00eeff"
270938193,CD_Clawson,13,0,1,1,0.400002,0.447187,0,"#3bec00"
271101954,NymeriaSolo,15,0,2,2,0.606981,0.560763,0.000486,"#008ebb"
271111321,amigosahpgu,22,0,1,1,0.397545,0.601336,0,"#00e8b2"
271138592,monicruzcaminha,36,0,2,2,0.535633,0.294724,0.000486,"#825403"
271140572,master_gc,30,1,0,1,0.541067,0.631679,0,"#ff77ff"
271184233,JMTorralbo,8,0,1,1,0.278929,0.271001,0,"#00ed5d"
271215629,SergioLeaPlaza,30,0,1,1,0.548638,0.643065,0,"#ff77ff"
271350791,KurtBravo,22,1,0,1,0.597685,0.598986,0,"#00e8b2"
271375109,gemmamtnez,19,0,2,2,0.626047,0.63337,0.000486,"#00d3ff"
271505423,dephistoriaUN,38,1,1,2,0.562033,0.40118,0.000486,"#662859"
271571170,evacolladoduran,14,2,0,2,0.682708,0.492903,0.000486,"#00eeff"
271581434,AinoaCastro,19,1,0,1,0.713878,0.54483,0,"#00d3ff"
271590437,garciaveram,17,0,1,1,0.918112,0.378881,0,"#ff9cc7"
271607930,AsoColHistoria,37,11,7,18,0.531654,0.445175,0.008268,"#006032"
271615701,MonicaLiCornejo,38,0,1,1,0.441218,0.771825,0,"#662859"
271645641,johnmadelgado,38,1,0,1,0.578305,0.346449,0,"#662859"
271649023,Uaesp,38,0,2,2,0.623485,0.379585,0.000486,"#662859"
271737593,weltanschauu_ng,3,0,1,1,0.467628,0.773984,0,"#ffb3ff"
271815921,tvaldessolis,30,1,0,1,0.451668,0.60469,0,"#ff77ff"
271880892,UERN,36,3,0,3,0.465391,0.322979,0.000973,"#825403"
271922522,ayatolaSN,30,0,1,1,0.534485,0.654178,0,"#ff77ff"
271957703,medranosss,17,0,1,1,0.725825,0.816501,0,"#ff9cc7"
271981837,cfbarrera,14,0,1,1,0.607775,0.489378,0,"#00eeff"
272003769,Carlospardo__,30,0,1,1,0.41761,0.588875,0,"#ff77ff"
272008339,ngertrudiz,13,0,2,2,0.460845,0.356425,0.000486,"#3bec00"
272032082,susanaalvaalva,22,0,1,1,0.749424,0.480264,0,"#00e8b2"
272036295,FccUab,14,4,0,4,0.522599,0.482353,0.001459,"#00eeff"
272060268,akakicrea,14,2,2,4,0.506147,0.522496,0.001459,"#00eeff"
272083590,VIAJAoMUERE,13,0,4,4,0.429813,0.395886,0.001459,"#3bec00"
272211173,Ns_Balabuch,49,1,0,1,0.298855,0.619699,0,"#ff7007"
272280643,MiriamPP,13,137,50,187,0.486187,0.473324,0.090467,"#3bec00"
272300099,profejlromero,49,1,0,1,0.377387,0.607512,0,"#ff7007"
272363916,MoniConTomate,40,0,1,1,0.606794,0.027086,0,"#ff12a3"
272372967,A1exBam,31,0,5,5,0.573009,0.502254,0.001946,"#3e93ff"
272430851,elicomelles,30,1,6,7,0.503924,0.522373,0.002918,"#ff77ff"
272449150,_samirsanchez,40,0,1,1,0.575504,0.049881,0,"#ff12a3"
272547548,PreciSan,37,0,1,1,0.65079,0.383857,0,"#006032"
272566279,cartolab,55,0,1,1,0.604483,0.429335,0,"#cb3f32"
272575137,abadal,14,1,0,1,0.665291,0.586388,0,"#00eeff"
272627216,JohanaMRPhD,0,0,1,1,0.427283,0.388717,0,"#8ecfec"
272662981,Victoriascinos,58,0,2,2,0.479643,0.595158,0.000486,"#005076"
272713223,tvruano,14,0,1,1,0.404144,0.524325,0,"#00eeff"
272724733,nestorlopezv,38,0,7,7,0.520729,0.507983,0.002918,"#662859"
272761249,jmsiqueiros,42,0,1,1,0.724028,0.434759,0,"#66e087"
272997984,anto_polis,3,0,1,1,0.598279,0.718089,0,"#ffb3ff"
273023803,1marcomuoz,9,0,1,1,0.73937,0.673578,0,"#008f7b"
273079116,carlosinnmortal,58,0,8,8,0.504954,0.552295,0.003405,"#005076"
273107128,POLITOLOGO82,10,0,1,1,0.678466,0.810325,0,"#52d7c0"
273308421,maranul,13,0,1,1,0.508045,0.307221,0,"#3bec00"
273342019,BistumSG,36,2,0,2,0.465906,0.329769,0.000486,"#825403"
273465911,muncyt,30,1,0,1,0.563275,0.592708,0,"#ff77ff"
273501607,Guadaumbrete,1,1,2,3,0.453825,0.56087,0.000973,"#b6cb00"
273502348,GrupoEDO,14,0,1,1,0.631261,0.537128,0,"#00eeff"
273519614,aulashistoria,36,1,0,1,0.448497,0.32531,0,"#825403"
273910434,ACUPcatalunya,8,9,2,11,0.596962,0.38753,0.004864,"#00ed5d"
273935884,LSEImpactBlog,30,2,0,2,0.546847,0.504656,0.000486,"#ff77ff"
273964101,pablo_casado,49,0,1,1,0.443115,0.678389,0,"#ff7007"
274095537,coachMarialuz,38,0,1,1,0.625343,0.359196,0,"#662859"
274150133,labernardina,13,1,7,8,0.438631,0.42395,0.003405,"#3bec00"
274167362,graduadosutnfrm,49,1,0,1,0.424498,0.66244,0,"#ff7007"
274172029,anapamartinez,38,0,1,1,0.658464,0.466139,0,"#662859"
274187559,MAZZAPA,15,0,2,2,0.612472,0.696615,0.000486,"#008ebb"
274204494,davidFLSTS,34,0,2,2,0.346134,0.419768,0.000486,"#ff0d69"
274296898,chulizuleta,37,0,1,1,0.564066,0.346171,0,"#006032"
274303059,UlyssesMtzMx,13,0,1,1,0.39976,0.364616,0,"#3bec00"
274311711,itayetzip,13,0,1,1,0.318606,0.527103,0,"#3bec00"
274576313,PeriodAlDerecho,49,1,0,1,0.395965,0.676664,0,"#ff7007"
274592041,AndresPerruca,0,5,17,22,0.442541,0.544384,0.010214,"#8ecfec"
274627966,agmasid,22,0,2,2,0.56794,0.627252,0.000486,"#00e8b2"
274654520,CFBarbudo,37,0,2,2,0.628764,0.516136,0.000486,"#006032"
274696914,cassandramex,7,0,2,2,0.421154,0.356948,0.000486,"#ffb800"
274711061,ACConde_,0,1,0,1,0.840914,0.435899,0,"#8ecfec"
274753839,ronaldorioln,3,0,1,1,0.464533,0.740468,0,"#ffb3ff"
274909232,aaconocimiento,1,8,1,9,0.472412,0.518372,0.003891,"#b6cb00"
274930627,JSGuadalajara,19,1,0,1,0.692252,0.765664,0,"#00d3ff"
274951688,MSNdokutalde,22,0,3,3,0.59515,0.619049,0.000973,"#00e8b2"
274958392,flacacz,8,0,1,1,0.515157,0.802236,0,"#00ed5d"
274977720,JMROMANGARCIA,0,0,10,10,0.898759,0.70434,0.004377,"#8ecfec"
275015646,bibliotgn,22,0,1,1,0.681197,0.568733,0,"#00e8b2"
275070598,UExternado,53,7,2,9,0.563191,0.685034,0.003891,"#008bdd"
275081367,Angelssoriano74,15,0,1,1,0.642156,0.534638,0,"#008ebb"
275092678,llopezocon,22,45,33,78,0.556385,0.559875,0.037451,"#00e8b2"
275097363,UAHes,37,18,1,19,0.609444,0.455056,0.008755,"#006032"
275185280,gabosinmas,14,0,2,2,0.44146,0.534191,0.000486,"#00eeff"
275200443,juandemurillos,34,0,2,2,0.417706,0.473998,0.000486,"#ff0d69"
275239439,Meta_VDR,35,0,2,2,0.423362,0.264485,0.000486,"#00faff"
275248862,J__Ele,38,1,3,4,0.288594,0.555674,0.001459,"#662859"
275271810,patmora_author,34,1,0,1,0.313668,0.40927,0,"#ff0d69"
275354006,diliaArojas,49,1,0,1,0.331679,0.617543,0,"#ff7007"
275375366,Erica_2012,49,1,0,1,0.392879,0.70484,0,"#ff7007"
275426582,sackito_,13,1,1,2,0.353603,0.317618,0.000486,"#3bec00"
275446924,hch_mexico,30,0,3,3,0.550676,0.560569,0.000973,"#ff77ff"
275466962,rosap01,8,0,1,1,0.267057,0.255665,0,"#00ed5d"
275527155,SonorosChus,22,0,2,2,0.511728,0.640568,0.000486,"#00e8b2"
275583016,UDC_gal,14,36,5,41,0.533208,0.516817,0.019455,"#00eeff"
275593743,AIEtxeberria,14,0,2,2,0.575886,0.450246,0.000486,"#00eeff"
275686563,verge,55,1,0,1,0.631027,0.560918,0,"#cb3f32"
275688332,maxgilr,38,0,1,1,0.566105,0.334841,0,"#662859"
275690077,Mario_LGuerrero,55,0,2,2,0.63404,0.556368,0.000486,"#cb3f32"
275699780,jodanuba,42,1,2,3,0.73836,0.482488,0.000973,"#66e087"
275729315,alxprince,3,1,5,6,0.465858,0.627147,0.002432,"#ffb3ff"
275730445,IDEMenorca,22,0,1,1,0.604016,0.621017,0,"#00e8b2"
275814862,josemanoriega,37,0,2,2,0.417084,0.560749,0.000486,"#006032"
275903631,XeviPujolAuden,3,0,3,3,0.480067,0.602295,0.000973,"#ffb3ff"
275978734,biblionthekes,14,1,3,4,0.593688,0.606446,0.001459,"#00eeff"
276060659,IbaiMartinez,22,0,1,1,0.690375,0.533666,0,"#00e8b2"
276091520,tecmexico,3,5,0,5,0.460291,0.568975,0.001946,"#ffb3ff"
276105382,Callejero777,38,0,2,2,0.555841,0.452477,0.000486,"#662859"
276117873,MartaSaus,14,1,9,10,0.51136,0.520842,0.004377,"#00eeff"
276133649,gabcano,13,1,1,2,0.438351,0.401526,0.000486,"#3bec00"
276217698,FerminDuranGa,14,0,1,1,0.673787,0.513957,0,"#00eeff"
276413350,ArchaiosPol,0,0,1,1,0.62933,0.44268,0,"#8ecfec"
276453739,MRaijmakersH,21,0,1,1,0.163287,0.233109,0,"#c6cc85"
277025517,joaquinramosmor,38,0,1,1,0.738905,0.461465,0,"#662859"
277029711,Hollow_hills,31,0,1,1,0.708486,0.272048,0,"#3e93ff"
277061332,oscarqyd,30,0,3,3,0.547754,0.634043,0.000973,"#ff77ff"
277194894,LasTop100,30,3,3,6,0.496953,0.596949,0.002432,"#ff77ff"
277206678,Tamaraoscar,38,0,1,1,0.732519,0.37618,0,"#662859"
277409211,DavidUnderdown9,4,0,1,1,0.513357,0.375623,0,"#f4c8cf"
277472232,brunamariz,36,0,3,3,0.507893,0.369696,0.000973,"#825403"
277485667,efcastillo,49,0,1,1,0.419446,0.720371,0,"#ff7007"
277526861,Mayoneitor,21,0,2,2,0.227442,0.234065,0.000486,"#c6cc85"
277540836,guiadebecas,1,1,0,1,0.396096,0.534056,0,"#b6cb00"
277547285,FILU_UV,13,4,6,10,0.434485,0.445526,0.004377,"#3bec00"
277559821,albertinsfran,49,5,12,17,0.485046,0.541734,0.007782,"#ff7007"
277562069,cerohd,37,0,2,2,0.7385,0.514502,0.000486,"#006032"
277595902,alberMoire,55,1,2,3,0.813222,0.689374,0.000973,"#cb3f32"
277605358,HistoriayDatos,1,1,0,1,0.394636,0.534015,0,"#b6cb00"
277686393,historiasocial,19,1,0,1,0.621605,0.775918,0,"#00d3ff"
277746072,bad_pt,36,1,0,1,0.586444,0.421646,0,"#825403"
277759071,JORGEMEDIOSIGLO,38,0,2,2,0.530003,0.418289,0.000486,"#662859"
277774138,ambasconzeta,34,0,1,1,0.592425,0.312649,0,"#ff0d69"
278042707,anonimocomatoso,49,1,0,1,0.388064,0.609126,0,"#ff7007"
278121706,museomusa,49,1,0,1,0.279466,0.810527,0,"#ff7007"
278126976,FragmentaEd,49,1,0,1,0.377441,0.610618,0,"#ff7007"
278201872,mrubino4,49,1,0,1,0.329587,0.656726,0,"#ff7007"
278266623,josemansant,19,0,1,1,0.632412,0.641423,0,"#00d3ff"
278286014,librosunam,7,19,3,22,0.403899,0.384781,0.010214,"#ffb800"
278333318,Klauzzina,55,0,1,1,0.610249,0.431407,0,"#cb3f32"
278364137,DIE_CINVESTAV,13,7,4,11,0.47445,0.489057,0.004864,"#3bec00"
278405719,kdnawrotzki,55,0,1,1,0.661202,0.566177,0,"#cb3f32"
278439678,themarquesito,49,0,1,1,0.485535,0.60888,0,"#ff7007"
278456481,Lanzadigital,19,1,0,1,0.690431,0.564475,0,"#00d3ff"
278482863,sepln,30,6,2,8,0.491433,0.521194,0.003405,"#ff77ff"
278506592,MSCActions,36,4,0,4,0.500604,0.432338,0.001459,"#825403"
278526860,bvazquezcalvo,14,1,2,3,0.681394,0.555574,0.000973,"#00eeff"
278538741,practicarte,14,1,6,7,0.49927,0.557255,0.002918,"#00eeff"
278577296,mercedes_p_g,4,0,4,4,0.934033,0.249878,0.001459,"#f4c8cf"
278626354,medicodeldolor,3,0,1,1,0.475332,0.671163,0,"#ffb3ff"
278713500,MiguelUTP,49,1,26,27,0.485865,0.527693,0.012646,"#ff7007"
278814481,karolinabadz,36,0,1,1,0.412588,0.574431,0,"#825403"
278983039,culturagob,19,3,0,3,0.578022,0.635931,0.000973,"#00d3ff"
279034479,Bibliocucuta,38,0,1,1,0.599172,0.344088,0,"#662859"
279106738,iemyr,15,1,0,1,0.534689,0.665368,0,"#008ebb"
279149606,azoteortograf,15,0,1,1,0.543935,0.674728,0,"#008ebb"
279160382,IIEc_UNAM,13,4,2,6,0.379368,0.266803,0.002432,"#3bec00"
279184743,JTrasobaresR,30,0,1,1,0.620208,0.432781,0,"#ff77ff"
279233738,mariogmd,13,0,1,1,0.35358,0.511876,0,"#3bec00"
279244226,FatimaFdezAdan,31,0,1,1,0.643261,0.516198,0,"#3e93ff"
279295559,csagol,49,2,20,22,0.451575,0.543063,0.010214,"#ff7007"
279323484,SusaanRguezF,3,0,1,1,0.455258,0.817641,0,"#ffb3ff"
279362444,RominaDonato,8,0,1,1,0.506523,0.804245,0,"#00ed5d"
279437739,anomru,1,7,4,11,0.377853,0.711805,0.004864,"#b6cb00"
279466571,Crispirulero,14,0,1,1,0.563483,0.580777,0,"#00eeff"
279663205,LetyPerezCast,13,0,2,2,0.436864,0.391034,0.000486,"#3bec00"
279694499,mafaldaparse,30,0,1,1,0.189521,0.589218,0,"#ff77ff"
279695003,zozquert,22,0,1,1,0.706748,0.618804,0,"#00e8b2"
279714238,AntoTrifolium,22,0,3,3,0.719786,0.387713,0.000973,"#00e8b2"
279774676,defensoriaendh,7,0,2,2,0.376283,0.370074,0.000486,"#ffb800"
279961352,_CristinaAlvarz,30,0,2,2,0.556569,0.701754,0.000486,"#ff77ff"
280079996,alexcalzadilla,30,0,1,1,0.600758,0.667536,0,"#ff77ff"
280105708,aureaarellano,13,0,1,1,0.389884,0.369245,0,"#3bec00"
280136686,AriadnaLuOk,37,0,1,1,0.172127,0.616479,0,"#006032"
280152200,CacaitoPuro,34,0,2,2,0.556983,0.380049,0.000486,"#ff0d69"
280172465,WatcherBlog,14,3,4,7,0.750848,0.506922,0.002918,"#00eeff"
280195400,JAMartinezLugo,17,0,1,1,0.893011,0.364849,0,"#ff9cc7"
280301243,HistoryJack,30,0,2,2,0.596535,0.596742,0.000486,"#ff77ff"
280310507,sara_cacao,34,0,1,1,0.365912,0.436315,0,"#ff0d69"
280405284,cheraglez,14,0,3,3,0.610324,0.531535,0.000973,"#00eeff"
280429962,Xavi_Penela,22,0,1,1,0.777077,0.520194,0,"#00e8b2"
280435715,informa,49,2,0,2,0.401073,0.565788,0.000486,"#ff7007"
280445560,deletrasum,22,0,1,1,0.467213,0.673218,0,"#00e8b2"
280453134,anapanouoc,13,1,35,36,0.494833,0.523597,0.017023,"#3bec00"
280495800,DelegaHCD,19,8,0,8,0.655142,0.758348,0.003405,"#00d3ff"
280534496,TeleAntillas2,49,1,0,1,0.313649,0.668516,0,"#ff7007"
280545927,milciades1983,3,0,1,1,0.681236,0.699596,0,"#ffb3ff"
280561320,EASPsalud,22,14,1,15,0.421216,0.262147,0.006809,"#00e8b2"
280562701,nestordilullo,8,0,1,1,0.236227,0.262527,0,"#00ed5d"
280572248,charobareno,49,1,0,1,0.318987,0.671992,0,"#ff7007"
280576945,ComprensLectora,1,0,3,3,0.414131,0.533847,0.000973,"#b6cb00"
280596656,ricardomontesg,13,0,4,4,0.496836,0.472245,0.001459,"#3bec00"
281025114,JustLoliAP,13,0,1,1,0.637814,1,0,"#3bec00"
281119597,maica_rivera,0,0,1,1,0.419097,0.517963,0,"#8ecfec"
281137901,SaraAguilarr,14,0,2,2,0.622106,0.52902,0.000486,"#00eeff"
281175839,cuneoworld,21,0,2,2,0.224961,0.252886,0.000486,"#c6cc85"
281180927,dahergary,3,0,1,1,0.702752,0.70544,0,"#ffb3ff"
281316561,ruthtzin,26,1,0,1,0.403602,0.107101,0,"#a7d4ff"
281450872,_balyasnikova,13,0,1,1,0.564731,0.405937,0,"#3bec00"
281535631,Rokrmel,49,0,1,1,0.444218,0.675461,0,"#ff7007"
281559676,EmprendeTorre,49,1,0,1,0.370271,0.685117,0,"#ff7007"
281606938,museocolonial,38,7,1,8,0.427702,0.471184,0.003405,"#662859"
281629616,MIStaClara,38,8,2,10,0.376908,0.515291,0.004377,"#662859"
281656239,elgueropulquero,13,0,1,1,0.581075,0.257678,0,"#3bec00"
281658284,paquiconde,16,0,3,3,0.938547,0.665247,0.000973,"#c42c63"
281673591,elcolmich,13,5,0,5,0.45546,0.472417,0.001946,"#3bec00"
281676483,UniJena,13,3,0,3,0.449756,0.470591,0.000973,"#3bec00"
281712996,nataliaeliro,42,0,5,5,0.698497,0.46787,0.001946,"#66e087"
281715946,ferminturiel,22,0,1,1,0.746433,0.421523,0,"#00e8b2"
281832082,EMGrumbach,34,0,8,8,0.419447,0.448528,0.003405,"#ff0d69"
281944445,clparrac,1,1,1,2,0.425851,0.628385,0.000486,"#b6cb00"
281948008,_Carmina__,16,0,3,3,0.926368,0.665756,0.000973,"#c42c63"
281983112,Roi_Arias,8,1,0,1,0.668691,0.24901,0,"#00ed5d"
282026933,lurixea,14,0,8,8,0.520242,0.504709,0.003405,"#00eeff"
282077134,LMEDIOS,31,0,1,1,0.615313,0.327446,0,"#3e93ff"
282081096,s4kink0,13,1,0,1,0.401071,0.404159,0,"#3bec00"
282123824,posgradoUAH,37,1,0,1,0.628071,0.3437,0,"#006032"
282187886,martinvi2011,0,2,2,4,0.479825,0.584396,0.001459,"#8ecfec"
282263125,vivanlasflores,3,0,1,1,0.511475,0.776284,0,"#ffb3ff"
282276510,LauraMasden,31,0,2,2,0.589501,0.502537,0.000486,"#3e93ff"
282391338,ariadna_acevedo,13,1,4,5,0.48175,0.519835,0.001946,"#3bec00"
282665357,tesiscanalsur,14,1,0,1,0.791997,0.556072,0,"#00eeff"
282668740,guadanc,30,2,5,7,0.527437,0.555718,0.002918,"#ff77ff"
282688608,mbonet2,2,0,2,2,0.661586,0.62112,0.000486,"#ffa64e"
282759853,Efe_Fletch,22,0,1,1,0.720331,0.363787,0,"#00e8b2"
283108001,RubenRase,49,1,0,1,0.350563,0.639709,0,"#ff7007"
283186676,Direct_Eq,40,0,1,1,0.640784,0.014387,0,"#ff12a3"
283221097,Marcelvelazq,13,0,1,1,0.403913,0.447941,0,"#3bec00"
283228699,manu_barreiro,0,0,1,1,0.384395,0.606197,0,"#8ecfec"
283230411,QuebrandoOTabu,48,1,0,1,0.275351,0.527253,0,"#ff7a78"
283548736,veraluvi,37,2,0,2,0.513906,0.37161,0.000486,"#006032"
283553456,fabinhafuhr,36,1,2,3,0.528243,0.277729,0.000973,"#825403"
283555892,Dolors_guillen,22,3,1,4,0.722718,0.513048,0.001459,"#00e8b2"
283561055,mariapgarciam,13,1,2,3,0.435775,0.508998,0.000973,"#3bec00"
283577845,AbelFdz_CDMX,7,0,4,4,0.483452,0.503366,0.001459,"#ffb800"
283753165,mollyhardy,34,0,2,2,0.354864,0.433,0.000486,"#ff0d69"
283775157,FFYLUNAM,13,2,0,2,0.484929,0.361378,0.000486,"#3bec00"
283829365,ergoolof,22,0,1,1,0.666984,0.570813,0,"#00e8b2"
283841656,gustavolsj,13,4,25,29,0.493212,0.451578,0.013619,"#3bec00"
283864014,gcusot,49,0,1,1,0.456989,0.630911,0,"#ff7007"
283942020,ericaferreiro,55,1,1,2,0.603921,0.544308,0.000486,"#cb3f32"
283946961,siberie191,30,0,2,2,0.467383,0.545889,0.000486,"#ff77ff"
284000156,Adellanotte,22,1,0,1,0.679845,0.564478,0,"#00e8b2"
284053968,AntoniGarrell,8,41,110,151,0.636327,0.315445,0.072957,"#00ed5d"
284062210,elisamencos,3,0,1,1,0.681294,0.694821,0,"#ffb3ff"
284080109,ConektIA,49,1,0,1,0.364461,0.626404,0,"#ff7007"
284183428,vivaleer,21,0,2,2,0.219078,0.249708,0.000486,"#c6cc85"
284285718,ibpad,36,18,5,23,0.508571,0.383392,0.0107,"#825403"
284392736,alorell,21,0,2,2,0.24213,0.229147,0.000486,"#c6cc85"
284422763,PSG1988,30,0,1,1,0.691225,0.624307,0,"#ff77ff"
284479026,JornadasCONTD,3,5,0,5,0.504996,0.712499,0.001946,"#ffb3ff"
284525970,guillermoleale,49,0,1,1,0.402849,0.514798,0,"#ff7007"
284558345,carlomicha,1,0,2,2,0.375275,0.542339,0.000486,"#b6cb00"
284642077,lluisanglada,14,28,17,45,0.563484,0.588846,0.021401,"#00eeff"
284734969,tatatrapita,38,78,73,151,0.511117,0.464116,0.072957,"#662859"
284800573,rislaidy,49,0,2,2,0.410996,0.593605,0.000486,"#ff7007"
284824460,davidchavarria_,34,0,17,17,0.485125,0.456767,0.007782,"#ff0d69"
284898293,lacajaderratas,13,1,4,5,0.425178,0.442442,0.001946,"#3bec00"
285002454,MartaMichel,55,2,0,2,0.634492,0.560794,0.000486,"#cb3f32"
285144730,esteman106,38,0,1,1,0.46139,0.776035,0,"#662859"
285154197,Maorodriguezgon,34,0,1,1,0.571475,0.227618,0,"#ff0d69"
285204230,Capi_Ussop,37,0,2,2,0.624637,0.387627,0.000486,"#006032"
285205740,jitrimegisto,21,0,1,1,0.216404,0.197618,0,"#c6cc85"
285224733,JaredCarballo_,4,5,5,10,0.560082,0.674094,0.004377,"#f4c8cf"
285228314,Amauri_Lpz,13,6,5,11,0.415835,0.483695,0.004864,"#3bec00"
285322447,cocinartechile,21,0,1,1,0.208884,0.224458,0,"#c6cc85"
285395514,mellymeldubs,34,0,2,2,0.354066,0.417865,0.000486,"#ff0d69"
285405708,Marce_I_P,37,0,1,1,0.214862,0.469045,0,"#006032"
285406049,Jackye36,38,0,2,2,0.587142,0.409059,0.000486,"#662859"
285482081,edgdehesa,49,1,0,1,0.319145,0.65077,0,"#ff7007"
285783267,Demografia_CSIC,22,0,1,1,0.563809,0.306,0,"#00e8b2"
285876383,Ernestocrates,14,2,0,2,0.526196,0.470993,0.000486,"#00eeff"
286102281,msaezfern,30,2,3,5,0.338228,0.527555,0.001946,"#ff77ff"
286346766,RomulaizerPardo,49,2,2,4,0.430201,0.528987,0.001459,"#ff7007"
286356745,SpiderSka,38,0,1,1,0.120659,0.816575,0,"#662859"
286407020,jorgeivanco,38,2,0,2,0.644603,0.463394,0.000486,"#662859"
286573591,DimitarKos,49,1,0,1,0.344572,0.618464,0,"#ff7007"
286851921,eneo_unam,7,0,2,2,0.46419,0.343969,0.000486,"#ffb800"
286884919,miguelhom,49,1,0,1,0.352484,0.657842,0,"#ff7007"
286905358,PATRICIOBERNEDO,7,0,2,2,0.432178,0.317464,0.000486,"#ffb800"
286912807,AlejandroOtaola,13,0,4,4,0.462035,0.353832,0.001459,"#3bec00"
286932560,the_mandalorin,34,0,2,2,0.334205,0.421475,0.000486,"#ff0d69"
286968273,GeekGirlsLatam,38,2,0,2,0.584203,0.415541,0.000486,"#662859"
287194246,rmathematicus,36,0,1,1,0.460201,0.276875,0,"#825403"
287220267,Jaravalderas,14,0,3,3,0.457282,0.549297,0.000973,"#00eeff"
287232930,omiromarti,13,0,4,4,0.485434,0.504425,0.001459,"#3bec00"
287249732,marcarminalva,13,0,1,1,0.486291,0.385025,0,"#3bec00"
287285569,MiguelDlaCamara,31,0,5,5,0.607035,0.556499,0.001946,"#3e93ff"
287358053,Alexandernikko,21,0,1,1,0.330469,0.446091,0,"#c6cc85"
287461552,yaakoswaldo,7,0,2,2,0.395393,0.352079,0.000486,"#ffb800"
287505480,scyasig,22,0,2,2,0.545154,0.651894,0.000486,"#00e8b2"
287561382,edsintesis,37,1,0,1,0.559944,0.376396,0,"#006032"
287615042,AsociacionEduca,22,0,2,2,0.207822,0.566984,0.000486,"#00e8b2"
287627616,robquera,40,0,1,1,0.62265,0.026551,0,"#ff12a3"
287659745,teknokultura,0,130,3,133,0.477331,0.463094,0.064202,"#8ecfec"
287788048,ALFREDOFDEZ_C,41,1,3,4,0.371105,0.427816,0.001459,"#697b00"
287837659,VicenteMunuzuri,30,0,1,1,0.362169,0.58997,0,"#ff77ff"
288021215,EstamosdePlan,38,1,2,3,0.622547,0.37186,0.000973,"#662859"
288151318,AFFermoselle,49,1,0,1,0.361417,0.622423,0,"#ff7007"
288177124,Marina_Saucejo,14,0,1,1,0.665524,0.501217,0,"#00eeff"
288179149,di_mad,22,2,0,2,0.555796,0.62728,0.000486,"#00e8b2"
288206767,CasaZorrilla,30,1,0,1,0.70882,0.668049,0,"#ff77ff"
288282457,imjustalbi,30,0,1,1,0.60166,0.660332,0,"#ff77ff"
288314738,MAdelPrado,13,0,1,1,0.418765,0.498948,0,"#3bec00"
288317902,MaribelHU,19,0,2,2,0.62787,0.637332,0.000486,"#00d3ff"
288464417,etxeetxehotmail,49,2,0,2,0.433908,0.650918,0.000486,"#ff7007"
288473878,wikimedia_bo,13,0,2,2,0.532237,0.434931,0.000486,"#3bec00"
288505683,JuanP_Battroid,13,0,2,2,0.415091,0.40022,0.000486,"#3bec00"
288549417,paorobgalan,22,0,1,1,0.66521,0.580635,0,"#00e8b2"
288554889,LaAbejota,34,0,1,1,0.60752,0.325297,0,"#ff0d69"
288685325,marisamargar,15,0,1,1,0.528817,0.738878,0,"#008ebb"
288710168,IsabelBonmati,49,1,0,1,0.312845,0.636192,0,"#ff7007"
288889950,cirila_thompson,49,1,0,1,0.332639,0.631714,0,"#ff7007"
288938423,BPGurus,49,3,0,3,0.434927,0.548169,0.000973,"#ff7007"
289005573,lilizer17,42,0,1,1,0.680276,0.365549,0,"#66e087"
289010573,EduardoCitronne,13,2,0,2,0.479625,0.406374,0.000486,"#3bec00"
289236741,FPilares,22,0,2,2,0.621783,0.464861,0.000486,"#00e8b2"
289280894,DiegoTelias,37,1,0,1,0.413245,0.257935,0,"#006032"
289286759,timancusto,30,0,3,3,0.54772,0.589062,0.000973,"#ff77ff"
289402162,saudadinho,13,1,0,1,0.390636,0.423281,0,"#3bec00"
289572192,SpanishBizarro,58,0,1,1,0.604154,0.18074,0,"#005076"
289601740,DeGruyterOA,22,10,1,11,0.524679,0.562503,0.004864,"#00e8b2"
289656659,atmosferatus,14,0,1,1,0.645968,0.579376,0,"#00eeff"
289683185,yerenace,36,0,2,2,0.478038,0.53883,0.000486,"#825403"
289808011,Pahidalg,19,0,2,2,0.617566,0.617968,0.000486,"#00d3ff"
289834442,mjguerrapalmero,31,1,11,12,0.725828,0.504835,0.00535,"#3e93ff"
289940115,GonnetDigital,49,1,0,1,0.404249,0.669317,0,"#ff7007"
289978575,MoyaRiu,0,0,8,8,0.434543,0.558079,0.003405,"#8ecfec"
290137690,marcos_galonso,0,0,1,1,0.38582,0.560232,0,"#8ecfec"
290177135,beadeguez,31,0,2,2,0.814976,0.442162,0.000486,"#3e93ff"
290516085,IMEDEA_UIB_CSIC,22,0,2,2,0.658435,0.479952,0.000486,"#00e8b2"
290596091,ilichrc,42,0,2,2,0.706001,0.434086,0.000486,"#66e087"
290721329,pekapepa,40,0,1,1,0.640842,0.025841,0,"#ff12a3"
290722708,pmarchiaro,3,0,2,2,0.479346,0.673296,0.000486,"#ffb3ff"
290784545,chaskynet,49,0,1,1,0.476342,0.806354,0,"#ff7007"
290789353,cefeza55,13,0,4,4,0.445795,0.415001,0.001459,"#3bec00"
290950723,paradoja_nihil,49,1,0,1,0.335795,0.620643,0,"#ff7007"
291002183,aprensasevilla,49,1,0,1,0.364261,0.609114,0,"#ff7007"
291003653,ruitinna,3,0,1,1,0.599542,0.709645,0,"#ffb3ff"
291387096,Marco_Cerdio,13,0,6,6,0.592963,0.496044,0.002432,"#3bec00"
291424986,SaraSanchez___,58,0,2,2,0.540331,0.602805,0.000486,"#005076"
291466601,MarianaSabu,49,1,2,3,0.414104,0.587736,0.000973,"#ff7007"
291652922,Patry_nf,15,0,4,4,0.527209,0.6102,0.001459,"#008ebb"
291681176,AdhilacInfo,38,0,5,5,0.385303,0.389998,0.001946,"#662859"
291689355,LauraBarrallo,2,0,1,1,0.394168,0.547656,0,"#ffa64e"
291727006,edurobayo7,3,0,1,1,0.664997,0.711146,0,"#ffb3ff"
291745825,Nissan_ESP,49,1,0,1,0.370515,0.661411,0,"#ff7007"
291788449,JMoralRubino,49,1,0,1,0.333888,0.595226,0,"#ff7007"
291875133,NinesT,49,0,1,1,0.413952,0.724762,0,"#ff7007"
291897555,IAtxa,30,0,2,2,0.513813,0.570138,0.000486,"#ff77ff"
292136445,dieolivaresj,34,0,3,3,0.543723,0.397042,0.000973,"#ff0d69"
292178008,rojas_dan,14,0,5,5,0.491037,0.49405,0.001946,"#00eeff"
292227204,cinemanet_info,49,1,0,1,0.330668,0.640472,0,"#ff7007"
292426878,betzaidamontero,49,1,0,1,0.302074,0.626549,0,"#ff7007"
292533999,mireianilo,8,0,1,1,0.685711,0.305844,0,"#00ed5d"
292536558,vane_arevalos,13,0,2,2,0.424851,0.446187,0.000486,"#3bec00"
292556038,msolanoaltaba,2,0,1,1,0.47046,0.508636,0,"#ffa64e"
292580628,LearningSPARQL,34,0,3,3,0.532535,0.467658,0.000973,"#ff0d69"
292596698,FODESEP,9,1,1,2,0.719376,0.673639,0.000486,"#008f7b"
292801970,JPColmenarejo,49,1,0,1,0.40955,0.689399,0,"#ff7007"
292916218,manenaota,21,0,1,1,0.249053,0.21174,0,"#c6cc85"
292991715,juanpbolmed,38,0,1,1,0.310186,0.179198,0,"#662859"
292998487,SardImperium,22,0,1,1,0.583542,0.47906,0,"#00e8b2"
293062839,mbailac,19,0,1,1,0.665352,0.779889,0,"#00d3ff"
293117602,ddu_10,21,0,2,2,0.235907,0.227573,0.000486,"#c6cc85"
293206946,Paul_Valley,49,0,2,2,0.446511,0.548603,0.000486,"#ff7007"
293292426,leonardomus44,38,0,2,2,0.428222,0.350348,0.000486,"#662859"
293303597,ffilipemr,36,2,0,2,0.462586,0.333052,0.000486,"#825403"
293305115,QuiqueenriqueCa,49,1,0,1,0.380368,0.678927,0,"#ff7007"
293339594,KrisSummer1,13,0,6,6,0.490566,0.483467,0.002432,"#3bec00"
293419650,bbaamalaga,14,5,0,5,0.525319,0.51012,0.001946,"#00eeff"
293515780,laia_mv,14,0,1,1,0.644822,0.597642,0,"#00eeff"
293587457,Diana_Joa,37,0,8,8,0.532138,0.449165,0.003405,"#006032"
293593704,dlmc29,22,0,1,1,0.819441,0.331461,0,"#00e8b2"
293596022,bdtarragona,14,0,1,1,0.624417,0.655736,0,"#00eeff"
293601379,gominolasdpetro,14,3,0,3,0.550651,0.694545,0.000973,"#00eeff"
293698668,Seguridadula,42,0,2,2,0.737404,0.393045,0.000486,"#66e087"
293775427,RaulRojoRuiz,7,0,2,2,0.414164,0.367342,0.000486,"#ffb800"
293931798,PonteIneptique,34,0,1,1,0.470345,0.373504,0,"#ff0d69"
293963889,fcienciasugr,31,0,1,1,0.663117,0.53468,0,"#3e93ff"
294059282,carlosghh,2,8,10,18,0.521376,0.533974,0.008268,"#ffa64e"
294075019,NireNegro_Ed,21,0,2,2,0.207926,0.247149,0.000486,"#c6cc85"
294081155,ramon_emaac,38,0,1,1,0.675705,0.346868,0,"#662859"
294099546,rnpy920am,37,0,2,2,0.239601,0.509433,0.000486,"#006032"
294101019,ana_valdi,31,7,3,10,0.623238,0.542481,0.004377,"#3e93ff"
294107159,Mar__Carrillo,49,4,0,4,0.407875,0.526886,0.001459,"#ff7007"
294142353,JEPK_,49,0,1,1,0.235772,0.693342,0,"#ff7007"
294168695,JairoGarc,31,0,3,3,0.612855,0.585918,0.000973,"#3e93ff"
294168790,Andreitakas,40,0,2,2,0.583436,0.278178,0.000486,"#ff12a3"
294308032,tisha_130,7,0,2,2,0.422489,0.365143,0.000486,"#ffb800"
294308507,jmolinamendoza,34,0,1,1,0.633079,0.314797,0,"#ff0d69"
294321129,Marce_Sandoval_,21,0,1,1,0.23146,0.192636,0,"#c6cc85"
294323086,alfredosabbagh,3,1,3,4,0.504325,0.69153,0.001459,"#ffb3ff"
294386283,damiancuenca80,30,0,1,1,0.513766,0.709188,0,"#ff77ff"
294731021,GrinUGR,31,53,11,64,0.56677,0.532217,0.030642,"#3e93ff"
294793276,elemasre,14,3,0,3,0.729436,0.469436,0.000973,"#00eeff"
294825660,lufecoaI,36,1,0,1,0.472242,0.33697,0,"#825403"
294860312,ChuchoPerdomo,38,0,1,1,0.696969,0.4041,0,"#662859"
294926157,danihino2,38,0,1,1,0.318077,0.17985,0,"#662859"
295165640,EHBilduOrereta,36,0,1,1,0.324584,0.15367,0,"#825403"
295410316,Pablastor,21,0,1,1,0.196656,0.208713,0,"#c6cc85"
295415649,KansasUniv,41,1,0,1,0.350074,0.379126,0,"#697b00"
295426453,Osvaldosfalcao,36,1,0,1,0.4651,0.318526,0,"#825403"
295556841,uam_estudiantes,37,4,2,6,0.581204,0.447675,0.002432,"#006032"
295732528,FinaPatino,49,1,0,1,0.322799,0.674759,0,"#ff7007"
295779009,FormacProfAnd,0,1,0,1,0.911397,0.330554,0,"#8ecfec"
295909447,FerBmin,38,0,1,1,0.087386,0.436993,0,"#662859"
296023747,CAVAGAR,9,0,2,2,0.673597,0.91059,0.000486,"#008f7b"
296023990,RodrigoHenrquez,7,0,1,1,0.394996,0.245022,0,"#ffb800"
296080400,joselyng_88,7,0,2,2,0.520544,0.723906,0.000486,"#ffb800"
296121328,ateneo_riojano,30,2,2,4,0.526819,0.631622,0.001459,"#ff77ff"
296395955,mercurio586,13,0,1,1,0.416247,0.356121,0,"#3bec00"
296477583,lpez_laura,22,0,1,1,0.300053,0.407776,0,"#00e8b2"
296486159,observatorioedu,30,6,0,6,0.461121,0.552253,0.002432,"#ff77ff"
296622890,ItzamaLopezY,13,0,1,1,0.415154,0.286575,0,"#3bec00"
296724555,HistoriaMemoria,19,2,0,2,0.653688,0.764202,0.000486,"#00d3ff"
296785990,Planiturconsult,49,1,0,1,0.404307,0.62098,0,"#ff7007"
296835426,vivitete8,21,0,1,1,0.037844,0.627844,0,"#c6cc85"
296880284,ArtHouseDirectr,34,0,2,2,0.347936,0.422113,0.000486,"#ff0d69"
296891508,SopraSteria_ES,49,1,0,1,0.421919,0.646437,0,"#ff7007"
296950170,jexlopez,22,3,12,15,0.564065,0.585864,0.006809,"#00e8b2"
296967530,manuamezcua,31,12,4,16,0.643351,0.529649,0.007296,"#3e93ff"
297008460,iresegura,14,0,1,1,0.498796,0.645086,0,"#00eeff"
297015905,CienciaInfoPUJ,37,1,0,1,0.562425,0.349749,0,"#006032"
297200106,FilosofiaMexico,41,0,1,1,0.297409,0.300785,0,"#697b00"
297220205,AsepecIBERO,13,0,1,1,0.437895,0.312838,0,"#3bec00"
297286051,iila_org,36,4,0,4,0.461109,0.381638,0.001459,"#825403"
297336996,mari38jo,22,13,4,17,0.276917,0.566652,0.007782,"#00e8b2"
297363735,RUBENLUCEROG,38,0,1,1,0.657706,0.419137,0,"#662859"
297409511,chikycuatrojos,38,0,1,1,0.313289,0.176591,0,"#662859"
297725059,dacostamariac,42,0,1,1,0.899797,0.439245,0,"#66e087"
297862021,GretaFranzini,30,0,15,15,0.499227,0.494975,0.006809,"#ff77ff"
297907760,CuiUpo,1,3,0,3,0.416013,0.540033,0.000973,"#b6cb00"
298223986,BelloElimar,0,0,2,2,0.504619,0.427981,0.000486,"#8ecfec"
298413083,alberto_bib,30,1,1,2,0.491256,0.59942,0.000486,"#ff77ff"
298432844,FerbEquisde,1,0,1,1,0.42611,0.784271,0,"#b6cb00"
298577952,manuelverdejo,16,0,2,2,0.945904,0.653369,0.000486,"#c42c63"
298622884,leacunag,38,0,1,1,0.688238,0.401846,0,"#662859"
298641701,almu_hs,31,0,9,9,0.53365,0.558126,0.003891,"#3e93ff"
298641743,angelesal14,49,2,1,3,0.527801,0.571202,0.000973,"#ff7007"
298758353,LourdesFeria,49,3,2,5,0.435904,0.476501,0.001946,"#ff7007"
299075442,venusmecanica,37,1,0,1,0.572297,0.376875,0,"#006032"
299306775,yanlivargas,7,0,1,1,0.42422,0.317805,0,"#ffb800"
299309800,pablogarguez,30,1,4,5,0.554949,0.616071,0.001946,"#ff77ff"
299541193,_noeruiz,22,0,1,1,0.392483,0.611339,0,"#00e8b2"
299700372,apgcc,14,0,2,2,0.570421,0.448279,0.000486,"#00eeff"
299738550,ConchiCalderon,0,0,1,1,0.377893,0.555564,0,"#8ecfec"
299742342,SMLpf,38,0,2,2,0.619011,0.390472,0.000486,"#662859"
299761647,Memmanul,22,0,3,3,0.527223,0.60579,0.000973,"#00e8b2"
299789933,lia_psi,13,0,1,1,0.494398,0.309795,0,"#3bec00"
299820080,eduquescobar,9,0,1,1,0.732185,0.666674,0,"#008f7b"
299852902,jonbben,42,0,3,3,0.725381,0.456908,0.000973,"#66e087"
299919913,AdrianPino22,3,0,2,2,0.453397,0.619142,0.000486,"#ffb3ff"
299924386,4Hum,14,5,0,5,0.522084,0.499006,0.001946,"#00eeff"
299946342,fran_abel,34,0,1,1,0.389147,0.455536,0,"#ff0d69"
300166826,ier_ac,49,1,0,1,0.299639,0.748563,0,"#ff7007"
300276871,SolUgarteF,30,0,4,4,0.512199,0.591278,0.001459,"#ff77ff"
300306607,ParaguayTVHD,37,0,2,2,0.238292,0.506922,0.000486,"#006032"
300318216,EnricGarrell,22,0,1,1,0.527961,0.648297,0,"#00e8b2"
300340762,laluchapa,49,1,0,1,0.412349,0.67583,0,"#ff7007"
300372136,llavesa,22,0,1,1,0.568462,0.738668,0,"#00e8b2"
300405680,RED92cadadiamas,49,2,0,2,0.419578,0.56924,0.000486,"#ff7007"
300407444,ORMurcia,22,7,0,7,0.592543,0.644672,0.002918,"#00e8b2"
300486929,semevadlalengua,37,19,5,24,0.552848,0.569924,0.011187,"#006032"
300487713,sergio_gpz,22,0,1,1,0.907323,0.762322,0,"#00e8b2"
300504487,pheraspu,37,0,1,1,0.69331,0.498934,0,"#006032"
300511083,Mdoloresdv,30,0,1,1,0.723753,0.615322,0,"#ff77ff"
300722675,VAlgarra,31,0,3,3,0.683586,0.560373,0.000973,"#3e93ff"
300727580,alcosti,49,1,0,1,0.330006,0.663753,0,"#ff7007"
300868924,EU_Eurostat,2,1,0,1,0.306757,0.427912,0,"#ffa64e"
300878835,CristinaRLuque,2,0,1,1,0.393003,0.555309,0,"#ffa64e"
300887149,AlexvonKarma,15,0,1,1,0.607908,0.554008,0,"#008ebb"
300890894,MLAnews,34,9,0,9,0.45299,0.440156,0.003891,"#ff0d69"
300894040,RosaSensat,8,2,0,2,0.634519,0.332611,0.000486,"#00ed5d"
300894363,1967j,40,0,1,1,0.619388,0.048138,0,"#ff12a3"
300989530,JLBAZALDUA,7,0,2,2,0.383722,0.367279,0.000486,"#ffb800"
301010345,JosepLlados,14,5,2,7,0.556157,0.579296,0.002918,"#00eeff"
301033803,ugucoc,2,0,1,1,0.738935,0.708803,0,"#ffa64e"
301083251,maciejmaryl,36,0,1,1,0.550643,0.626185,0,"#825403"
301237333,dastein283,36,0,1,1,0.430389,0.346398,0,"#825403"
301302495,masanti75,2,1,11,12,0.54456,0.539318,0.00535,"#ffa64e"
301318016,Iacobus_Santi,19,0,2,2,0.592421,0.406429,0.000486,"#00d3ff"
301424927,CPInnovacion,22,1,0,1,0.624936,0.489822,0,"#00e8b2"
301455456,AlbaRedhead,22,0,1,1,0.606146,0.645482,0,"#00e8b2"
301529829,ImjuveMX,42,1,0,1,0.813466,0.421413,0,"#66e087"
301536057,ZalMahal,40,0,1,1,0.614334,0.031015,0,"#ff12a3"
301539386,rodri_verano,22,3,1,4,0.737748,0.281504,0.001459,"#00e8b2"
301547461,ibansuamed,2,0,2,2,0.672547,0.666189,0.000486,"#ffa64e"
301934830,ArmelaDi,30,0,5,5,0.529366,0.556196,0.001946,"#ff77ff"
301945604,ACEcultura,0,25,6,31,0.538313,0.590201,0.014591,"#8ecfec"
301987019,UBUinvestiga,37,5,2,7,0.629376,0.393204,0.002918,"#006032"
302031086,DianaSerLo,49,1,0,1,0.359207,0.669062,0,"#ff7007"
302113463,aggdev,30,0,1,1,0.524217,0.614765,0,"#ff77ff"
302129033,mariamodu,2,0,2,2,0.69233,0.658541,0.000486,"#ffa64e"
302138009,rostrocentauro,58,0,1,1,0.580157,0.171047,0,"#005076"
302210449,CEPHCIS_UNAM_MX,7,0,2,2,0.438709,0.206168,0.000486,"#ffb800"
302214601,MJesusRosado,22,7,3,10,0.457574,0.520598,0.004377,"#00e8b2"
302228892,BibUtopia,49,11,12,23,0.447736,0.524348,0.0107,"#ff7007"
302240813,CarmenTenor,14,4,0,4,0.565878,0.526255,0.001459,"#00eeff"
302504735,ilizasoain,30,2,0,2,0.577262,0.563061,0.000486,"#ff77ff"
302512200,javierlaporta,2,0,1,1,0.743737,0.518931,0,"#ffa64e"
302533475,RodriguezAllue,22,1,0,1,0.625512,0.692357,0,"#00e8b2"
302536579,ArantxaDRL,19,0,1,1,0.609186,0.458583,0,"#00d3ff"
302548109,nostocanatodas,40,0,1,1,0.57641,0.017835,0,"#ff12a3"
302626348,LauraMorRom,37,0,4,4,0.51618,0.535357,0.001459,"#006032"
302716204,Toni_M_Arboleda,13,1,0,1,0.329433,0.335572,0,"#3bec00"
302785483,Sanlago1,49,0,3,3,0.408298,0.541967,0.000973,"#ff7007"
302824276,sandroenriquez,21,0,2,2,0.227376,0.244899,0.000486,"#c6cc85"
302837235,Helvidiuss,21,0,1,1,0.207158,0.210393,0,"#c6cc85"
302841600,ISRIV,30,0,6,6,0.460844,0.533535,0.002432,"#ff77ff"
302878190,Clara_Bella_,21,0,1,1,0.270843,0.201742,0,"#c6cc85"
302936026,jalonsoregalado,38,0,6,6,0.475074,0.466565,0.002432,"#662859"
303107068,mar__san,3,0,1,1,0.473398,0.670618,0,"#ffb3ff"
303150396,olminguez,22,0,1,1,0.601047,0.591908,0,"#00e8b2"
303152298,PerezBonmati,15,0,3,3,0.570109,0.555817,0.000973,"#008ebb"
303158123,yasminaromero,14,0,1,1,0.593104,0.486005,0,"#00eeff"
303195346,selenadaly,36,0,1,1,0.416847,0.576889,0,"#825403"
303266402,BertheTrepatt,58,0,1,1,0.558846,0.726994,0,"#005076"
303307634,mancem,31,0,1,1,0.711917,0.533294,0,"#3e93ff"
303349093,EMILIOMARINROIG,22,0,2,2,0.694669,0.752723,0.000486,"#00e8b2"
303357513,jl_hoyas,31,0,4,4,0.588116,0.534131,0.001459,"#3e93ff"
303375836,Manuel_Gomez_Ra,49,1,0,1,0.351393,0.671306,0,"#ff7007"
303404958,niduato,40,0,1,1,0.649842,0.02582,0,"#ff12a3"
303476998,tomascarralero,14,0,4,4,0.520875,0.544628,0.001459,"#00eeff"
303480108,escartxa,15,6,10,16,0.481542,0.549862,0.007296,"#008ebb"
303505461,carinalion,31,0,1,1,0.653422,0.512559,0,"#3e93ff"
303635928,txtdgtl,13,8,21,29,0.512241,0.472032,0.013619,"#3bec00"
303756804,lourdesmoyasan,1,0,1,1,0.382953,0.545686,0,"#b6cb00"
303772119,IHRDigHist,34,1,3,4,0.504284,0.421157,0.001459,"#ff0d69"
303864976,ComunicaUAO,37,1,0,1,0.537182,0.23021,0,"#006032"
303889202,ImpactHubDSS,18,0,1,1,0.763007,0.627825,0,"#5456a6"
303918417,miguelRodrivera,58,0,1,1,0.652051,0.349861,0,"#005076"
303949762,92Estrella,31,0,16,16,0.534406,0.531702,0.007296,"#3e93ff"
303960544,KikeAndivia,22,0,1,1,0.650266,0.468159,0,"#00e8b2"
303980445,educarportal,8,22,0,22,0.502113,0.718445,0.010214,"#00ed5d"
304068174,J_S_Orozco,1,0,1,1,0.578494,0.826082,0,"#b6cb00"
304221736,pakofran,13,0,2,2,0.435413,0.226777,0.000486,"#3bec00"
304314971,eSaludInvestiga,22,0,1,1,0.379624,0.193799,0,"#00e8b2"
304316780,CSICdivulga,22,8,6,14,0.543847,0.559912,0.006323,"#00e8b2"
304328950,alejandravf2705,38,2,6,8,0.458811,0.351963,0.003405,"#662859"
304337483,fguma,14,2,1,3,0.648076,0.503028,0.000973,"#00eeff"
304338078,UABBarcelona,14,31,3,34,0.547051,0.528782,0.016051,"#00eeff"
304342684,AmparoRubiales,1,13,1,14,0.683149,0.537695,0.006323,"#b6cb00"
304356220,GabrielArroyo2,1,0,2,2,0.671551,0.449722,0.000486,"#b6cb00"
304438690,ivanraulgb,38,0,1,1,0.649873,0.417912,0,"#662859"
304503701,aidagraciela70,4,0,1,1,0.851204,0.23526,0,"#f4c8cf"
304504746,SUZU_DOS,21,0,1,1,0.254149,0.197747,0,"#c6cc85"
304552780,indibiljavi,22,0,2,2,0.564595,0.615137,0.000486,"#00e8b2"
304568816,KatieSony,30,0,1,1,0.501532,0.629769,0,"#ff77ff"
304568842,Omarsauld,38,0,2,2,0.660448,0.423007,0.000486,"#662859"
304678519,LudovicCelle,13,0,2,2,0.452221,0.325979,0.000486,"#3bec00"
304698232,jorvog,30,0,1,1,0.542823,0.738855,0,"#ff77ff"
304747483,cynmoto,22,0,1,1,0.274526,0.455843,0,"#00e8b2"
304795421,CardiffBookHist,36,0,1,1,0.434414,0.588941,0,"#825403"
304822355,mmvty,13,0,1,1,0.380325,0.437758,0,"#3bec00"
304901172,CDEufv,30,0,1,1,0.591082,0.557196,0,"#ff77ff"
304957681,BlankTextField,13,0,1,1,0.422378,0.500774,0,"#3bec00"
304990157,noeliaclasica,40,0,1,1,0.613677,0.015144,0,"#ff12a3"
305032933,Albertovicentep,22,0,1,1,0.68828,0.533438,0,"#00e8b2"
305060861,Klauz_G,49,1,0,1,0.317141,0.64836,0,"#ff7007"
305080808,estupefalso,19,0,3,3,0.660699,0.755916,0.000973,"#00d3ff"
305086857,EmilioLorenteYo,40,0,1,1,0.665647,0.04034,0,"#ff12a3"
305108736,CeciliaPortilla,14,0,1,1,0.580235,0.484748,0,"#00eeff"
305172448,TribunaSal,58,0,2,2,0.462515,0.629168,0.000486,"#005076"
305191432,lila_pinto,3,18,3,21,0.485877,0.549422,0.009728,"#ffb3ff"
305194289,erederbez,13,0,1,1,0.448111,0.313174,0,"#3bec00"
305259965,LuzMariaChavez1,49,1,0,1,0.426385,0.680506,0,"#ff7007"
305321115,blancaecarrada,58,0,1,1,0.64692,0.686803,0,"#005076"
305457580,antonio_arnau,19,1,0,1,0.607001,0.795109,0,"#00d3ff"
305475599,egalsori,49,1,0,1,0.328098,0.672193,0,"#ff7007"
305641639,madrid__cultura,14,1,0,1,0.400622,0.533284,0,"#00eeff"
305704347,Missmerh,1,0,1,1,0.415568,0.78956,0,"#b6cb00"
305818954,DRE_UNAL,37,0,1,1,0.410692,0.366744,0,"#006032"
305920342,LuaracdP,35,11,3,14,0.463083,0.568868,0.006323,"#00faff"
306118580,alex_guillot,14,0,1,1,0.505252,0.660448,0,"#00eeff"
306144899,Comafa_UGR,31,1,0,1,0.681082,0.609922,0,"#3e93ff"
306214163,quesique___,30,0,1,1,0.593192,0.668971,0,"#ff77ff"
306245721,UNESCO_es,30,1,0,1,0.509847,0.628413,0,"#ff77ff"
306350887,danielcbogota,38,0,2,2,0.534279,0.430686,0.000486,"#662859"
306372993,museodelchopo,13,1,0,1,0.388719,0.494782,0,"#3bec00"
306397976,ypr_67,15,0,4,4,0.545972,0.540681,0.001459,"#008ebb"
306535279,Milito2_0,21,0,1,1,0.207976,0.231973,0,"#c6cc85"
306547193,alan_tell,49,0,2,2,0.425599,0.593471,0.000486,"#ff7007"
306621503,FeriaTecne,14,0,2,2,0.61935,0.524841,0.000486,"#00eeff"
306805040,ealpv,13,0,1,1,0.422051,0.415256,0,"#3bec00"
306862429,elcorc,30,0,1,1,0.609694,0.440618,0,"#ff77ff"
306960902,nazarethfish,38,0,1,1,0.108907,0.43124,0,"#662859"
307101088,ClaudiaDides,21,0,1,1,0.170905,0.218385,0,"#c6cc85"
307123146,EJuriGuristari,42,0,1,1,0.839052,0.428037,0,"#66e087"
307234991,carlusserrano,31,0,1,1,0.668877,0.511689,0,"#3e93ff"
307271636,PatrimVirtual,15,3,0,3,0.470195,0.593234,0.000973,"#008ebb"
307297856,GonzaloBerger,19,2,0,2,0.678568,0.75558,0.000486,"#00d3ff"
307550177,lopez_miguel13,38,0,1,1,0.557583,0.409945,0,"#662859"
307556504,phipola,14,0,2,2,0.49727,0.587605,0.000486,"#00eeff"
307567151,mathigaELE,1,0,2,2,0.525299,0.684824,0.000486,"#b6cb00"
307572163,mgpros_eu,21,1,0,1,0.654927,0.166798,0,"#c6cc85"
307615990,ClimentMiro,14,0,1,1,0.606543,0.549502,0,"#00eeff"
307713764,digoesundecir,22,0,2,2,0.516355,0.514245,0.000486,"#00e8b2"
307900547,valylewis,3,0,1,1,0.602809,0.713012,0,"#ffb3ff"
307930856,QVisionGrafica,49,1,0,1,0.323175,0.63442,0,"#ff7007"
307950954,bizantinistica,30,0,1,1,0.470061,0.64664,0,"#ff77ff"
308138944,chiquitectos,0,0,1,1,0.422587,0.606577,0,"#8ecfec"
308391668,agonzaleznj,40,0,1,1,0.608971,0.037631,0,"#ff12a3"
308398091,PaolaSartoretto,36,3,0,3,0.511917,0.375642,0.000973,"#825403"
308404578,ARSF_Espana,35,3,0,3,0.407329,0.50095,0.000973,"#00faff"
308420567,MariaLaura_Rios,14,0,1,1,0.598845,0.59264,0,"#00eeff"
308487814,CVC_UAB,14,19,20,39,0.564942,0.569328,0.018482,"#00eeff"
308574964,CTilata,49,1,0,1,0.360513,0.596721,0,"#ff7007"
308617315,kelyahlaura,22,0,1,1,0.67932,0.681874,0,"#00e8b2"
308662969,nessbu,8,2,0,2,0.6632,0.286145,0.000486,"#00ed5d"
308702490,pirigoyen_,21,0,2,2,0.232721,0.232938,0.000486,"#c6cc85"
308954746,FSP_UGT_Guada,19,1,0,1,0.6935,0.774071,0,"#00d3ff"
309008607,fisiodelaserna,15,0,1,1,0.554927,0.722448,0,"#008ebb"
309043860,laschumanas,22,1,0,1,0.856277,0.749875,0,"#00e8b2"
309145377,futurosociologo,21,0,1,1,0.193057,0.210939,0,"#c6cc85"
309160091,FMVZUNAM,13,1,0,1,0.428122,0.298232,0,"#3bec00"
309223740,TaliaNieto,40,0,1,1,0.639239,0.039138,0,"#ff12a3"
309319376,humanizart,14,0,6,6,0.521415,0.552485,0.002432,"#00eeff"
309340625,Jotapelea,38,0,1,1,0.693249,0.408954,0,"#662859"
309549844,MeryCed,30,1,3,4,0.549994,0.604175,0.001459,"#ff77ff"
309572468,cued_,3,1,4,5,0.5638,0.54536,0.001946,"#ffb3ff"
309582114,MBezunartea,30,0,1,1,0.290641,0.228296,0,"#ff77ff"
309592277,JULMARZ,38,0,5,5,0.509079,0.490554,0.001946,"#662859"
309661843,alison_booth,49,0,2,2,0.375042,0.393119,0.000486,"#ff7007"
309813559,CaperucitaenM,13,0,11,11,0.504286,0.533856,0.004864,"#3bec00"
309879326,Delmartrad,30,4,2,6,0.539876,0.506772,0.002432,"#ff77ff"
310143531,sadurnimarti,34,7,2,9,0.442973,0.484524,0.003891,"#ff0d69"
310156720,ariel_brito,30,30,35,65,0.530567,0.576831,0.031128,"#ff77ff"
310221094,uramonllull,8,2,3,5,0.673373,0.330608,0.001946,"#00ed5d"
310351250,bc1burom,0,0,1,1,0.659849,0.623232,0,"#8ecfec"
310404943,fabiolafavila,2,0,1,1,0.756913,0.530551,0,"#ffa64e"
310406074,xelatics,0,0,1,1,0.353732,0.582373,0,"#8ecfec"
310481767,GorkaAzkoien,40,0,1,1,0.627828,0.041769,0,"#ff12a3"
310569076,Sisisilviaa,30,0,2,2,0.598758,0.616794,0.000486,"#ff77ff"
310596714,radioambulante,38,3,0,3,0.488492,0.42147,0.000973,"#662859"
310620514,alfre_avila,34,0,1,1,0.486271,0.261879,0,"#ff0d69"
310639809,cerosetenta,38,6,3,9,0.515021,0.497134,0.003891,"#662859"
310897418,AaronCuddeback,36,0,2,2,0.415686,0.377182,0.000486,"#825403"
311044066,Zareladas,14,1,0,1,0.678822,0.400247,0,"#00eeff"
311080722,drchrisjyoung,34,0,3,3,0.370447,0.384942,0.000973,"#ff0d69"
311214212,AnGaSoo,3,0,1,1,0.48856,0.750404,0,"#ffb3ff"
311464695,clemenciarodner,49,1,0,1,0.278394,0.632472,0,"#ff7007"
311465263,ConsTecnologica,49,1,0,1,0.303721,0.671393,0,"#ff7007"
311550374,raulmagallon,19,2,0,2,0.512694,0.693104,0.000486,"#00d3ff"
311640613,man_cebral,13,33,23,56,0.449457,0.513585,0.026751,"#3bec00"
311642543,DevelopNewMinds,30,0,1,1,0.511856,0.616548,0,"#ff77ff"
311706618,mlazaroto,30,0,5,5,0.521851,0.701,0.001946,"#ff77ff"
311888575,FundacionSeneca,37,1,1,2,0.623782,0.392591,0.000486,"#006032"
311903881,DIGHUMLAB,30,1,0,1,0.514881,0.621927,0,"#ff77ff"
311961582,cursosveranouc,22,3,3,6,0.568086,0.656883,0.002432,"#00e8b2"
311970047,SEDLL,15,12,2,14,0.489609,0.646968,0.006323,"#008ebb"
311976920,AncientRomeLive,22,0,4,4,0.640044,0.535048,0.001459,"#00e8b2"
311979693,astro_duque,30,8,0,8,0.548722,0.541395,0.003405,"#ff77ff"
312005020,JortTo,34,0,12,12,0.532542,0.482879,0.00535,"#ff0d69"
312023515,Jason_W_Dean,13,0,1,1,0.397317,0.391799,0,"#3bec00"
312143268,AlexMontero_Esp,58,0,2,2,0.636861,0.31042,0.000486,"#005076"
312216501,CSUC_info,14,1,0,1,0.696903,0.734833,0,"#00eeff"
312560433,baronmediopelo,14,0,2,2,0.547437,0.561263,0.000486,"#00eeff"
312759493,Koltharius,22,0,2,2,0.764619,0.534372,0.000486,"#00e8b2"
312896589,alexgarciadiez,22,0,2,2,0.622992,0.50256,0.000486,"#00e8b2"
313121914,FILMEmagazine,7,0,1,1,0.38782,0.286162,0,"#ffb800"
313139818,OFPIUGR,31,0,4,4,0.610505,0.546351,0.001459,"#3e93ff"
313293865,gerarmontoya,36,1,3,4,0.687118,0.347871,0.001459,"#825403"
313297821,EdiComplutense,14,3,2,5,0.477424,0.536411,0.001946,"#00eeff"
313378513,figudesign,38,0,1,1,0.301232,0.187385,0,"#662859"
313446000,JanelleJenstad,49,2,1,3,0.351185,0.519483,0.000973,"#ff7007"
313516695,uammanizales,9,2,0,2,0.708068,0.683838,0.000486,"#008f7b"
313550113,ralcarazm,22,6,9,15,0.561215,0.598035,0.006809,"#00e8b2"
313607229,Ayineisi,49,3,0,3,0.432583,0.543675,0.000973,"#ff7007"
313647725,LuisGonzalezyG,34,0,1,1,0.499494,0.37651,0,"#ff0d69"
313743463,MGC_UC3M,31,11,11,22,0.56657,0.561719,0.010214,"#3e93ff"
313866163,diana_peto,49,1,0,1,0.387808,0.697915,0,"#ff7007"
313905929,unico_es,15,0,2,2,0.564158,0.611133,0.000486,"#008ebb"
314014143,Zientzia,49,1,0,1,0.32419,0.658754,0,"#ff7007"
314030236,BibDeCastro,21,0,3,3,0.279466,0.250057,0.000973,"#c6cc85"
314054243,MappingGIS,55,0,1,1,0.609137,0.42806,0,"#cb3f32"
314088135,Ceix_es,58,0,1,1,0.560569,0.66208,0,"#005076"
314136481,victorgonvera,14,0,3,3,0.572016,0.529425,0.000973,"#00eeff"
314251825,annacromatica,49,1,0,1,0.380611,0.662496,0,"#ff7007"
314506211,LosSimsES,58,1,0,1,0.33954,0.572587,0,"#005076"
314520124,UexBiblioteca,49,8,6,14,0.485605,0.556661,0.006323,"#ff7007"
314542612,CursosVeranoUCM,36,6,0,6,0.539099,0.527559,0.002432,"#825403"
314687897,unsamoficial,37,13,3,16,0.303695,0.50889,0.007296,"#006032"
314768296,cosipellegrino,22,0,1,1,0.675761,0.571748,0,"#00e8b2"
314847285,letras15M,40,0,1,1,0.625461,0.023336,0,"#ff12a3"
314938902,nuvia55,49,1,0,1,0.403772,0.650477,0,"#ff7007"
314947670,DizhSa,13,3,0,3,0.548206,0.328905,0.000973,"#3bec00"
315146860,paco_segado,22,3,1,4,0.550215,0.573202,0.001459,"#00e8b2"
315215597,La_coronica,30,0,6,6,0.479579,0.559137,0.002432,"#ff77ff"
315262827,Jaime9mun,22,0,2,2,0.551206,0.62235,0.000486,"#00e8b2"
315301258,mier_rafa,38,1,0,1,0.620371,0.673191,0,"#662859"
315355772,sisifomx_,13,0,2,2,0.452827,0.323083,0.000486,"#3bec00"
315454130,jm_zaragoza,22,0,10,10,0.589105,0.415918,0.004377,"#00e8b2"
315461854,kik3garcia,31,0,2,2,0.608107,0.502904,0.000486,"#3e93ff"
315462595,chsanchezr,33,0,2,2,0.363171,0.525767,0.000486,"#ff8c00"
315574889,Danihilism,34,0,2,2,0.564621,0.38303,0.000486,"#ff0d69"
315705688,geacron,22,0,5,5,0.573137,0.573494,0.001946,"#00e8b2"
315940362,benuza9,13,0,1,1,0.528314,0.460218,0,"#3bec00"
315995432,bdemontork,13,0,1,1,0.380621,0.386962,0,"#3bec00"
316033701,SerdarTabakoglu,22,0,1,1,0.822592,0.336256,0,"#00e8b2"
316065344,rcasadoz,31,0,2,2,0.580163,0.530381,0.000486,"#3e93ff"
316116840,emmalkore,7,0,2,2,0.425796,0.334251,0.000486,"#ffb800"
316137557,EdwinArcilaF,38,0,1,1,0.12372,0.805819,0,"#662859"
316170386,RafaelApablaza,40,0,1,1,0.619992,0.039561,0,"#ff12a3"
316355792,culturaum,22,0,1,1,0.69868,0.746019,0,"#00e8b2"
316362380,Usurpado56,19,0,4,4,0.652232,0.755371,0.001459,"#00d3ff"
316400487,cfdeh,8,1,0,1,0.660756,0.251244,0,"#00ed5d"
316443182,Suka131,15,0,1,1,0.537217,0.728925,0,"#008ebb"
316554695,lolalortega,13,3,53,56,0.480367,0.482053,0.026751,"#3bec00"
316682585,hallpaz,36,0,1,1,0.472131,0.287289,0,"#825403"
316735764,gestionatur,13,0,2,2,0.437896,0.513052,0.000486,"#3bec00"
316819157,LauraTaube,49,0,1,1,0.367256,0.751277,0,"#ff7007"
316837082,cfacid,17,0,1,1,0.826697,0.219944,0,"#ff9cc7"
316945062,SimoneAlberto,49,3,0,3,0.44049,0.550237,0.000973,"#ff7007"
317003388,merilotta,58,0,7,7,0.521953,0.50878,0.002918,"#005076"
317107318,xaviermcelorrio,31,0,2,2,0.636396,0.494915,0.000486,"#3e93ff"
317164553,GrandesPymes,49,1,0,1,0.327485,0.629687,0,"#ff7007"
317264025,Ggarfri,30,0,2,2,0.464284,0.52945,0.000486,"#ff77ff"
317303312,ocixneros,3,0,2,2,0.576739,0.5643,0.000486,"#ffb3ff"
317306038,MauricioLoboR,3,0,1,1,0.494039,0.747167,0,"#ffb3ff"
317328512,f_ranciscolopes,36,0,11,11,0.466387,0.482363,0.004864,"#825403"
317369617,jmbbnet,38,0,1,1,0.319705,0.16886,0,"#662859"
317388105,aIejandro_esva,13,0,5,5,0.466132,0.44024,0.001946,"#3bec00"
317429351,DHInstitute,13,8,5,13,0.480296,0.430211,0.005837,"#3bec00"
317514323,rubencito_pimen,49,0,1,1,0.081756,0.640106,0,"#ff7007"
317555895,alzilei,13,11,4,15,0.486898,0.462356,0.006809,"#3bec00"
317700456,ignaciolopet,22,0,1,1,0.700393,0.743724,0,"#00e8b2"
317707340,OFransisco,49,2,0,2,0.418182,0.565177,0.000486,"#ff7007"
317755719,dariocedres,22,0,1,1,0.396806,0.593702,0,"#00e8b2"
317803709,ocsalevj,34,1,0,1,0.378579,0.432759,0,"#ff0d69"
317846722,Sheilapastor_,58,0,1,1,0.572555,0.720517,0,"#005076"
317861362,SB_PUCMM,1,1,0,1,0.545683,0.678966,0,"#b6cb00"
317897447,vegawinslet,58,2,10,12,0.507503,0.537602,0.00535,"#005076"
317998075,ssantovena,30,2,1,3,0.492378,0.722614,0.000973,"#ff77ff"
318081369,redisybd_unam,7,0,1,1,0.638768,0.366699,0,"#ffb800"
318088798,offrayLC,13,1,0,1,0.392337,0.383497,0,"#3bec00"
318176401,PTGuatiguara,34,1,0,1,0.653583,0.174343,0,"#ff0d69"
318319298,MartaRivera06,0,0,2,2,0.311082,0.582147,0.000486,"#8ecfec"
318420513,mdegiusti,49,2,0,2,0.419981,0.556171,0.000486,"#ff7007"
318464687,FurryLibrarian,30,7,44,51,0.546987,0.565391,0.024319,"#ff77ff"
318557516,ArtesUV,52,2,1,3,0.929293,0.776054,0.000973,"#b56eed"
318562341,fmamanif,14,2,11,13,0.526545,0.484903,0.005837,"#00eeff"
318635483,PoliticaMemoria,22,1,2,3,0.558755,0.5798,0.000973,"#00e8b2"
318639748,agudeloparra,13,1,2,3,0.438279,0.531057,0.000973,"#3bec00"
318650032,RubnAlmGon,30,0,2,2,0.495526,0.57993,0.000486,"#ff77ff"
318701449,FundacionTefPe,0,0,1,1,0.349322,0.555436,0,"#8ecfec"
318711008,MunozPalma,21,0,1,1,0.342671,0.454721,0,"#c6cc85"
318952306,Mustislectora,14,0,2,2,0.439687,0.527103,0.000486,"#00eeff"
318953493,FMontecruz,30,0,1,1,0.599078,0.688068,0,"#ff77ff"
318993513,joserequenaidv,49,1,0,1,0.403643,0.69124,0,"#ff7007"
319104328,anamancera,1,6,0,6,0.477216,0.602997,0.002432,"#b6cb00"
319210602,ledismo,8,2,6,8,0.558633,0.421772,0.003405,"#00ed5d"
319421277,El_bichote,34,1,0,1,0.399246,0.45338,0,"#ff0d69"
319721896,elroto_rss,31,3,0,3,0.630442,0.492177,0.000973,"#3e93ff"
319749788,orbis_imagines,14,0,6,6,0.575309,0.495331,0.002432,"#00eeff"
319769248,e_paniagua,14,1,1,2,0.545265,0.584061,0.000486,"#00eeff"
319818180,LuzRendonB,10,0,1,1,0.694431,0.804347,0,"#52d7c0"
319929827,ottodelgadoz,42,0,1,1,0.914116,0.439094,0,"#66e087"
320040426,AndersonAlv_,34,0,1,1,0.54444,0.343945,0,"#ff0d69"
320298773,perrycollins,34,0,2,2,0.365211,0.41639,0.000486,"#ff0d69"
320389932,lfrg22,38,0,1,1,0.112171,0.793794,0,"#662859"
320458893,gomezmariacami,38,1,0,1,0.678318,0.486774,0,"#662859"
320583242,CFMorante,55,1,1,2,0.249677,0.528397,0.000486,"#cb3f32"
320676650,EnriqueBerzal1,30,0,2,2,0.673546,0.633024,0.000486,"#ff77ff"
320798310,AlegraAlonso,58,0,1,1,0.431233,0.632594,0,"#005076"
320853278,Radinitocmoi,13,0,1,1,0.431407,0.372531,0,"#3bec00"
320863192,estherveraARA,8,1,0,1,0.668346,0.236748,0,"#00ed5d"
321094958,DianaUribefm,38,1,0,1,0.561951,0.372623,0,"#662859"
321176894,MikelGaxiola,14,0,2,2,0.515148,0.453338,0.000486,"#00eeff"
321249811,Die30p,30,0,3,3,0.541617,0.562013,0.000973,"#ff77ff"
321296493,unipv,30,2,2,4,0.481366,0.577766,0.001459,"#ff77ff"
321357579,FCEBUAP_Oficial,17,0,1,1,0.645082,0.272875,0,"#ff9cc7"
321449115,MauToscano,30,15,14,29,0.537739,0.526235,0.013619,"#ff77ff"
321479703,DeepSky91,38,0,1,1,0.070881,0.440327,0,"#662859"
321652274,PatriciaSonria,49,0,3,3,0.41461,0.53649,0.000973,"#ff7007"
321736843,EdoCoronado,38,0,1,1,0.443153,0.771936,0,"#662859"
321774364,flaminioreyes,34,0,1,1,0.565388,0.337932,0,"#ff0d69"
321808581,mercedesmontalv,21,0,2,2,0.297453,0.238444,0.000486,"#c6cc85"
321943742,FgNaharro,22,0,2,2,0.595695,0.629537,0.000486,"#00e8b2"
322016721,ArquivoBrasil,36,37,6,43,0.540195,0.359204,0.020428,"#825403"
322049843,oscarchivite,14,0,1,1,0.619922,0.645552,0,"#00eeff"
322060173,g_garrigos,49,1,0,1,0.373263,0.684902,0,"#ff7007"
322095041,PFLLera,30,0,1,1,0.481605,0.628189,0,"#ff77ff"
322172045,CONICETDialoga,13,20,0,20,0.449234,0.518503,0.009241,"#3bec00"
322525427,simon_menendez,37,0,2,2,0.634065,0.49153,0.000486,"#006032"
322696603,Noemi_Cadena_C,13,0,1,1,0.364377,0.378945,0,"#3bec00"
322872189,jbarler,14,0,2,2,0.561196,0.517354,0.000486,"#00eeff"
322884518,Natoroz,49,1,0,1,0.344004,0.614398,0,"#ff7007"
323016067,hippocampuz,7,0,1,1,0.372226,0.368272,0,"#ffb800"
323109170,VisionArtif,22,2,0,2,0.557167,0.6318,0.000486,"#00e8b2"
323267630,SilvieTarazona,14,6,2,8,0.478466,0.494524,0.003405,"#00eeff"
323306871,fundacomunes,36,6,0,6,0.566274,0.431349,0.002432,"#825403"
323501925,PILAS_postgrads,38,2,0,2,0.459606,0.324476,0.000486,"#662859"
323547848,mangoconfresaa,10,0,2,2,0.402235,0.320317,0.000486,"#52d7c0"
323832779,jamescosullivan,36,0,2,2,0.573881,0.410019,0.000486,"#825403"
323892543,JohnBrockman,3,6,0,6,0.444637,0.567066,0.002432,"#ffb3ff"
324043767,Biblioteca_UNCo,49,1,3,4,0.408497,0.53874,0.001459,"#ff7007"
324158902,miguelangelcer2,7,0,1,1,0.406297,0.326347,0,"#ffb800"
324234686,AplecClassiques,30,0,1,1,0.561032,0.644244,0,"#ff77ff"
324360148,SireHisp,35,0,2,2,0.607181,0.45657,0.000486,"#00faff"
324447694,RNuevoMundo,21,0,2,2,0.244686,0.220717,0.000486,"#c6cc85"
324514309,arturoMesc,49,1,0,1,0.340346,0.649684,0,"#ff7007"
324577347,ChemaMunozRosa,2,0,1,1,0.736217,0.532738,0,"#ffa64e"
324626329,MauricioPinzonB,9,0,2,2,0.653244,0.915081,0.000486,"#008f7b"
324775344,BecasMexicanos,1,1,0,1,0.388118,0.535384,0,"#b6cb00"
324808442,AlexMarCasado,0,0,2,2,0.580043,0.561016,0.000486,"#8ecfec"
324825074,adiazmendez,30,1,0,1,0.708655,0.673756,0,"#ff77ff"
324855683,beisadlt,14,0,6,6,0.553263,0.549415,0.002432,"#00eeff"
324870812,albabgar,49,3,3,6,0.47636,0.547588,0.002432,"#ff7007"
324881278,lizlorang,34,1,0,1,0.383105,0.453536,0,"#ff0d69"
324903879,EduRobalinoV,49,1,0,1,0.356588,0.674921,0,"#ff7007"
324914653,tekneo_lv,37,2,0,2,0.531765,0.326174,0.000486,"#006032"
324948058,MirtaBrand,49,1,0,1,0.366995,0.687444,0,"#ff7007"
324960202,josperello,22,1,0,1,0.664444,0.529776,0,"#00e8b2"
325029400,saynotocaroline,36,0,2,2,0.507348,0.296399,0.000486,"#825403"
325100970,hypothes_is,13,1,0,1,0.568743,0.41588,0,"#3bec00"
325118061,dipMurcia,22,3,0,3,0.635881,0.691574,0.000973,"#00e8b2"
325243541,tmglatam,49,1,0,1,0.379825,0.615726,0,"#ff7007"
325255181,IIJONGUI,37,0,1,1,0.453881,0.203044,0,"#006032"
325351066,ivillanueva28,34,0,1,1,0.567258,0.322424,0,"#ff0d69"
325437911,bbvaOpenMind,15,0,1,1,0.70752,0.656634,0,"#008ebb"
325443810,salarroya,49,0,1,1,0.488609,0.60694,0,"#ff7007"
325608198,BEGONIA11,10,0,1,1,0.329896,0.476024,0,"#52d7c0"
325623276,ICYT_UC3M,19,19,22,41,0.575126,0.583928,0.019455,"#00d3ff"
325879132,Fundacion_UNAM,7,1,0,1,0.399852,0.307324,0,"#ffb800"
326001946,adrianita_vive,13,0,2,2,0.5014,0.373961,0.000486,"#3bec00"
326065259,CienciatkCSIC,22,0,5,5,0.564384,0.557818,0.001946,"#00e8b2"
326219748,mySTILUS,37,2,3,5,0.544606,0.509886,0.001946,"#006032"
326245041,UCC_SPLAS,30,1,0,1,0.596062,0.435491,0,"#ff77ff"
326362906,RbkMej,13,0,4,4,0.484795,0.418247,0.001459,"#3bec00"
326412104,azambranosz,38,0,1,1,0.594667,0.350374,0,"#662859"
326492315,DavidGarcia777,38,0,1,1,0.102982,0.798531,0,"#662859"
326528154,profetadetrana,21,0,1,1,0.333103,0.452488,0,"#c6cc85"
326529723,MusicaDigitall,22,1,0,1,0.521262,0.678133,0,"#00e8b2"
326595517,CarGilSuz,34,0,2,2,0.553593,0.352205,0.000486,"#ff0d69"
326736898,TheaPitman,30,0,15,15,0.487344,0.468752,0.006809,"#ff77ff"
326806989,Hekpuente,13,0,1,1,0.405202,0.494844,0,"#3bec00"
326822288,djp2025,36,1,1,2,0.410755,0.473237,0.000486,"#825403"
326828097,Oskarvaler,30,0,1,1,0.606749,0.668261,0,"#ff77ff"
326881078,CCazueli,0,0,1,1,0.272824,0.490921,0,"#8ecfec"
326895459,ninacasmen,7,0,1,1,0.378178,0.205066,0,"#ffb800"
326927622,PTomeM,22,0,15,15,0.512184,0.553889,0.006809,"#00e8b2"
326959874,alex_forman,36,0,2,2,0.472132,0.352017,0.000486,"#825403"
326964995,luisrolando12,30,0,1,1,0.647353,0.696717,0,"#ff77ff"
327040680,elenab_flores,30,1,7,8,0.504445,0.559565,0.003405,"#ff77ff"
327146276,ImperioCaliban,13,0,3,3,0.564816,0.430877,0.000973,"#3bec00"
327166139,historiapesante,34,0,5,5,0.491579,0.441891,0.001946,"#ff0d69"
327172291,monicar_gl,37,0,1,1,0.184617,0.473609,0,"#006032"
327301533,MarisaLlorens,37,0,1,1,0.452086,0.616117,0,"#006032"
327712253,NicollCast,21,0,1,1,0.028213,0.619912,0,"#c6cc85"
327746358,HilmarRE,49,0,1,1,0.389732,0.528115,0,"#ff7007"
327996189,ElEstadoDeLaRed,49,1,0,1,0.380554,0.692149,0,"#ff7007"
328042475,Gloria_Ll,22,0,2,2,0.628219,0.553802,0.000486,"#00e8b2"
328408326,mjmjalonso62,1,0,2,2,0.494534,0.643784,0.000486,"#b6cb00"
328456385,elpincho_net,20,0,1,1,0.383568,0.02826,0,"#f0be45"
328561113,smcalata,30,1,1,2,0.58013,0.653071,0.000486,"#ff77ff"
328659624,javessur,30,6,13,19,0.542317,0.535341,0.008755,"#ff77ff"
328739130,heradiazlinco,21,0,1,1,0.203603,0.228304,0,"#c6cc85"
328802248,MartinMontesM,40,0,1,1,0.563924,0.013904,0,"#ff12a3"
329179709,olgalvi,30,0,1,1,0.540228,0.643874,0,"#ff77ff"
329246702,dhgermany,30,1,4,5,0.494031,0.486708,0.001946,"#ff77ff"
329315514,malaga,14,1,0,1,0.606558,0.377525,0,"#00eeff"
329359149,srtavenegas,15,0,2,2,0.606039,0.635414,0.000486,"#008ebb"
329566868,BamadGalicia,19,4,0,4,0.668558,0.610349,0.001459,"#00d3ff"
329593494,ConcelloOurense,30,1,0,1,0.59027,0.701233,0,"#ff77ff"
329634618,AliciaOtero19,40,0,1,1,0.606823,0.004003,0,"#ff12a3"
329684252,mar09i,49,0,1,1,0.492012,0.685871,0,"#ff7007"
329699082,soyingridbeck,34,1,0,1,0.422241,0.477437,0,"#ff0d69"
329702029,SujetoCallejero,38,0,1,1,0.305317,0.160976,0,"#662859"
329712294,lilicastillo17,49,0,4,4,0.408426,0.496912,0.001459,"#ff7007"
329844724,InstDeFilosofia,13,0,19,19,0.472416,0.480321,0.008755,"#3bec00"
329847199,tmfiguerola,14,0,1,1,0.630223,0.657486,0,"#00eeff"
329876465,aaaArchiveros,19,4,3,7,0.567471,0.578078,0.002918,"#00d3ff"
329912043,jaumereus,14,1,0,1,0.643185,0.582186,0,"#00eeff"
329946948,innovatics_,30,7,0,7,0.439299,0.50829,0.002918,"#ff77ff"
330019860,NelidaEsterRey,49,1,0,1,0.343422,0.680052,0,"#ff7007"
330059174,Cleivag,21,0,1,1,0.314676,0.445019,0,"#c6cc85"
330264995,TizMancinelli,13,1,11,12,0.457313,0.483502,0.00535,"#3bec00"
330469770,PrensaCONADU,49,1,0,1,0.392639,0.615242,0,"#ff7007"
330614994,jornaldomacico,36,0,1,1,0.506343,0.302906,0,"#825403"
330899969,luisalfonsosp,0,0,2,2,0.840301,0.431272,0.000486,"#8ecfec"
331048757,uv_mx,13,1,0,1,0.411288,0.46839,0,"#3bec00"
331059057,ArquivoRS,36,12,1,13,0.551544,0.325844,0.005837,"#825403"
331064775,Red_HD,13,1005,307,1312,0.485171,0.473076,0.637646,"#3bec00"
331125343,rachelrv13,15,0,1,1,0.603203,0.631706,0,"#008ebb"
331195870,RicardoMPimenta,49,105,100,205,0.497284,0.456346,0.099222,"#ff7007"
331340802,LuisMartinezSo,21,1,1,2,0.483813,0.317147,0.000486,"#c6cc85"
331378898,RubiCroft,49,1,0,1,0.386864,0.689611,0,"#ff7007"
331571061,valdeazogues,22,0,1,1,0.590469,0.629734,0,"#00e8b2"
331577538,imaxinsoftware,0,1,1,2,0.453059,0.600661,0.000486,"#8ecfec"
331636117,cantunivillate,14,0,3,3,0.450902,0.546616,0.000973,"#00eeff"
331637047,everdcita,31,0,3,3,0.601249,0.515956,0.000973,"#3e93ff"
331701540,amasamune54,19,0,4,4,0.564693,0.690271,0.001459,"#00d3ff"
331754212,patticarrascosa,15,0,2,2,0.536777,0.720235,0.000486,"#008ebb"
331804081,Alejandro_Egea,22,1,0,1,0.78385,0.709565,0,"#00e8b2"
331841381,SandraFerrerV,19,9,0,9,0.624629,0.730912,0.003891,"#00d3ff"
331959569,ProfeGaspar,41,1,0,1,0.247441,0.335004,0,"#697b00"
331973137,epuentese,21,0,1,1,0.1473,0.60571,0,"#c6cc85"
332114072,TamaraMoyaJ,31,0,1,1,0.720849,0.266964,0,"#3e93ff"
332228637,gatitomiau7,4,0,1,1,0.862827,0.22251,0,"#f4c8cf"
332296571,minerva_campos,49,1,0,1,0.282524,0.641595,0,"#ff7007"
332399168,sergiolavandero,21,0,1,1,0.038199,0.644903,0,"#c6cc85"
332444254,DiarideGuerra,19,1,0,1,0.659327,0.766004,0,"#00d3ff"
332912007,jgsogo,37,0,3,3,0.500039,0.513015,0.000973,"#006032"
333146582,GerardoBustosP,15,0,1,1,0.521835,0.695419,0,"#008ebb"
333333116,EEANorwayGrants,36,1,0,1,0.617568,0.284288,0,"#825403"
333351635,DeustoResearch,22,1,0,1,0.649816,0.310138,0,"#00e8b2"
333375166,EmbaMexBra,22,1,3,4,0.472454,0.471996,0.001459,"#00e8b2"
333442765,crisanfres,14,0,2,2,0.622873,0.526257,0.000486,"#00eeff"
333657515,Webstranet,38,0,1,1,0.66514,0.418552,0,"#662859"
333728695,piscoluna,2,0,2,2,0.678966,0.66817,0.000486,"#ffa64e"
333898596,gob_na,1,2,0,2,0.680321,0.47449,0.000486,"#b6cb00"
333977447,Mapy_Biblioteca,30,0,4,4,0.549866,0.581192,0.001459,"#ff77ff"
333992172,COAMadrid,58,0,1,1,0.568858,0.166725,0,"#005076"
334138218,sinarquitectura,31,0,3,3,0.597921,0.539484,0.000973,"#3e93ff"
334144942,Panama_Mia,49,1,0,1,0.36508,0.658541,0,"#ff7007"
334283834,tuerkka,49,4,1,5,0.477164,0.539596,0.001946,"#ff7007"
334283874,martaep_mep,37,0,10,10,0.529924,0.540027,0.004377,"#006032"
334291387,A___Moreno,58,0,2,2,0.603728,0.300068,0.000486,"#005076"
334317918,_JoyCastro,34,0,2,2,0.34452,0.411539,0.000486,"#ff0d69"
334376075,conchi_lulu,49,1,0,1,0.36151,0.632938,0,"#ff7007"
334589577,INTECCAUNED,30,2,2,4,0.534434,0.58951,0.001459,"#ff77ff"
334637487,MarcialAGP,13,0,2,2,0.48458,0.423803,0.000486,"#3bec00"
334765721,silvia_zarza,30,0,1,1,0.507329,0.624195,0,"#ff77ff"
334797670,Mayito33dc,49,1,0,1,0.363216,0.67273,0,"#ff7007"
334857096,CamiloCG0,38,0,1,1,0.421882,0.760441,0,"#662859"
334930037,ninadhora,36,10,1,11,0.47259,0.301515,0.004864,"#825403"
334967360,_fernw3h,36,1,1,2,0.455639,0.331544,0.000486,"#825403"
335015982,MiguelitoMiau,55,0,1,1,0.609171,0.423837,0,"#cb3f32"
335047697,cevibe5,22,0,3,3,0.568278,0.485517,0.000973,"#00e8b2"
335115960,sefigue,3,0,3,3,0.492415,0.635659,0.000973,"#ffb3ff"
335195647,EduMNavarro,19,0,3,3,0.612478,0.588758,0.000973,"#00d3ff"
335213654,sergio_isalu,15,0,7,7,0.570998,0.590128,0.002918,"#008ebb"
335308535,javierarroyave2,38,0,1,1,0.610903,0.359095,0,"#662859"
335342198,Marianapennab,21,0,1,1,0.00565,0.636894,0,"#c6cc85"
335496078,GabrielTorresEs,3,0,6,6,0.530718,0.709758,0.002432,"#ffb3ff"
335758992,MundoCyberia,49,1,0,1,0.394698,0.662879,0,"#ff7007"
335785958,AmalioFD,49,1,0,1,0.356249,0.59865,0,"#ff7007"
335846630,donalcisnelles,38,0,3,3,0.698753,0.599085,0.000973,"#662859"
335851779,osovan,30,0,1,1,0.548144,0.669865,0,"#ff77ff"
335904204,Katzenjammerrrr,3,0,2,2,0.444184,0.652885,0.000486,"#ffb3ff"
335917254,ConchiGonzalezD,2,0,6,6,0.609638,0.524619,0.002432,"#ffa64e"
336026818,hannusalmi,13,7,1,8,0.464721,0.448296,0.003405,"#3bec00"
336168071,anonymousdatero,38,0,1,1,0.448373,0.782307,0,"#662859"
336321643,daiane_rossi,36,17,5,22,0.408751,0.409835,0.010214,"#825403"
336365509,altamiranolili,0,0,2,2,0.446471,0.395977,0.000486,"#8ecfec"
336770061,estephaniemx,13,0,1,1,0.498447,0.31847,0,"#3bec00"
336868387,vschinazi,14,1,0,1,0.606255,0.37336,0,"#00eeff"
336907309,IbargurenM,13,0,1,1,0.628267,0.985474,0,"#3bec00"
337215202,lcBolados,19,0,1,1,0.634183,0.643055,0,"#00d3ff"
337307484,ionetsas,38,0,1,1,0.442364,0.784561,0,"#662859"
337309997,ramonmontanera,49,1,0,1,0.409382,0.65809,0,"#ff7007"
337594299,1Majococa,30,0,1,1,0.511723,0.619561,0,"#ff77ff"
337666392,LpezLilia,49,1,0,1,0.313778,0.623368,0,"#ff7007"
337679391,iriscara,55,0,5,5,0.666215,0.668145,0.001946,"#cb3f32"
337712653,blagarmar,1,0,1,1,0.450895,0.644284,0,"#b6cb00"
337715207,Makova_,31,0,6,6,0.597279,0.534654,0.002432,"#3e93ff"
337952858,OmarMandujanoB,41,0,1,1,0.332209,0.391306,0,"#697b00"
337965530,erwinconcua,36,0,2,2,0.779356,0.614247,0.000486,"#825403"
338045293,martinez_xavi,4,0,4,4,0.906534,0.240978,0.001459,"#f4c8cf"
338114615,skamin_mty,13,0,3,3,0.456807,0.493017,0.000973,"#3bec00"
338315801,allhoff_joachim,36,2,7,9,0.428236,0.371828,0.003891,"#825403"
338322529,lgfrade,13,0,1,1,0.425391,0.288408,0,"#3bec00"
338356325,MaraJosCarrizo,30,0,1,1,0.491592,0.620808,0,"#ff77ff"
338382040,CapitanApiacho,49,1,0,1,0.413083,0.648773,0,"#ff7007"
338532498,MEC_Uruguay,55,0,1,1,0.689013,0.692542,0,"#cb3f32"
338543729,juandmarin,38,0,2,2,0.467368,0.385356,0.000486,"#662859"
338551008,ALMUDENA143,49,1,0,1,0.337094,0.615925,0,"#ff7007"
338679358,RPerezGay,11,1,0,1,0.484581,0.0232,0,"#3a8724"
338999223,RusiaGonzalez,49,0,2,2,0.250632,0.599169,0.000486,"#ff7007"
339046886,CamiloCancelado,4,0,1,1,0.891178,0.238279,0,"#f4c8cf"
339071930,AcervoHZulia,35,1,0,1,0.481396,0.689906,0,"#00faff"
339075999,lecturamundi,37,0,1,1,0.235387,0.478578,0,"#006032"
339142862,LFeministe,25,0,3,3,0.582806,0.095593,0.000973,"#f4a2ff"
339286059,hugomezri64,22,0,1,1,0.61647,0.620958,0,"#00e8b2"
339337972,Odiaber,49,0,3,3,0.496525,0.601087,0.000973,"#ff7007"
339442471,joluarfa,10,2,1,3,0.532625,0.659539,0.000973,"#52d7c0"
339532535,CamposDevis,14,0,3,3,0.681999,0.55644,0.000973,"#00eeff"
339640298,CristinaRaurich,30,1,0,1,0.687437,0.724476,0,"#ff77ff"
339694854,berta_sole,38,0,1,1,0.632028,0.357105,0,"#662859"
339753749,FmartineL,19,1,0,1,0.638009,0.779966,0,"#00d3ff"
339826785,derrumbe2,13,16,60,76,0.468196,0.485787,0.036479,"#3bec00"
339923750,lauao,37,2,0,2,0.505813,0.208673,0.000486,"#006032"
340055745,SoyDanusauria,13,0,3,3,0.491578,0.449929,0.000973,"#3bec00"
340362129,afribuku,14,0,1,1,0.294301,0.452933,0,"#00eeff"
340639937,EmilyGonzalez24,17,0,1,1,0.826371,0.228892,0,"#ff9cc7"
341047542,pastusolibre,3,0,1,1,0.463005,0.780411,0,"#ffb3ff"
341773035,dianratner,49,0,2,2,0.383036,0.560444,0.000486,"#ff7007"
341910547,AllonsyMexGirl,13,0,1,1,0.431971,0.407842,0,"#3bec00"
341920529,AprilNineth,3,0,1,1,0.629935,0.575733,0,"#ffb3ff"
342033954,tecnopas,30,2,1,3,0.48576,0.531658,0.000973,"#ff77ff"
342393153,mairu_santiago,42,0,1,1,0.854046,0.463166,0,"#66e087"
342455529,Demibol,34,0,12,12,0.523608,0.423251,0.00535,"#ff0d69"
342579333,coachAprendizaj,18,0,1,1,0.759109,0.585527,0,"#5456a6"
342637843,J_MartinezRubio,37,11,1,12,0.637091,0.559588,0.00535,"#006032"
342639886,VeraDAntonio,13,0,1,1,0.423176,0.416652,0,"#3bec00"
342698907,laurajimemarin,3,0,1,1,0.489756,0.755358,0,"#ffb3ff"
342881332,arturopay,10,0,2,2,0.417417,0.548503,0.000486,"#52d7c0"
342890405,dansar39,49,1,4,5,0.427884,0.554808,0.001946,"#ff7007"
343015933,xavi0525,38,0,1,1,0.67847,0.454626,0,"#662859"
343161454,MRUPanama,49,0,1,1,0.080201,0.633897,0,"#ff7007"
343418962,cazonci_biblio,49,0,2,2,0.424689,0.593724,0.000486,"#ff7007"
343505665,kolegui77,40,0,1,1,0.601083,0.051022,0,"#ff12a3"
343520172,guillermohakim,21,0,1,1,0.174119,0.17883,0,"#c6cc85"
343545893,gemmatuit,40,0,1,1,0.619662,0.017233,0,"#ff12a3"
343681065,CristobalNuez,30,1,0,1,0.526507,0.623804,0,"#ff77ff"
343730699,nicolescavino,40,0,1,1,0.582332,0.019903,0,"#ff12a3"
343761999,the_real_OmarPB,34,0,4,4,0.50545,0.41548,0.001459,"#ff0d69"
343765123,JulianaDimateC,38,0,1,1,0.139375,0.812189,0,"#662859"
343854215,wickedgme,36,0,2,2,0.468336,0.169143,0.000486,"#825403"
343958108,biblioagenda,22,0,3,3,0.50744,0.512453,0.000973,"#00e8b2"
344001047,Clarimusic97,1,0,1,1,0.416663,0.622109,0,"#b6cb00"
344136915,MoralesTIT,31,0,1,1,0.679615,0.538434,0,"#3e93ff"
344159265,alvarezadrianna,30,0,3,3,0.538546,0.603595,0.000973,"#ff77ff"
344362875,EcceMosqui,13,0,1,1,0.630969,0.988625,0,"#3bec00"
344366329,PNocturna,3,0,1,1,0.509801,0.771168,0,"#ffb3ff"
344376174,LuckyChomps,41,0,1,1,0.323852,0.390389,0,"#697b00"
344401797,egresadoucaldas,9,2,1,3,0.708336,0.637133,0.000973,"#008f7b"
344428078,unfernandezmas,3,2,3,5,0.507523,0.590488,0.001946,"#ffb3ff"
344653322,Nacho_History,22,0,3,3,0.592666,0.520603,0.000973,"#00e8b2"
344862116,Mundisensor,49,1,0,1,0.38375,0.66641,0,"#ff7007"
344887879,CARMENEGOMET,30,0,1,1,0.171847,0.540218,0,"#ff77ff"
344909773,tw_eva,0,0,1,1,0.375636,0.548442,0,"#8ecfec"
344913974,DrPantera,37,1,1,2,0.589933,0.384168,0.000486,"#006032"
345267042,MariaValseca,30,0,2,2,0.565377,0.611477,0.000486,"#ff77ff"
345310708,tillgrallert,37,2,2,4,0.511337,0.460872,0.001459,"#006032"
345663452,crizcavalcante,36,1,1,2,0.455325,0.333726,0.000486,"#825403"
345845630,MusicologiaUCM,22,1,1,2,0.452701,0.736087,0.000486,"#00e8b2"
345861906,Jimujica,4,0,2,2,0.41123,0.382685,0.000486,"#f4c8cf"
346130719,AulaCIH,14,4,13,17,0.532771,0.544228,0.007782,"#00eeff"
346318509,MrWagnerCabral,36,0,1,1,0.467049,0.227094,0,"#825403"
346341052,sussierave,38,0,1,1,0.146757,0.822486,0,"#662859"
346415533,SarusSevilla,1,0,1,1,0.432837,0.638182,0,"#b6cb00"
346444005,VirgiForero,31,0,1,1,0.674758,0.54268,0,"#3e93ff"
346582902,FCPolitUNR,49,3,0,3,0.390497,0.552871,0.000973,"#ff7007"
346633116,ChristianVinolo,38,0,1,1,0.562548,0.698797,0,"#662859"
346652716,saidegart,3,0,1,1,0.470636,0.768047,0,"#ffb3ff"
346862445,JuliaGaytan,49,0,1,1,0.408661,0.517296,0,"#ff7007"
347002675,s,35,3,0,3,0.479652,0.365961,0.000973,"#00faff"
347019325,mimetiz,38,0,1,1,0.560789,0.409384,0,"#662859"
347124246,MuseodelTraje,50,0,1,1,0.551681,0.015389,0,"#ff76c3"
347221031,EspidoFreire,14,16,5,21,0.448802,0.547377,0.009728,"#00eeff"
347260082,rociogm,31,0,2,2,0.720689,0.532058,0.000486,"#3e93ff"
347292919,Karla_D94,13,0,1,1,0.379689,0.387183,0,"#3bec00"
347390540,Jilirio,4,0,4,4,0.921345,0.240175,0.001459,"#f4c8cf"
347419674,nemligaguria_,48,0,1,1,0.213219,0.728006,0,"#ff7a78"
347515795,recordspapers,34,0,2,2,0.381811,0.449593,0.000486,"#ff0d69"
347530925,Jhonny_Saavedra,22,0,1,1,0.571609,0.694925,0,"#00e8b2"
347547098,EFSantagada,37,0,1,1,0.21009,0.473551,0,"#006032"
347623341,adryjur,22,0,1,1,0.522955,0.7528,0,"#00e8b2"
347721436,SimonGornes,2,0,3,3,0.650433,0.574632,0.000973,"#ffa64e"
347812465,VictorJGranada,19,0,1,1,0.633392,0.790759,0,"#00d3ff"
347826691,eduariste,0,2,0,2,0.346237,0.591969,0.000486,"#8ecfec"
347838347,luis_olano,40,0,1,1,0.648304,0.037099,0,"#ff12a3"
347844723,CasadelaMemoria,22,0,1,1,0.665586,0.389479,0,"#00e8b2"
348416778,mozillafestival,49,1,0,1,0.345752,0.397641,0,"#ff7007"
348505258,massegarra,42,0,2,2,0.817272,0.447247,0.000486,"#66e087"
348593773,dalrmx,35,7,1,8,0.550633,0.384106,0.003405,"#00faff"
348618701,EnterateHidalgo,49,1,0,1,0.322786,0.614441,0,"#ff7007"
348708526,segalvez1,19,2,14,16,0.61033,0.730472,0.007296,"#00d3ff"
348716996,_ka_ce,36,0,1,1,0.538067,0.243831,0,"#825403"
348740352,JuditdeDiego,15,22,16,38,0.51331,0.587378,0.017996,"#008ebb"
348773946,_missamnesia,13,3,2,5,0.419782,0.378162,0.001946,"#3bec00"
348847875,Redpipil,34,0,3,3,0.370455,0.421478,0.000973,"#ff0d69"
348874321,PurasTuras,13,1,0,1,0.413164,0.459364,0,"#3bec00"
348997675,rocioanguita,31,1,2,3,0.581225,0.503838,0.000973,"#3e93ff"
349017788,cas_alonso,30,0,3,3,0.685838,0.578105,0.000973,"#ff77ff"
349020396,Starchildsp,31,0,4,4,0.612022,0.527232,0.001459,"#3e93ff"
349044638,Fran35Nat,30,0,1,1,0.488525,0.625406,0,"#ff77ff"
349064432,Onai_Ram,0,0,1,1,0.432389,0.383436,0,"#8ecfec"
349099536,Gomez_Parejo,49,0,1,1,0.483502,0.605075,0,"#ff7007"
349309137,enazjosebarandi,18,0,1,1,0.76926,0.625338,0,"#5456a6"
349352708,KatinSATX,34,0,2,2,0.350851,0.412863,0.000486,"#ff0d69"
349394632,LilyCroix,13,0,1,1,0.356251,0.453782,0,"#3bec00"
349448280,hernancastro_,21,0,2,2,0.216545,0.245023,0.000486,"#c6cc85"
349754435,joseramosvivas,30,0,1,1,0.524466,0.628012,0,"#ff77ff"
349815360,CarlosAburto71,13,2,3,5,0.472704,0.537841,0.001946,"#3bec00"
349989125,detetivevsilva,36,0,1,1,0.475435,0.223159,0,"#825403"
350073802,JoPaArauz,49,0,1,1,0.087312,0.642336,0,"#ff7007"
350166502,PSOEGuadalajara,19,1,0,1,0.6946,0.755524,0,"#00d3ff"
350361620,Marielarubiano,34,0,3,3,0.602654,0.335597,0.000973,"#ff0d69"
350411337,RAEinforma,15,32,1,33,0.540593,0.661384,0.015564,"#008ebb"
350432635,stockfjm,49,1,0,1,0.290382,0.642733,0,"#ff7007"
350504547,majo_navajasOK,49,0,3,3,0.395909,0.517246,0.000973,"#ff7007"
350517076,juanesfilosofic,9,0,2,2,0.717834,0.605705,0.000486,"#008f7b"
350544451,Jlgurquiza,30,0,1,1,0.698679,0.679143,0,"#ff77ff"
350656488,porotosconmote,14,0,1,1,0.449321,0.655946,0,"#00eeff"
350695995,vanerek,26,1,0,1,0.400137,0.109086,0,"#a7d4ff"
350854490,estamujer0,15,0,2,2,0.602054,0.563786,0.000486,"#008ebb"
350922941,take_plu,58,0,1,1,0.268284,0.569577,0,"#005076"
351000720,Bru_Verastegui,48,0,1,1,0.226616,0.728041,0,"#ff7a78"
351050161,RebeCanalla,49,0,1,1,0.480763,0.682308,0,"#ff7007"
351053896,JAntonioSalgado,31,0,3,3,0.619407,0.583582,0.000973,"#3e93ff"
351246866,DaniglamS,38,0,1,1,0.454908,0.781215,0,"#662859"
351566384,raymerichp,8,1,23,24,0.639917,0.348133,0.011187,"#00ed5d"
351699614,BNE_biblioteca,30,315,22,337,0.561271,0.595558,0.163424,"#ff77ff"
351736562,cocoaranda90,14,1,3,4,0.543331,0.514105,0.001459,"#00eeff"
351820423,DanielNorero,21,0,1,1,0.239109,0.197476,0,"#c6cc85"
351969813,miri_vanilli,34,0,1,1,0.547716,0.384381,0,"#ff0d69"
351974722,AmeliaLuzMontes,34,0,3,3,0.375775,0.423033,0.000973,"#ff0d69"
352039126,marlonsanguino,38,0,1,1,0.669889,0.467523,0,"#662859"
352053266,coursera,14,29,0,29,0.587793,0.521074,0.013619,"#00eeff"
352132920,BNE_directora,30,29,7,36,0.560888,0.581679,0.017023,"#ff77ff"
352231563,early_universe,30,1,1,2,0.673912,0.630276,0.000486,"#ff77ff"
352525947,CarlesLindin,13,5,81,86,0.495639,0.498747,0.041342,"#3bec00"
352559992,MinettiJavier,49,1,0,1,0.405002,0.643712,0,"#ff7007"
352685378,gcastroibarra,13,0,1,1,0.498039,0.310696,0,"#3bec00"
352717592,pamellasynthia,48,0,1,1,0.251991,0.714099,0,"#ff7a78"
352755998,medianthropos,22,0,2,2,0.506747,0.266939,0.000486,"#00e8b2"
352782133,Lila_1906,49,1,0,1,0.311041,0.618551,0,"#ff7007"
352787278,Lidy_Monteiro,49,0,2,2,0.422527,0.505568,0.000486,"#ff7007"
352850698,daniel_yo_soy,38,0,1,1,0.298132,0.180469,0,"#662859"
352961143,KonicaMinoltaES,49,1,0,1,0.36685,0.63177,0,"#ff7007"
353056732,SerranaDS,55,0,4,4,0.678765,0.646175,0.001459,"#cb3f32"
353124886,_MisterStrange,22,0,1,1,0.404379,0.603604,0,"#00e8b2"
353157060,SoftlandOficial,49,1,0,1,0.419361,0.687156,0,"#ff7007"
353196615,SacraJaimez,31,0,2,2,0.647554,0.547635,0.000486,"#3e93ff"
353290676,MissRespetos,49,1,0,1,0.361646,0.678442,0,"#ff7007"
353332107,irenelasen,13,0,4,4,0.42918,0.507878,0.001459,"#3bec00"
353345561,AlbertoPVZ,13,0,1,1,0.39689,0.37881,0,"#3bec00"
353373673,paillawen,21,0,1,1,0.244941,0.215519,0,"#c6cc85"
353497255,davidpenal,34,0,2,2,0.500526,0.409538,0.000486,"#ff0d69"
353503536,alpiedepagina,38,0,2,2,0.518702,0.382378,0.000486,"#662859"
353638080,BorjaGAM,22,0,2,2,0.57982,0.588434,0.000486,"#00e8b2"
353684144,ArchivesPortal,19,1,0,1,0.641486,0.633318,0,"#00d3ff"
353962554,FranSalinasR,13,1,0,1,0.500632,0.393801,0,"#3bec00"
354437724,yoesnadie,7,0,1,1,0.777015,0.645033,0,"#ffb800"
354438132,Cruz_Hierro,13,0,1,1,0.400929,0.4146,0,"#3bec00"
354475622,aalvarezgallo,34,5,5,10,0.551602,0.447346,0.004377,"#ff0d69"
354485614,Carloscarau,3,0,1,1,0.461884,0.761974,0,"#ffb3ff"
354544500,dhdebates,34,7,0,7,0.475385,0.462242,0.002918,"#ff0d69"
354914156,Wikimania2015,13,14,6,20,0.482963,0.46401,0.009241,"#3bec00"
355225151,Ursusmexicano,7,0,2,2,0.427045,0.363004,0.000486,"#ffb800"
355278714,cristares10,3,0,1,1,0.480263,0.786134,0,"#ffb3ff"
355529324,madresfera,0,0,1,1,0.415763,0.604428,0,"#8ecfec"
355540311,LLUIS_R_C,30,0,1,1,0.474926,0.648866,0,"#ff77ff"
355542112,MBuenoAguado,19,0,2,2,0.619861,0.812203,0.000486,"#00d3ff"
355578753,PedroLpez5,38,0,1,1,0.103152,0.428865,0,"#662859"
355598685,Tomy_gg,58,0,2,2,0.605377,0.308121,0.000486,"#005076"
355642935,flopes_patri,30,5,19,24,0.507553,0.48681,0.011187,"#ff77ff"
355685799,oscarisaac_rt,13,0,1,1,0.470494,0.389612,0,"#3bec00"
355783841,crosscecilia,49,0,8,8,0.464396,0.543259,0.003405,"#ff7007"
356087375,aventurasaber,0,0,3,3,0.574838,0.64932,0.000973,"#8ecfec"
356240342,EmbajadaEspCol,37,2,0,2,0.583821,0.362525,0.000486,"#006032"
356243804,archivofrontera,13,2,0,2,0.534613,0.407822,0.000486,"#3bec00"
356571417,tatianuskaya,58,0,2,2,0.606888,0.288702,0.000486,"#005076"
356785381,CSYol,8,0,3,3,0.733728,0.233456,0.000973,"#00ed5d"
356873842,emacarioa,10,0,1,1,0.683563,0.805854,0,"#52d7c0"
356942090,adolfo_sd,30,3,0,3,0.234304,0.579365,0.000973,"#ff77ff"
356986327,ma_collado,15,9,2,11,0.574078,0.633562,0.004864,"#008ebb"
357004772,PtoEncuentroEdi,37,1,0,1,0.583755,0.379038,0,"#006032"
357272138,alejomaya55,9,0,2,2,0.666319,0.912846,0.000486,"#008f7b"
357629650,platohedro,38,1,0,1,0.23127,0.54957,0,"#662859"
357656346,mfferreiro,14,2,1,3,0.485854,0.524537,0.000973,"#00eeff"
357670338,arturocarrascog,13,0,1,1,0.553519,0.396284,0,"#3bec00"
357678031,FacMedicinaUNAM,7,0,1,1,0.625406,0.366624,0,"#ffb800"
357776399,Fatimunflis,30,0,8,8,0.529102,0.570288,0.003405,"#ff77ff"
357868059,IsraelTrejoM,13,3,4,7,0.52012,0.416319,0.002918,"#3bec00"
357885570,ocfar11,49,1,0,1,0.351868,0.599459,0,"#ff7007"
357941050,ScratchinPro,38,0,2,2,0.310968,0.736107,0.000486,"#662859"
358024490,lago_jorge,40,0,2,2,0.100746,0.415826,0.000486,"#ff12a3"
358181063,LuOulton,55,0,4,4,0.564396,0.495561,0.001459,"#cb3f32"
358187547,prezlorena,30,0,1,1,0.65161,0.542723,0,"#ff77ff"
358236690,CAEH_7,35,2,7,9,0.438533,0.508161,0.003891,"#00faff"
358311869,nestorape,30,0,1,1,0.284531,0.552028,0,"#ff77ff"
358342675,MonicaDodero,49,0,3,3,0.442887,0.597504,0.000973,"#ff7007"
358582083,AlejandroGalvnx,34,0,3,3,0.499556,0.422951,0.000973,"#ff0d69"
358655963,gipUniovi,31,0,1,1,0.542003,0.689167,0,"#3e93ff"
358729281,Chlortig,30,1,0,1,0.548719,0.618068,0,"#ff77ff"
359488648,titoperezp,3,0,2,2,0.306056,0.565849,0.000486,"#ffb3ff"
359514520,Yo_CamiloJ,38,0,1,1,0.291335,0.184908,0,"#662859"
359637250,_ideashop,3,0,5,5,0.480509,0.616325,0.001946,"#ffb3ff"
359697588,apajaritos,55,0,2,2,0.66615,0.63956,0.000486,"#cb3f32"
359791727,Villarruel_clau,49,2,0,2,0.386842,0.56484,0.000486,"#ff7007"
359974537,Delgazpacho,14,0,1,1,0.497855,0.641273,0,"#00eeff"
360068680,huellasdelotro,35,1,3,4,0.564786,0.39537,0.001459,"#00faff"
360147131,vanjerono,38,4,0,4,0.396886,0.310406,0.001459,"#662859"
360159584,nlpado,34,1,0,1,0.383352,0.473783,0,"#ff0d69"
360179617,leydibotellas,3,0,1,1,0.685495,0.712162,0,"#ffb3ff"
360338275,leokamis,49,1,0,1,0.313539,0.64558,0,"#ff7007"
360347015,Juanpaverri,3,0,1,1,0.430805,0.751208,0,"#ffb3ff"
360682978,Educacion_Ec,31,1,0,1,0.584926,0.251488,0,"#3e93ff"
360857254,mividalibros,30,0,3,3,0.57848,0.585035,0.000973,"#ff77ff"
360874005,MinCulturaPe,31,6,0,6,0.559961,0.487801,0.002432,"#3e93ff"
360989809,darthfab,14,0,1,1,0.631267,0.596671,0,"#00eeff"
361133063,lavieestici,21,0,1,1,0.202658,0.226468,0,"#c6cc85"
361193969,ACBJ_OK,49,8,6,14,0.455338,0.605676,0.006323,"#ff7007"
361302333,BritishAcademy_,13,1,0,1,0.431309,0.505813,0,"#3bec00"
361393239,signumperu,3,0,1,1,0.586216,0.714087,0,"#ffb3ff"
361536173,periodistagodoy,49,0,4,4,0.479954,0.540609,0.001459,"#ff7007"
361628371,Darwin_Movie,14,0,1,1,0.328886,0.551055,0,"#00eeff"
361673905,CatyGonzalezC,22,0,2,2,0.558137,0.659031,0.000486,"#00e8b2"
361786526,cbravosantos,15,0,1,1,0.590907,0.631763,0,"#008ebb"
361897752,bibliotecaippur,36,4,7,11,0.511651,0.367164,0.004864,"#825403"
362062348,actualidadUBU,37,0,1,1,0.737473,0.357998,0,"#006032"
362073449,untoroblanco,21,0,2,2,0.263294,0.229231,0.000486,"#c6cc85"
362074693,DC_ASSEMBLERS,49,0,1,1,0.394909,0.525309,0,"#ff7007"
362308860,anateresamr,13,2,16,18,0.479033,0.470737,0.008268,"#3bec00"
362586529,Enclmdiario,15,12,3,15,0.565945,0.576949,0.006809,"#008ebb"
362655366,inesgce,19,3,0,3,0.647589,0.739276,0.000973,"#00d3ff"
362668751,CirunCh,30,0,1,1,0.600903,0.437959,0,"#ff77ff"
362711392,FundacionTeleMx,14,2,0,2,0.70261,0.537905,0.000486,"#00eeff"
362841607,PauloFlores_10,21,0,2,2,0.255528,0.233431,0.000486,"#c6cc85"
363018392,JavierRomeroOk,37,1,0,1,0.563435,0.361374,0,"#006032"
363228662,FrayGato,29,0,1,1,0.36306,0.156626,0,"#1fab00"
363330480,MartaRiquelme_,31,0,2,2,0.643452,0.558169,0.000486,"#3e93ff"
363334584,MuseuHolocausto,36,1,0,1,0.478721,0.324746,0,"#825403"
363467139,hjpalala,34,0,3,3,0.402716,0.460274,0.000973,"#ff0d69"
363622610,mariadinares,30,0,1,1,0.474987,0.645782,0,"#ff77ff"
363747144,SimulPast,30,0,2,2,0.536938,0.537677,0.000486,"#ff77ff"
363864350,lidiagarcia,3,1,0,1,0.620209,0.577555,0,"#ffb3ff"
363965303,GenilsonGeraldo,36,3,1,4,0.497349,0.409226,0.001459,"#825403"
364030711,juan_okie,40,0,1,1,0.575251,0.012087,0,"#ff12a3"
364164153,elsursumcorda,37,0,1,1,0.715099,0.582879,0,"#006032"
364331483,martaespu,0,0,2,2,0.638673,0.626852,0.000486,"#8ecfec"
364497509,sergiorodrigvez,49,1,0,1,0.380069,0.619329,0,"#ff7007"
364517397,pujapais,49,1,0,1,0.436076,0.664354,0,"#ff7007"
364599749,villamilfm,31,0,1,1,0.813355,0.526486,0,"#3e93ff"
364811159,JKiribumbatan,2,0,1,1,0.74723,0.513039,0,"#ffa64e"
364922180,gonzalobusan,30,0,2,2,0.594136,0.652037,0.000486,"#ff77ff"
365008415,acnzbell,13,0,6,6,0.490376,0.438115,0.002432,"#3bec00"
365017572,dpla,36,1,0,1,0.582782,0.420046,0,"#825403"
365074871,bwins35,34,0,2,2,0.352574,0.408842,0.000486,"#ff0d69"
365409552,nchauvina,22,0,1,1,0.559328,0.814647,0,"#00e8b2"
365450177,IsThatSergiKK,38,0,2,2,0.704262,0.585943,0.000486,"#662859"
365551675,cavalenzu,38,0,4,4,0.541619,0.535662,0.001459,"#662859"
365633431,Prereka,58,0,1,1,0.65708,0.425694,0,"#005076"
365688694,Mrojas_Abalos,49,2,1,3,0.432989,0.469131,0.000973,"#ff7007"
365971836,JaimeNubiola,31,1,0,1,0.795788,0.471172,0,"#3e93ff"
365981778,UNED_Ponferrada,37,3,2,5,0.528429,0.66202,0.001946,"#006032"
365996576,uc3mFacultadHCD,19,9,10,19,0.60459,0.639472,0.008755,"#00d3ff"
366004192,FMRPc,8,2,0,2,0.642058,0.330934,0.000486,"#00ed5d"
366035089,beabr95,22,1,0,1,0.60648,0.599689,0,"#00e8b2"
366157323,Nestor_Esau,42,0,1,1,0.677918,0.396943,0,"#66e087"
366237642,jvalenciacal,38,0,1,1,0.436378,0.783597,0,"#662859"
366484494,iacs_aragon,30,4,0,4,0.312979,0.29313,0.001459,"#ff77ff"
366536590,JorgedeTorres,14,0,5,5,0.51891,0.552356,0.001946,"#00eeff"
366595483,RoncesLabiano,1,0,2,2,0.658194,0.449681,0.000486,"#b6cb00"
366605732,bonetbea,19,1,5,6,0.605326,0.607662,0.002432,"#00d3ff"
366606307,MagazineGonnet,49,1,0,1,0.401498,0.642209,0,"#ff7007"
366661199,poblacion_csic,22,10,1,11,0.589775,0.393399,0.004864,"#00e8b2"
367069440,agonzat,1,1,2,3,0.537606,0.6393,0.000973,"#b6cb00"
367454621,bernardita000,21,0,2,2,0.229176,0.255078,0.000486,"#c6cc85"
367800694,jotacarballo,49,0,1,1,0.439377,0.662545,0,"#ff7007"
367807834,JavierHelguetaM,30,0,1,1,0.484832,0.634206,0,"#ff77ff"
367860277,UCLMtic,15,0,1,1,0.574781,0.71201,0,"#008ebb"
367957797,MrConstituyente,21,0,1,1,0.038296,0.632564,0,"#c6cc85"
368199660,museuexili,31,1,3,4,0.608306,0.577482,0.001459,"#3e93ff"
368330887,ariruigo,30,8,2,10,0.548441,0.578396,0.004377,"#ff77ff"
368365568,JaviMoscarella,38,0,1,1,0.68173,0.471961,0,"#662859"
368367115,ascunoficial,38,0,2,2,0.319368,0.535151,0.000486,"#662859"
368367932,iandradega,37,5,8,13,0.579534,0.510412,0.005837,"#006032"
368389207,Ruthoolf,58,0,2,2,0.579248,0.607931,0.000486,"#005076"
368414329,Educacion_UMA,14,1,0,1,0.752458,0.570256,0,"#00eeff"
368476077,LuisMartinLP,30,0,4,4,0.573573,0.587905,0.001459,"#ff77ff"
368520823,KhantutaM,37,0,3,3,0.486572,0.401691,0.000973,"#006032"
368527821,laboratorioe,42,0,1,1,0.728439,0.400531,0,"#66e087"
368591437,geografiandoesp,22,0,1,1,0.591312,0.614618,0,"#00e8b2"
368593070,CarminadeLuna,34,0,1,1,0.475624,0.370634,0,"#ff0d69"
368629264,Dionysius_vbrt,14,0,1,1,0.503334,0.642331,0,"#00eeff"
368854275,IslasDeCultura,4,1,0,1,0.573276,0.79225,0,"#f4c8cf"
368912166,heypoosinboots,14,0,2,2,0.563182,0.51639,0.000486,"#00eeff"
368919501,JuanitaNoJuana,34,0,1,1,0.586359,0.314766,0,"#ff0d69"
368927453,SdLUAB,14,4,0,4,0.520894,0.48666,0.001459,"#00eeff"
368954650,MCruzWesolowski,30,0,1,1,0.494887,0.648556,0,"#ff77ff"
368960130,_josefermin_,30,0,3,3,0.553033,0.603498,0.000973,"#ff77ff"
368971425,sbalbornoz,49,1,0,1,0.396376,0.629433,0,"#ff7007"
369000620,CristinaBorraj1,49,0,76,76,0.458324,0.563696,0.036479,"#ff7007"
369051037,nievbb,14,0,1,1,0.490043,0.6433,0,"#00eeff"
369074418,sarap_e,14,0,1,1,0.421661,0.634071,0,"#00eeff"
369207326,EsRubenValle,49,6,0,6,0.424771,0.570642,0.002432,"#ff7007"
369346119,REA_rolde,14,3,2,5,0.374553,0.574616,0.001946,"#00eeff"
369401436,CIMAcineastas,35,1,0,1,0.640989,0.44694,0,"#00faff"
369454241,City_Research,13,2,0,2,0.529117,0.401354,0.000486,"#3bec00"
369529173,ProfessMoravec,34,0,8,8,0.490573,0.505675,0.003405,"#ff0d69"
369533463,mphermosilla,31,0,1,1,0.660729,0.540948,0,"#3e93ff"
369592095,MarcoMorenoTec,10,0,2,2,0.362179,0.518576,0.000486,"#52d7c0"
369689042,GrandjeanMartin,36,0,8,8,0.454177,0.484753,0.003405,"#825403"
369689237,Margallego25,37,0,1,1,0.645596,0.49251,0,"#006032"
369706524,ctaunisabana,38,0,1,1,0.427767,0.270375,0,"#662859"
369719204,NocionesComunes,36,6,0,6,0.568202,0.427966,0.002432,"#825403"
369733406,ebaquerom,1,0,2,2,0.652504,0.453972,0.000486,"#b6cb00"
369971505,AdaCruzTnd,14,0,1,1,0.695651,0.463391,0,"#00eeff"
370056944,valenzuela_sara,34,0,3,3,0.450942,0.46884,0.000973,"#ff0d69"
370072897,elmarcapaginas,0,8,3,11,0.482737,0.541151,0.004864,"#8ecfec"
370110216,CaroPaideia,36,0,1,1,0.578614,0.418029,0,"#825403"
370115289,idartes,38,1,1,2,0.885568,0.509502,0.000486,"#662859"
370343383,MateusJuliana,38,0,1,1,0.557261,0.298199,0,"#662859"
370345430,museusbr,36,3,0,3,0.799956,0.332085,0.000973,"#825403"
370412391,edgsanabria,37,0,1,1,0.193647,0.478142,0,"#006032"
370765467,COMECSO,7,0,5,5,0.440068,0.365427,0.001946,"#ffb800"
370771233,ignaciopeyro,1,0,3,3,0.452128,0.691985,0.000973,"#b6cb00"
370786269,MiniPaulaVR,30,0,1,1,0.617114,0.646902,0,"#ff77ff"
370855808,Sergio_PMA,40,0,1,1,0.606478,0.021863,0,"#ff12a3"
370888624,KathrynLHolland,13,0,1,1,0.383072,0.443359,0,"#3bec00"
371082634,galarole08,3,0,1,1,0.674217,0.709766,0,"#ffb3ff"
371370378,emeggamez,13,0,1,1,0.428899,0.408527,0,"#3bec00"
371399287,MelbaLCardenasB,38,4,3,7,0.472701,0.378369,0.002918,"#662859"
371409990,NikoLiakopulosF,2,0,1,1,0.400982,0.54444,0,"#ffa64e"
371478431,cvilaz,30,0,4,4,0.511962,0.519092,0.001459,"#ff77ff"
371578742,paolathompsonru,10,0,1,1,0.340315,0.501313,0,"#52d7c0"
371668722,BernatRuiz,14,4,4,8,0.583218,0.566203,0.003405,"#00eeff"
371732429,austrohungaro_,13,3,3,6,0.508488,0.508344,0.002432,"#3bec00"
371863903,tlvictoria,49,2,4,6,0.462282,0.593924,0.002432,"#ff7007"
371900160,ArturRomano,40,0,1,1,0.572062,0.021952,0,"#ff12a3"
372175598,drmarjbeirut,49,0,2,2,0.420551,0.463766,0.000486,"#ff7007"
372180373,PerezPombo,49,2,0,2,0.423406,0.619758,0.000486,"#ff7007"
372216955,sanchezgalera,58,0,3,3,0.546955,0.581528,0.000973,"#005076"
372384990,alebalestra59,49,0,4,4,0.423748,0.538646,0.001459,"#ff7007"
372391470,MrsNemo_,15,0,1,1,0.559065,0.733957,0,"#008ebb"
372550322,NereaVsk,22,0,1,1,0.605251,0.587081,0,"#00e8b2"
372622120,jimenapc02,42,20,6,26,0.679567,0.439347,0.01216,"#66e087"
372770596,unciegocomoyo,37,0,1,1,0.282927,0.361723,0,"#006032"
372778265,BegonaPedrosa,18,1,3,4,0.672458,0.583003,0.001459,"#5456a6"
372905473,visceral_blot,34,0,3,3,0.515574,0.413464,0.000973,"#ff0d69"
372963607,BibliotecaJdeC,13,10,0,10,0.437281,0.498993,0.004377,"#3bec00"
373103222,KUSpanPort,13,1,1,2,0.406136,0.463706,0.000486,"#3bec00"
373104489,ElvizRojas,38,6,4,10,0.457679,0.43902,0.004377,"#662859"
373108431,LuisinaSilvaB,37,9,7,16,0.609883,0.410491,0.007296,"#006032"
373267321,maryjo_rg,2,0,2,2,0.686712,0.639374,0.000486,"#ffa64e"
373311030,amparocozar,31,1,3,4,0.474054,0.625046,0.001459,"#3e93ff"
373312205,Jorge_Vega_,30,0,2,2,0.522589,0.607496,0.000486,"#ff77ff"
373457376,mjmarinj,22,1,0,1,0.505723,0.680089,0,"#00e8b2"
373539942,LatamUF,34,9,3,12,0.445647,0.269798,0.00535,"#ff0d69"
373602643,Karlaollin,7,0,2,2,0.424918,0.354533,0.000486,"#ffb800"
373820283,Andrey4Mir,36,0,5,5,0.448904,0.505888,0.001946,"#825403"
373870437,EvaPfanzelter,13,0,1,1,0.437359,0.406673,0,"#3bec00"
373890086,Benito_Navarret,14,1,2,3,0.533358,0.600964,0.000973,"#00eeff"
373967564,murillo1975,0,0,1,1,0.375739,0.563388,0,"#8ecfec"
374223270,HKNorton,34,0,2,2,0.369321,0.414456,0.000486,"#ff0d69"
374261532,margarita_rd,17,0,1,1,0.836886,0.235592,0,"#ff9cc7"
374296231,ileanizima,7,0,1,1,0.402629,0.345178,0,"#ffb800"
374395365,dialnet,30,16,0,16,0.502061,0.551323,0.007296,"#ff77ff"
374410513,QuimBrugue,8,1,0,1,0.654209,0.244015,0,"#00ed5d"
374433827,ragerri,34,0,5,5,0.469075,0.50797,0.001946,"#ff0d69"
374527380,adolfocaparros,31,0,1,1,0.717277,0.280711,0,"#3e93ff"
374630821,aroa2R,30,10,7,17,0.525353,0.517566,0.007782,"#ff77ff"
374639885,yomolomas1,22,0,2,2,0.644942,0.479891,0.000486,"#00e8b2"
374745690,RosyRub,17,0,1,1,0.906414,0.358503,0,"#ff9cc7"
374819960,fariastuitea,37,10,0,10,0.709145,0.385313,0.004377,"#006032"
374936892,dapilan,36,0,1,1,0.521534,0.296598,0,"#825403"
375224604,Leuphana_Uni,30,2,0,2,0.490987,0.551782,0.000486,"#ff77ff"
375263828,eleuterioamoedo,31,0,2,2,0.799238,0.380416,0.000486,"#3e93ff"
375494413,rs_angie,58,0,1,1,0.726957,0.516279,0,"#005076"
375919565,VikoSiedlecki,49,0,2,2,0.422018,0.561393,0.000486,"#ff7007"
376098679,MRomanticismo,37,1,0,1,0.547723,0.758705,0,"#006032"
376246967,ragarfer13,37,0,1,1,0.699444,0.503967,0,"#006032"
376277910,cmartalazo,31,2,6,8,0.519048,0.642339,0.003405,"#3e93ff"
376304075,xamores,8,1,0,1,0.666248,0.253384,0,"#00ed5d"
376516710,ElisaLoncon,21,0,1,1,0.039533,0.625831,0,"#c6cc85"
376660115,JosCarlosMorill,49,0,4,4,0.453703,0.579609,0.001459,"#ff7007"
376750874,sedici,30,4,0,4,0.482837,0.55445,0.001459,"#ff77ff"
376755013,StrategiaInf,22,0,2,2,0.210029,0.569876,0.000486,"#00e8b2"
376799037,sabiasvip,49,1,0,1,0.351447,0.655172,0,"#ff7007"
376802717,23031522082015H,3,0,1,1,0.53099,0.764123,0,"#ffb3ff"
376810851,abogadoknowmads,31,0,8,8,0.632813,0.531494,0.003405,"#3e93ff"
376812625,Carlosmperalta,49,1,0,1,0.310408,0.649716,0,"#ff7007"
376879980,Mayterius,8,5,0,5,0.648463,0.36504,0.001946,"#00ed5d"
377013645,CarolaJojo,30,0,2,2,0.476445,0.511218,0.000486,"#ff77ff"
377033028,silviasarri,8,0,12,12,0.651184,0.332524,0.00535,"#00ed5d"
377238242,URJCcientifica,15,2,2,4,0.665431,0.599124,0.001459,"#008ebb"
377253521,BComplutense,36,1,4,5,0.529008,0.546657,0.001946,"#825403"
377279249,PeriodistasAND,0,1,0,1,0.911708,0.702105,0,"#8ecfec"
377381877,e__morales,30,1,0,1,0.563613,0.580964,0,"#ff77ff"
377436082,milenkavs,37,0,2,2,0.463401,0.368371,0.000486,"#006032"
377464987,HumanidadesUNAM,13,8,4,12,0.400794,0.316456,0.00535,"#3bec00"
377544685,luisa__correa,34,1,1,2,0.46627,0.358491,0.000486,"#ff0d69"
377609214,amolanor,38,7,8,15,0.645803,0.439911,0.006809,"#662859"
377720369,marioperalta7,5,0,1,1,0.638736,0.308052,0,"#b2dd44"
377724340,sisinfounisalle,38,1,0,1,0.569894,0.344071,0,"#662859"
377731932,Isacrisal,38,0,1,1,0.630408,0.386433,0,"#662859"
377887570,svmusicology,34,1,0,1,0.572088,0.355897,0,"#ff0d69"
377975776,hombreencamino,49,6,1,7,0.466705,0.596581,0.002918,"#ff7007"
378033688,DeLetras_UCLM,15,5,2,7,0.514907,0.597682,0.002918,"#008ebb"
378076547,TAMU_CoDHR,13,5,0,5,0.486104,0.44856,0.001946,"#3bec00"
378086932,EruBogota,38,0,1,1,0.659133,0.367027,0,"#662859"
378127538,HernndezAlpzar,47,0,1,1,0.595522,0.191306,0,"#a091c4"
378172479,JuanColmeneroE,49,1,0,1,0.339496,0.625069,0,"#ff7007"
378242042,inohasanci,19,0,2,2,0.577758,0.689737,0.000486,"#00d3ff"
378492909,MariaPovedaV,22,8,11,19,0.546802,0.609416,0.008755,"#00e8b2"
378674834,conejovich,21,0,2,2,0.24112,0.240481,0.000486,"#c6cc85"
378685116,MileSuquilanda,20,1,0,1,0.414097,0.118564,0,"#f0be45"
378917820,miguelGbarea,30,0,1,1,0.531282,0.645457,0,"#ff77ff"
378933623,zcastan,30,0,1,1,0.268751,0.46946,0,"#ff77ff"
379154581,diegoleonbu,38,0,1,1,0.642253,0.391217,0,"#662859"
379349776,trisquelisabel,30,0,1,1,0.594313,0.565659,0,"#ff77ff"
379454399,nanarpo1,3,0,1,1,0.479295,0.748707,0,"#ffb3ff"
379591379,almagre_pf,14,0,1,1,0.628899,0.600651,0,"#00eeff"
379753067,Eugefer_3,49,0,7,7,0.483699,0.574719,0.002918,"#ff7007"
379801639,UnMundoCultural,49,0,1,1,0.48495,0.686103,0,"#ff7007"
379838669,lortizdezarate,37,1,3,4,0.670725,0.525666,0.001459,"#006032"
379934403,DarwinPerezRuiz,7,0,2,2,0.441635,0.503463,0.000486,"#ffb800"
380256696,pepetesoro,40,0,2,2,0.095483,0.40445,0.000486,"#ff12a3"
380463389,ROBERTOMOLINA18,17,0,1,1,0.81135,0.214428,0,"#ff9cc7"
380479203,CeriHoulbrook,34,0,2,2,0.480854,0.406064,0.000486,"#ff0d69"
380981698,ngilfournier,0,0,3,3,0.349681,0.458187,0.000973,"#8ecfec"
381001701,silviabrito8,49,0,3,3,0.488898,0.614417,0.000973,"#ff7007"
381070776,DavidBordonaba,30,5,6,11,0.471014,0.553137,0.004864,"#ff77ff"
381276177,alial65,30,0,4,4,0.530882,0.552312,0.001459,"#ff77ff"
381379202,Orellana_Pep,8,0,1,1,0.282763,0.25978,0,"#00ed5d"
381416383,ACousillas,14,0,5,5,0.602532,0.544606,0.001946,"#00eeff"
381435887,pdperiodico,49,1,0,1,0.406272,0.663854,0,"#ff7007"
381437950,Anto_Navarro,49,2,0,2,0.424997,0.538718,0.000486,"#ff7007"
381511542,laiapujoltost,30,1,0,1,0.602563,0.433514,0,"#ff77ff"
381614437,eluniversomx,34,1,0,1,0.378963,0.46257,0,"#ff0d69"
381631792,mujeresdel36,19,7,0,7,0.636301,0.731211,0.002918,"#00d3ff"
381642653,hugoram47,22,0,1,1,0.271966,0.448824,0,"#00e8b2"
381681423,unaimagen_,58,0,2,2,0.596309,0.290525,0.000486,"#005076"
381706654,mariarunaways,35,3,0,3,0.54507,0.45819,0.000973,"#00faff"
381743098,MargyMacLibrary,34,0,4,4,0.364063,0.453162,0.001459,"#ff0d69"
381881850,Shant1981,7,0,2,2,0.42724,0.338946,0.000486,"#ffb800"
381979754,artzapico,37,0,1,1,0.693381,0.50824,0,"#006032"
382022414,joanfeliufranch,31,0,1,1,0.555293,0.253835,0,"#3e93ff"
382031214,ipcepatrimonio,22,0,1,1,0.587191,0.617444,0,"#00e8b2"
382102378,bender_k,19,2,2,4,0.548305,0.475472,0.001459,"#00d3ff"
382169591,marxismocritico,19,2,4,6,0.551117,0.696803,0.002432,"#00d3ff"
382226980,pecastano1,38,0,1,1,0.685622,0.46119,0,"#662859"
382249498,CoryDuclos,13,0,1,1,0.399164,0.480289,0,"#3bec00"
382255212,RJBOTANICO,22,1,1,2,0.617464,0.597705,0.000486,"#00e8b2"
382300046,TeideHease,0,0,1,1,0.373155,0.547286,0,"#8ecfec"
382545438,okitron,30,0,1,1,0.47467,0.636322,0,"#ff77ff"
382704865,SPabloCalleja,22,0,7,7,0.564091,0.600438,0.002918,"#00e8b2"
382796903,MaddenAmanda,36,0,1,1,0.474099,0.279732,0,"#825403"
382880553,jibonilla,37,1,0,1,0.455352,0.346764,0,"#006032"
382969925,californiaedit,38,0,7,7,0.538362,0.471264,0.002918,"#662859"
383021187,Giljesus67,45,0,2,2,0.658311,0.180838,0.000486,"#00e8ff"
383344736,HectorGil94,58,0,2,2,0.589902,0.307152,0.000486,"#005076"
383359019,JDiegoLpezGarca,14,0,2,2,0.566306,0.518882,0.000486,"#00eeff"
383419347,mafornaciari,36,13,2,15,0.451664,0.406687,0.006809,"#825403"
383822750,cslage,14,0,1,1,0.665858,0.496654,0,"#00eeff"
383977788,aula_expansion,30,0,1,1,0.520551,0.629125,0,"#ff77ff"
384201056,jgalgarra,30,2,5,7,0.506668,0.549159,0.002918,"#ff77ff"
384212402,scqlab,49,3,4,7,0.443653,0.581803,0.002918,"#ff7007"
384240682,IndustrialesCV,14,0,1,1,0.470854,0.679338,0,"#00eeff"
384257137,AndaluciaJunta,1,1,0,1,0.407923,0.620248,0,"#b6cb00"
384295770,JuankoExc,40,0,1,1,0.631673,0.043694,0,"#ff12a3"
384369323,LudiPrice,13,0,1,1,0.556777,0.33134,0,"#3bec00"
384480951,LawraMH,3,0,2,2,0.638804,0.659211,0.000486,"#ffb3ff"
384548610,JulioRB81,37,0,1,1,0.706829,0.499072,0,"#006032"
384550829,BibliotecaCEPAL,49,32,18,50,0.439098,0.489264,0.023833,"#ff7007"
384630256,JosVRamrez,3,0,1,1,0.459011,0.738607,0,"#ffb3ff"
384665214,optimvs333,3,0,1,1,0.512466,0.779665,0,"#ffb3ff"
384685845,LibreriaBonilla,13,16,0,16,0.473145,0.421413,0.007296,"#3bec00"
384768450,mvillasalero,15,0,1,1,0.61434,0.636994,0,"#008ebb"
384801683,BibliotecaUCLM,15,4,3,7,0.567893,0.590394,0.002918,"#008ebb"
384811394,AlainJordaDEL,22,2,0,2,0.415522,0.631983,0.000486,"#00e8b2"
384831136,IralaPilar,30,0,1,1,0.841965,0.638379,0,"#ff77ff"
384856915,ganpir,9,3,0,3,0.7259,0.427836,0.000973,"#008f7b"
384867507,digital_objects,34,2,0,2,0.501537,0.43537,0.000486,"#ff0d69"
384899514,MarcelaTintilay,49,0,6,6,0.45288,0.499212,0.002432,"#ff7007"
384907052,Letyludigital,13,1,16,17,0.507546,0.474286,0.007782,"#3bec00"
384928466,neorobotictv,15,0,1,1,0.507363,0.694677,0,"#008ebb"
384946027,TavoBarro,10,0,1,1,0.323996,0.471065,0,"#52d7c0"
385026627,aneurizar_,18,0,2,2,0.750523,0.628018,0.000486,"#5456a6"
385050437,BeatrizGracia1,2,0,1,1,0.643276,0.661496,0,"#ffa64e"
385235642,Lcruz_Foto,13,0,4,4,0.459853,0.356604,0.001459,"#3bec00"
385247514,teleidiotizado,49,1,0,1,0.37662,0.630495,0,"#ff7007"
385299581,LaTejado,0,0,1,1,0.427957,0.389787,0,"#8ecfec"
385323397,divulgaUNED,30,4,1,5,0.508139,0.585217,0.001946,"#ff77ff"
385332902,Lou3069,22,0,1,1,0.614129,0.607376,0,"#00e8b2"
385339288,portalcacocu,31,1,0,1,0.675475,0.608102,0,"#3e93ff"
385437417,NSahumerio,13,0,1,1,0.446484,0.371681,0,"#3bec00"
385452886,Juanoz55,34,0,1,1,0.623059,0.321106,0,"#ff0d69"
385503580,jlnoise,42,0,1,1,0.74395,0.501286,0,"#66e087"
385508199,jcknen,22,7,0,7,0.573819,0.602044,0.002918,"#00e8b2"
385714180,Discernidor27,49,1,0,1,0.346703,0.659617,0,"#ff7007"
385801671,chabelita_dd,13,0,2,2,0.446913,0.425896,0.000486,"#3bec00"
385843469,UVa_es,30,32,0,32,0.517317,0.5331,0.015078,"#ff77ff"
385854327,MNAD_Madrid,2,1,2,3,0.618179,0.602028,0.000973,"#ffa64e"
385931079,LaNauuv,31,11,1,12,0.561083,0.532611,0.00535,"#3e93ff"
385974908,HumanitumIratus,30,0,1,1,0.535117,0.699685,0,"#ff77ff"
385995441,_IsabellaPaez_,13,0,8,8,0.495138,0.460371,0.003405,"#3bec00"
386010323,Reale_Seguros,49,1,0,1,0.422831,0.646073,0,"#ff7007"
386064540,AlfredReyesBCN,49,2,0,2,0.411058,0.563373,0.000486,"#ff7007"
386072880,librosjesus,38,0,6,6,0.564429,0.470691,0.002432,"#662859"
386126000,KomaJabbyt,37,0,1,1,0.680265,0.301651,0,"#006032"
386133956,EricSDet,41,2,1,3,0.329033,0.367025,0.000973,"#697b00"
386143388,UAHComunicacion,37,1,0,1,0.633661,0.422249,0,"#006032"
386146587,Jenjeny182,34,0,1,1,0.579031,0.315095,0,"#ff0d69"
386178032,Univ_Cultura,7,16,0,16,0.730159,0.354544,0.007296,"#ffb800"
386185407,SarahJPurcell,34,0,1,1,0.338962,0.406833,0,"#ff0d69"
386253841,bomba_rosa,30,0,1,1,0.672381,0.743186,0,"#ff77ff"
386674334,ADUBAArgentina,49,8,0,8,0.486646,0.645299,0.003405,"#ff7007"
386755635,molivosa,13,0,1,1,0.439864,0.235743,0,"#3bec00"
386782091,jennymarcela03,2,0,4,4,0.520649,0.494388,0.001459,"#ffa64e"
386817531,Sandrivanamallo,3,0,1,1,0.669967,0.711973,0,"#ffb3ff"
387023321,tanww116,36,0,5,5,0.468504,0.502451,0.001946,"#825403"
387026369,Odontologogeek,38,0,2,2,0.660724,0.280099,0.000486,"#662859"
387050639,marfilcarmona,31,7,4,11,0.633194,0.485131,0.004864,"#3e93ff"
387848266,rosa_castells,14,0,1,1,0.666916,0.402004,0,"#00eeff"
388029041,saulo_carneiro,36,0,1,1,0.372727,0.347125,0,"#825403"
388132770,LAPISLAZZULI2,49,1,0,1,0.369657,0.65297,0,"#ff7007"
388320609,CarolCortesB,30,0,1,1,0.497624,0.622774,0,"#ff77ff"
388410400,keri_thomas,36,0,2,2,0.418691,0.510228,0.000486,"#825403"
388416822,Conacyt_MX,17,34,0,34,0.581104,0.338114,0.016051,"#ff9cc7"
388449165,mallocochile,49,0,1,1,0.44919,0.680603,0,"#ff7007"
388503174,juancommander,13,1,1,2,0.46465,0.368191,0.000486,"#3bec00"
388504146,loloaraya,21,0,1,1,0.196885,0.200467,0,"#c6cc85"
388592826,JMPereira61,37,5,8,13,0.535632,0.40341,0.005837,"#006032"
388664772,MonipennyDML,0,0,2,2,0.428812,0.605585,0.000486,"#8ecfec"
388729560,costamrv,36,16,8,24,0.529299,0.390116,0.011187,"#825403"
388752666,dfcspain,0,0,1,1,0.35565,0.549694,0,"#8ecfec"
388996524,amigosEyS,22,0,2,2,0.573993,0.580282,0.000486,"#00e8b2"
389023606,PabloSV310,37,0,1,1,0.765515,0.499074,0,"#006032"
389052563,AnaKalashnikova,3,0,1,1,0.291357,0.609692,0,"#ffb3ff"
389463626,bibliofilosofia,49,0,1,1,0.374731,0.468801,0,"#ff7007"
389494696,4rtopal,13,0,3,3,0.438919,0.481152,0.000973,"#3bec00"
389521711,MAR_Fund,49,1,0,1,0.388677,0.687384,0,"#ff7007"
389543845,GilbertoLopezMx,13,0,1,1,0.416254,0.343635,0,"#3bec00"
389579588,huertaizquierdo,31,0,2,2,0.583072,0.518905,0.000486,"#3e93ff"
389620129,Ceper_Uniandes,34,19,5,24,0.596208,0.391423,0.011187,"#ff0d69"
389742425,ArchivoMCR,22,0,3,3,0.494503,0.60905,0.000973,"#00e8b2"
390186312,IRI_robotics,8,1,0,1,0.696167,0.260016,0,"#00ed5d"
390190524,albertoprz1,38,0,1,1,0.734069,0.466221,0,"#662859"
390270686,CarlosZapa,1,0,1,1,0.388371,0.551886,0,"#b6cb00"
390356716,hdemauleon,11,2,0,2,0.497549,0.226195,0.000486,"#3a8724"
390414987,schuyleresprit,13,5,0,5,0.447981,0.487478,0.001946,"#3bec00"
390531357,DosisdeJota,38,0,1,1,0.36596,0.244423,0,"#662859"
390543894,emmacfreeman313,10,1,2,3,0.359278,0.499603,0.000973,"#52d7c0"
390632133,SVitrola4Free,40,0,1,1,0.604746,0.053376,0,"#ff12a3"
390839814,jormtz_,13,0,9,9,0.466709,0.45044,0.003891,"#3bec00"
390860235,atalav_,10,0,1,1,0.680141,0.799425,0,"#52d7c0"
390945001,AJDieguez,0,0,2,2,0.434733,0.599677,0.000486,"#8ecfec"
391042337,NormaTiva_esp,38,0,1,1,0.603637,0.364447,0,"#662859"
391096666,brenlatch,7,0,2,2,0.388425,0.360868,0.000486,"#ffb800"
391179564,mhnvalpo,21,0,2,2,0.257471,0.242197,0.000486,"#c6cc85"
391247062,viti_vitines,14,0,2,2,0.555425,0.509762,0.000486,"#00eeff"
391362936,myfirstSN,36,2,2,4,0.569822,0.439445,0.001459,"#825403"
391423650,DiosceMartinez,30,0,2,2,0.493215,0.598911,0.000486,"#ff77ff"
391478702,BasiMontes,55,0,1,1,0.617005,0.563582,0,"#cb3f32"
391524230,lbinotti,13,0,2,2,0.553443,0.444597,0.000486,"#3bec00"
391565780,KateAusten5,1,0,2,2,0.438897,0.601071,0.000486,"#b6cb00"
391673801,Oliviernes,13,0,2,2,0.51772,0.42816,0.000486,"#3bec00"
391710622,jesusrevelles,15,0,3,3,0.529641,0.587408,0.000973,"#008ebb"
391811948,Roberth14__,7,0,1,1,0.785721,0.584473,0,"#ffb800"
391926702,RappAndrea,36,0,1,1,0.43926,0.590754,0,"#825403"
391938634,MCarmenSuarezF,22,0,5,5,0.571357,0.602579,0.001946,"#00e8b2"
391962205,AlejandroFerr3,1,0,1,1,0.365525,0.550852,0,"#b6cb00"
392075005,jotajcmmorais,36,0,1,1,0.50935,0.217997,0,"#825403"
392078941,marcelabestevez,38,0,1,1,0.658265,0.72616,0,"#662859"
392178348,Noble_Jhon,38,0,2,2,0.706076,0.575057,0.000486,"#662859"
392198313,RaulRomero_mx,7,0,1,1,0.36705,0.218474,0,"#ffb800"
392241423,Glutenkaos1,0,0,1,1,0.377314,0.551802,0,"#8ecfec"
392267197,juditcarrera,8,1,0,1,0.687739,0.248201,0,"#00ed5d"
392357015,emulenews,22,3,3,6,0.655308,0.467413,0.002432,"#00e8b2"
392607707,IsidroPenaGP,15,0,1,1,0.576811,0.614206,0,"#008ebb"
392613136,dnazproject,14,0,2,2,0.611819,0.574305,0.000486,"#00eeff"
392621066,AlexYTimia,14,0,2,2,0.565682,0.515247,0.000486,"#00eeff"
392633867,cosnautas,14,10,2,12,0.535018,0.525055,0.00535,"#00eeff"
392916597,SamuMartinLopez,31,0,2,2,0.65927,0.554596,0.000486,"#3e93ff"
392949205,Crissov93,38,0,2,2,0.63591,0.427653,0.000486,"#662859"
393009997,G__Farell,4,0,1,1,0.866635,0.236841,0,"#f4c8cf"
393049821,alex_bia,14,12,1,13,0.500478,0.499606,0.005837,"#00eeff"
393269199,RudeboySax,22,0,1,1,0.396031,0.598082,0,"#00e8b2"
393318573,RubenDiezGarcia,19,0,2,2,0.63186,0.647699,0.000486,"#00d3ff"
393323296,diegogarcir,14,2,7,9,0.512602,0.48791,0.003891,"#00eeff"
393345271,JMVelascoR,15,0,1,1,0.631339,0.674835,0,"#008ebb"
393434194,abrahamrcea,40,0,2,2,0.094135,0.413192,0.000486,"#ff12a3"
393471845,miaspasia,58,1,0,1,0.795406,0.568439,0,"#005076"
393533331,100planes1finde,1,0,1,1,0.466735,0.711352,0,"#b6cb00"
393550078,iCERCA,14,0,1,1,0.672073,0.534381,0,"#00eeff"
393557197,josealbertohe,14,0,1,1,0.670868,0.494246,0,"#00eeff"
393675585,JulioGonzalo1,30,2,1,3,0.568861,0.556387,0.000973,"#ff77ff"
393691474,Toda_la_UNAM,13,17,1,18,0.458818,0.315314,0.008268,"#3bec00"
393741073,LuxBangs,1,0,1,1,0.432697,0.71161,0,"#b6cb00"
393998237,empel_david,14,0,2,2,0.61639,0.688552,0.000486,"#00eeff"
394049233,JulioVillenaR,2,0,2,2,0.661714,0.616344,0.000486,"#ffa64e"
394094315,CristinaCancho_,58,0,3,3,0.604134,0.286281,0.000973,"#005076"
394158423,coblezc,13,0,4,4,0.451482,0.447762,0.001459,"#3bec00"
394290965,dqserv,18,0,3,3,0.416645,0.773107,0.000973,"#5456a6"
394365540,sodamnstressed,48,0,1,1,0.197872,0.727775,0,"#ff7a78"
394417360,comunica_ucsj,37,5,1,6,0.361748,0.389867,0.002432,"#006032"
394562367,minasenergiaupm,31,1,0,1,0.615733,0.647739,0,"#3e93ff"
394564363,jdmorenob,34,0,3,3,0.442092,0.324,0.000973,"#ff0d69"
394818222,joshua_gmez,1,0,1,1,0.361559,0.73283,0,"#b6cb00"
394912313,BaltaFM,0,7,4,11,0.49702,0.605208,0.004864,"#8ecfec"
394925721,mirimalva,33,0,1,1,0.242447,0.610745,0,"#ff8c00"
395010038,ardillamoreno,19,0,1,1,0.615373,0.459499,0,"#00d3ff"
395091343,AlejandroSig,21,0,2,2,0.287713,0.445607,0.000486,"#c6cc85"
395174441,La_UPM,31,4,0,4,0.575374,0.640115,0.001459,"#3e93ff"
395189007,Agasol_SwL,55,0,1,1,0.351313,0.543814,0,"#cb3f32"
395398776,isapovea,13,17,15,32,0.493055,0.487456,0.015078,"#3bec00"
395483194,Tatamuffin,38,0,1,1,0.344918,0.187799,0,"#662859"
395579293,IFwrnandez,40,0,1,1,0.578365,0.044788,0,"#ff12a3"
395645255,patriciachl,49,1,1,2,0.391499,0.589777,0.000486,"#ff7007"
395894881,mariruilo,22,0,1,1,0.663591,0.47347,0,"#00e8b2"
396036194,silviamuinha,31,0,1,1,0.702029,0.265416,0,"#3e93ff"
396241313,Caracteres_net,30,25,2,27,0.531191,0.561987,0.012646,"#ff77ff"
396318659,afwiman,49,4,0,4,0.477735,0.533778,0.001459,"#ff7007"
396319940,jeimyamaya00,38,0,1,1,0.671166,0.421148,0,"#662859"
396497313,FJavier_Galan,0,7,2,9,0.726296,0.661694,0.003891,"#8ecfec"
396713395,eBooksBierzo,37,1,0,1,0.541119,0.754944,0,"#006032"
396723871,VMoncholi,14,0,1,1,0.843333,0.486917,0,"#00eeff"
396782630,MunillaCarlos,31,0,1,1,0.597252,0.416411,0,"#3e93ff"
397006449,OscarACastroL,13,0,1,1,0.521989,0.461772,0,"#3bec00"
397183246,elpidio_dcc,22,0,1,1,0.394686,0.512373,0,"#00e8b2"
397233335,laurmondejar,2,0,2,2,0.47381,0.51594,0.000486,"#ffa64e"
397517481,elisabeth_rg,19,0,1,1,0.677643,0.787393,0,"#00d3ff"
397560793,cosovschi,36,3,2,5,0.4781,0.362443,0.001946,"#825403"
397768365,gatamufina,48,0,1,1,0.229474,0.706667,0,"#ff7a78"
397868784,manuelortuno,30,0,1,1,0.475568,0.607266,0,"#ff77ff"
398154994,AnastasioGracia,19,1,7,8,0.61692,0.740686,0.003405,"#00d3ff"
398174642,tonodz,7,0,2,2,0.586163,0.400678,0.000486,"#ffb800"
398191371,aguaded,31,3,0,3,0.521981,0.584318,0.000973,"#3e93ff"
398207715,cedaguilarc,3,0,1,1,0.294108,0.575774,0,"#ffb3ff"
398444223,juanyepes3,38,0,1,1,0.309355,0.182061,0,"#662859"
398621872,fsanmillan,15,0,2,2,0.527177,0.696402,0.000486,"#008ebb"
398660322,cilengua,15,4,2,6,0.501789,0.621611,0.002432,"#008ebb"
398763399,colonia_de_luz,22,0,2,2,0.48879,0.582285,0.000486,"#00e8b2"
398769873,VirginiaLuzon,3,0,3,3,0.464557,0.533605,0.000973,"#ffb3ff"
398801685,pabloalfaroh,30,2,3,5,0.545544,0.569393,0.001946,"#ff77ff"
398865642,DidacPujol,14,0,6,6,0.543914,0.469035,0.002432,"#00eeff"
398936731,joaquinmgc,14,0,2,2,0.439166,0.529602,0.000486,"#00eeff"
399038996,rafapyp,13,7,6,13,0.538235,0.460177,0.005837,"#3bec00"
399092326,Rangel_Lucia,36,0,1,1,0.664434,0.33833,0,"#825403"
399391750,SpioUsal,58,0,2,2,0.528369,0.640558,0.000486,"#005076"
399494034,Saritaa15ds,14,0,2,2,0.647027,0.562219,0.000486,"#00eeff"
399682118,ladyhalcon2012,22,5,8,13,0.451831,0.655146,0.005837,"#00e8b2"
399710646,Victor_Gayol,34,234,84,318,0.50046,0.457258,0.154183,"#ff0d69"
399743581,marticardozopy,37,1,1,2,0.324115,0.577184,0.000486,"#006032"
399892128,Eduard__oH,7,0,3,3,0.431379,0.462756,0.000973,"#ffb800"
399944230,cris_aranda_,30,1,9,10,0.517847,0.600291,0.004377,"#ff77ff"
400012781,DHDarmstadt,30,0,1,1,0.558683,0.463235,0,"#ff77ff"
400024012,luiseborek,49,0,6,6,0.445783,0.516238,0.002432,"#ff7007"
400075975,robles_paco,19,2,2,4,0.616724,0.75387,0.001459,"#00d3ff"
400174867,LourdesAyala3,7,0,3,3,0.43797,0.322248,0.000973,"#ffb800"
400185748,A_CR_E,14,0,1,1,0.636651,0.602799,0,"#00eeff"
400241522,DatosUBA,3,44,51,95,0.462761,0.57228,0.04572,"#ffb3ff"
400286949,camaradellibro,49,1,0,1,0.428017,0.666613,0,"#ff7007"
400308418,AngelGdeAgreda,0,0,2,2,0.424023,0.598034,0.000486,"#8ecfec"
400319183,profvirtualibre,13,0,1,1,0.410955,0.488563,0,"#3bec00"
400469337,Fernoth77,10,0,3,3,0.38878,0.324149,0.000973,"#52d7c0"
400728084,SociabilidadCL,49,0,2,2,0.373792,0.477713,0.000486,"#ff7007"
400774489,mark_529,30,1,2,3,0.483197,0.556547,0.000973,"#ff77ff"
400794880,Mibarizt,35,0,1,1,0.573783,0.270043,0,"#00faff"
400886482,Marcela_etc,55,0,14,14,0.611709,0.520784,0.006323,"#cb3f32"
400969106,draamparo,58,0,1,1,0.462445,0.656334,0,"#005076"
400998123,raulvmorgado,22,0,3,3,0.566756,0.607634,0.000973,"#00e8b2"
401292100,MorFlog,30,12,19,31,0.530847,0.546724,0.014591,"#ff77ff"
401843758,_silvira,30,0,2,2,0.65742,0.520103,0.000486,"#ff77ff"
402010627,Oscar_2mart,37,0,2,2,0.637437,0.402151,0.000486,"#006032"
402092242,EscafandraCult,49,0,2,2,0.299734,0.769336,0.000486,"#ff7007"
402114568,dianasilva76,38,0,1,1,0.669411,0.374921,0,"#662859"
402209946,woody200278,7,0,1,1,0.777831,0.321329,0,"#ffb800"
402242241,connchisan,58,0,1,1,0.560342,0.164693,0,"#005076"
402278183,_juanalfonso_,30,0,1,1,0.579761,0.569324,0,"#ff77ff"
402349318,IU_Guadalajara,19,1,0,1,0.684701,0.763121,0,"#00d3ff"
402425611,AnaMariaTorresS,3,0,1,1,0.500218,0.751412,0,"#ffb3ff"
402625250,dta_cthomas,49,2,2,4,0.442038,0.47196,0.001459,"#ff7007"
402741568,gmcolli,49,1,0,1,0.319691,0.641574,0,"#ff7007"
402818646,medistoria,58,0,2,2,0.551599,0.600191,0.000486,"#005076"
402857468,AliciaFornes,14,11,12,23,0.570648,0.551849,0.0107,"#00eeff"
402887468,UNLaOficial,49,2,0,2,0.390605,0.585214,0.000486,"#ff7007"
402906803,filosofadbarrio,13,0,2,2,0.483484,0.426022,0.000486,"#3bec00"
403511207,Madrid_Cultura,22,1,0,1,0.631125,0.637566,0,"#00e8b2"
403578400,issyinthesky,14,0,2,2,0.558298,0.508457,0.000486,"#00eeff"
403746046,Apalo1970,34,0,1,1,0.60228,0.318511,0,"#ff0d69"
403786990,SoyFIGRI,53,0,2,2,0.5256,0.717791,0.000486,"#008bdd"
404033345,carmenloli_bual,38,0,1,1,0.573537,0.699671,0,"#662859"
404167857,UOCotri,14,0,1,1,0.585931,0.45063,0,"#00eeff"
404170482,SoyValdez,30,0,1,1,0.505883,0.706901,0,"#ff77ff"
404268113,daniell419,34,0,2,2,0.493841,0.395585,0.000486,"#ff0d69"
404322134,Losunosylosotro,40,0,2,2,0.578704,0.332468,0.000486,"#ff12a3"
404343269,vgabardam,31,0,1,1,0.638913,0.50223,0,"#3e93ff"
404368700,Belial_CL,21,0,1,1,0.176338,0.234921,0,"#c6cc85"
404442001,emckiernan13,13,12,0,12,0.475995,0.425237,0.00535,"#3bec00"
404482767,maravilla71,38,0,2,2,0.545856,0.417986,0.000486,"#662859"
404698626,feyts_uva,22,0,4,4,0.356648,0.572231,0.001459,"#00e8b2"
404902364,GuillermoPardo3,14,0,2,2,0.41612,0.751852,0.000486,"#00eeff"
404931257,FyL_UGR,31,6,5,11,0.531549,0.543875,0.004864,"#3e93ff"
405058299,MamenBond,40,0,1,1,0.601391,0.039901,0,"#ff12a3"
405081774,jougiguimaraes,36,1,2,3,0.480261,0.346972,0.000973,"#825403"
405086411,leitoraincomum,48,0,1,1,0.219862,0.730272,0,"#ff7a78"
405143843,jisanjose,30,0,1,1,0.566891,0.636119,0,"#ff77ff"
405282123,sancris63,13,0,1,1,0.399681,0.399226,0,"#3bec00"
405476939,c_mejia00,31,0,2,2,0.656244,0.524906,0.000486,"#3e93ff"
405508027,vega_rapun,1,0,1,1,0.362658,0.557525,0,"#b6cb00"
405556251,LunaLinda52,37,0,2,2,0.637341,0.40784,0.000486,"#006032"
405563005,lidiaBocanegra,31,3,0,3,0.640593,0.538088,0.000973,"#3e93ff"
405701122,gutiarqnav,49,1,0,1,0.357086,0.689389,0,"#ff7007"
405766722,aitorperueusk98,40,0,1,1,0.606929,0.008907,0,"#ff12a3"
405969744,sofyprado,17,0,1,1,0.809201,0.229107,0,"#ff9cc7"
406235608,Hitrania,15,5,6,11,0.504926,0.580931,0.004864,"#008ebb"
406473668,massimoaria,36,2,0,2,0.487347,0.357709,0.000486,"#825403"
406537757,eugeniocarrill2,49,1,0,1,0.38013,0.704887,0,"#ff7007"
406766589,Mulher_Noticia,36,0,2,2,0.641527,0.408968,0.000486,"#825403"
406794344,mgamartinez,13,0,1,1,0.446294,0.356556,0,"#3bec00"
406843902,Idea_Red,49,0,4,4,0.498937,0.597158,0.001459,"#ff7007"
406889671,MECENAS20,14,1,0,1,0.589143,0.575872,0,"#00eeff"
406903171,schultz_jj,30,0,1,1,0.46324,0.620399,0,"#ff77ff"
406992013,natyaruguete,36,0,2,2,0.530891,0.333612,0.000486,"#825403"
407082095,carminasuncion,19,0,2,2,0.627323,0.64466,0.000486,"#00d3ff"
407154185,BiblioDiTella,49,1,0,1,0.396202,0.696152,0,"#ff7007"
407179956,Francatripa,14,1,11,12,0.496438,0.549641,0.00535,"#00eeff"
407230265,Alejandrogbu,36,0,1,1,0.376657,0.332266,0,"#825403"
407236189,Cardonamalaga,22,0,1,1,0.661771,0.46965,0,"#00e8b2"
407263439,beggpons,36,1,1,2,0.521632,0.490043,0.000486,"#825403"
407266971,LeticiaGandara,30,0,4,4,0.541711,0.587708,0.001459,"#ff77ff"
407268535,vdarnelly,34,0,1,1,0.525465,0.384857,0,"#ff0d69"
407308942,verdewek,14,83,25,108,0.526176,0.52522,0.052043,"#00eeff"
407310786,LauraLacarra,37,1,1,2,0.649118,0.539385,0.000486,"#006032"
407316710,xxxspin,22,0,1,1,0.394073,0.606112,0,"#00e8b2"
407325933,cnelportus,22,0,1,1,0.609731,0.641686,0,"#00e8b2"
407349527,jlubjlub,31,0,1,1,0.62954,0.511299,0,"#3e93ff"
407390406,Cristian_g106,49,1,11,12,0.415316,0.510296,0.00535,"#ff7007"
407530024,LilianaGGR,31,0,4,4,0.601128,0.505075,0.001459,"#3e93ff"
407759861,BrynMawrLITS,57,0,2,2,0.717209,0.528866,0.000486,"#b66f7a"
407777016,TLarramendi,15,0,2,2,0.54087,0.674684,0.000486,"#008ebb"
407835346,StefanoNeri2,14,0,1,1,0.603798,0.564462,0,"#00eeff"
407904800,lletrespuntcat,15,0,1,1,0.620958,0.636401,0,"#008ebb"
407956389,josedevesaroca,3,0,1,1,0.588757,0.716411,0,"#ffb3ff"
407971407,Ireneprofe,1,0,2,2,0.452761,0.576955,0.000486,"#b6cb00"
408037994,Inigocamunas,49,1,0,1,0.389601,0.630359,0,"#ff7007"
408062137,Antropomedia,31,2,1,3,0.656325,0.621978,0.000973,"#3e93ff"
408105430,Yubii_28,42,0,1,1,0.699822,0.436272,0,"#66e087"
408162440,mscalone,55,0,1,1,0.643577,0.673768,0,"#cb3f32"
408226607,rayenchil,34,18,10,28,0.427795,0.452128,0.013132,"#ff0d69"
408497300,TeresaSiluar,30,3,0,3,0.556129,0.530654,0.000973,"#ff77ff"
408546347,RPQ48,13,1,0,1,0.223829,0.512223,0,"#3bec00"
408569953,marilepretel,2,4,2,6,0.495372,0.571498,0.002432,"#ffa64e"
408665419,rmartintorres,22,0,1,1,0.385208,0.199172,0,"#00e8b2"
408879804,envalparaiso,21,0,2,2,0.215894,0.238081,0.000486,"#c6cc85"
409193824,tandfnewsroom,31,1,0,1,0.704114,0.401317,0,"#3e93ff"
409234558,blancallen,40,0,1,1,0.589217,0.00137,0,"#ff12a3"
409235307,Tofe_92,15,0,1,1,0.578594,0.614932,0,"#008ebb"
409280333,AGroundw,34,0,2,2,0.48909,0.408395,0.000486,"#ff0d69"
409363808,InquietudFemini,58,0,2,2,0.595967,0.581956,0.000486,"#005076"
409451803,Raul_Landa,49,1,0,1,0.372967,0.673935,0,"#ff7007"
409481206,LAB1100,36,6,5,11,0.522502,0.399349,0.004864,"#825403"
409513709,boutainaelfbb,49,1,0,1,0.399814,0.694645,0,"#ff7007"
409573368,HelenaMatute,22,0,3,3,0.566399,0.492602,0.000973,"#00e8b2"
410157048,raul_mlopez,2,0,1,1,0.399754,0.545373,0,"#ffa64e"
410167349,Letrasucab,35,1,1,2,0.700971,0.402283,0.000486,"#00faff"
410186307,2_SMy,40,0,1,1,0.57808,0.035463,0,"#ff12a3"
410226975,FAAEColombia,22,4,4,8,0.599848,0.424554,0.003405,"#00e8b2"
410314492,miluki28,49,0,1,1,0.374101,0.536029,0,"#ff7007"
410365297,gigita247,21,0,1,1,0.23196,0.199233,0,"#c6cc85"
410383419,ictandlaw,13,0,4,4,0.457424,0.413945,0.001459,"#3bec00"
410778732,ITelligent_IT,49,1,0,1,0.385681,0.637769,0,"#ff7007"
410838353,AndreaYamilethM,3,0,1,1,0.531414,0.768878,0,"#ffb3ff"
410978539,Manueliyo3,58,0,2,2,0.584269,0.298827,0.000486,"#005076"
411014966,luuuciamoran,30,0,1,1,0.597063,0.666974,0,"#ff77ff"
411058141,OlimpiaTorres,49,1,0,1,0.388793,0.656217,0,"#ff7007"
411112141,mrvizan,49,1,0,1,0.390986,0.650681,0,"#ff7007"
411200946,materesafdez,34,0,1,1,0.551393,0.328371,0,"#ff0d69"
411378315,__Oihan,22,0,1,1,0.579651,0.694926,0,"#00e8b2"
411419084,rahul05ranjan,49,0,10,10,0.449848,0.433443,0.004377,"#ff7007"
411469680,Clara_Merin,30,0,2,2,0.540602,0.631241,0.000486,"#ff77ff"
411522157,marietaArq,22,0,1,1,0.39655,0.601167,0,"#00e8b2"
411629310,RobertoRuedaQ,38,0,1,1,0.553718,0.319412,0,"#662859"
412236022,KingCreoleEs,49,1,0,1,0.353527,0.602463,0,"#ff7007"
412401510,ninaproduccions,19,2,0,2,0.680594,0.753111,0.000486,"#00d3ff"
412414381,ICTanger,30,3,0,3,0.440568,0.567392,0.000973,"#ff77ff"
412420420,_SrPerro,34,1,0,1,0.412701,0.251075,0,"#ff0d69"
412465213,davalonso2000,30,3,8,11,0.508785,0.599293,0.004864,"#ff77ff"
412616279,65_alma,13,0,1,1,0.435015,0.241647,0,"#3bec00"
412848403,occosentino,7,0,1,1,0.344958,0.451025,0,"#ffb800"
412889909,yayimendezsosa,3,0,2,2,0.489928,0.612156,0.000486,"#ffb3ff"
412898512,dandydelameche,7,0,1,1,0.416077,0.328724,0,"#ffb800"
413132436,edovillamizar,49,1,0,1,0.374646,0.644192,0,"#ff7007"
413140220,dncxarxes,2,0,2,2,0.681901,0.650631,0.000486,"#ffa64e"
413201311,PacoGilBarbate,30,0,1,1,0.582918,0.671893,0,"#ff77ff"
413210637,jmarinarrese,30,1,0,1,0.589606,0.571958,0,"#ff77ff"
413381942,Balduqueando20,30,0,5,5,0.563431,0.453566,0.001946,"#ff77ff"
413515774,willingtoncam96,38,0,1,1,0.331617,0.16613,0,"#662859"
413554340,mariabriceno43,42,0,2,2,0.708933,0.434506,0.000486,"#66e087"
413643466,MinatoGzenx,13,0,5,5,0.460901,0.470412,0.001946,"#3bec00"
413851087,ajenjomata,15,2,3,5,0.649127,0.568761,0.001946,"#008ebb"
414250569,saracazzoli,1,0,1,1,0.353566,0.751292,0,"#b6cb00"
414496177,stefaniagallini,38,167,113,280,0.51676,0.445585,0.1357,"#662859"
414705452,etopia_,31,1,0,1,0.64216,0.487025,0,"#3e93ff"
414794428,rosasebastia,30,44,58,102,0.486898,0.565223,0.049125,"#ff77ff"
414879584,villalvazoM131,13,0,4,4,0.42256,0.454894,0.001459,"#3bec00"
414989367,judittur,38,0,1,1,0.799516,0.651619,0,"#662859"
415017868,CASTAC_AAA,49,1,0,1,0.300649,0.359796,0,"#ff7007"
415037722,be_intuitive,3,0,2,2,0.489078,0.710676,0.000486,"#ffb3ff"
415112016,mderramon,19,3,0,3,0.646876,0.743293,0.000973,"#00d3ff"
415157317,Bosco_delrosal,49,1,0,1,0.350973,0.608619,0,"#ff7007"
415352527,aprodrig77,34,0,2,2,0.364547,0.405353,0.000486,"#ff0d69"
415392117,euMONDRAGON,18,2,0,2,0.743723,0.634722,0.000486,"#5456a6"
415505964,Leticare,58,0,2,2,0.684812,0.644451,0.000486,"#005076"
415621065,Cmagallon1,31,0,1,1,0.658823,0.432688,0,"#3e93ff"
415661892,AvisperoR,49,1,0,1,0.422214,0.653559,0,"#ff7007"
415670218,DocuJavi,30,0,1,1,0.603116,0.657113,0,"#ff77ff"
415833094,javiergilquinta,22,1,1,2,0.320703,0.718094,0.000486,"#00e8b2"
416005266,AWILKIS,37,1,0,1,0.23106,0.492731,0,"#006032"
416361675,CDHTrier,30,0,1,1,0.55878,0.459319,0,"#ff77ff"
416515036,monkeyplatillos,30,0,2,2,0.518232,0.58581,0.000486,"#ff77ff"
416622121,rdiegon,22,0,1,1,0.820442,0.333678,0,"#00e8b2"
416838819,kanquisurf1,21,0,2,2,0.24635,0.28253,0.000486,"#c6cc85"
416971473,purayradiante,21,0,1,1,0.166441,0.229929,0,"#c6cc85"
417157262,NataliaMdeZ,22,0,1,1,0.593978,0.615101,0,"#00e8b2"
417294495,oarcinie,13,0,4,4,0.472325,0.445194,0.001459,"#3bec00"
417770353,francescnadal,31,0,1,1,0.653525,0.498296,0,"#3e93ff"
417793312,sordip,13,6,12,18,0.497061,0.482193,0.008268,"#3bec00"
417973681,fahce,49,2,0,2,0.427226,0.563923,0.000486,"#ff7007"
418011068,bchgUAB,14,4,6,10,0.546848,0.531823,0.004377,"#00eeff"
418050783,marilinaoria,31,0,1,1,0.624479,0.595783,0,"#3e93ff"
418062794,mafab25,34,0,5,5,0.469459,0.443544,0.001946,"#ff0d69"
418359412,chrichardsss,12,1,2,3,0.847645,0.602468,0.000973,"#00a04a"
418673035,Emfzanatta,36,1,0,1,0.531084,0.179077,0,"#825403"
418851365,hispanopress,49,1,0,1,0.366001,0.654791,0,"#ff7007"
419006281,IISUNAM,7,3,1,4,0.391517,0.365281,0.001459,"#ffb800"
419012110,Reyes_calderon,0,3,0,3,0.468941,0.605041,0.000973,"#8ecfec"
419164852,clboyles,49,1,8,9,0.442042,0.49475,0.003891,"#ff7007"
419338372,Tirant_ESP,31,2,0,2,0.688193,0.417844,0.000486,"#3e93ff"
419428981,formarprevenir,31,0,2,2,0.686777,0.429295,0.000486,"#3e93ff"
419460932,CanalTaronja,8,1,0,1,0.684436,0.299144,0,"#00ed5d"
419489646,EvaAstorga,49,2,1,3,0.497505,0.527503,0.000973,"#ff7007"
419531032,LolaFpalenzuela,31,0,1,1,0.659827,0.548565,0,"#3e93ff"
419640637,o_spinosa,38,0,1,1,0.615823,0.372378,0,"#662859"
419672561,mshlyon,37,0,1,1,0.645026,0.290228,0,"#006032"
419838305,cesarepayome,38,0,1,1,0.615807,0.713392,0,"#662859"
420047233,JulioBravo10,21,0,1,1,0.185214,0.203221,0,"#c6cc85"
420091534,TobyBurrows,36,1,0,1,0.575465,0.418556,0,"#825403"
420281679,EconomicasUA,49,1,0,1,0.341809,0.646841,0,"#ff7007"
420405133,mic_albarello,8,0,2,2,0.688466,0.257563,0.000486,"#00ed5d"
420409419,toniTYC,31,0,1,1,0.334512,0.525533,0,"#3e93ff"
420452250,R_Arellano_C,31,0,2,2,0.724147,0.57297,0.000486,"#3e93ff"
420499603,IdeasPuzzle,38,0,1,1,0.594155,0.346401,0,"#662859"
420518954,villegas_pao,49,0,1,1,0.40558,0.518537,0,"#ff7007"
420528408,isidrelara,49,1,0,1,0.325508,0.629048,0,"#ff7007"
420553080,GuadarramaRico,41,5,9,14,0.351352,0.39217,0.006323,"#697b00"
420626511,periodicomujer,56,0,1,1,0.381755,0.093172,0,"#384205"
420639740,ProlopeUab,14,37,10,47,0.540439,0.546514,0.022374,"#00eeff"
420746029,FuentesMizuki,13,0,1,1,0.420082,0.286172,0,"#3bec00"
420779440,CandyRdzO,13,0,1,1,0.360409,0.510576,0,"#3bec00"
420984708,efdezlarrea,31,0,1,1,0.619468,0.717746,0,"#3e93ff"
421163325,pepealgemesi,30,0,3,3,0.473768,0.599031,0.000973,"#ff77ff"
421250770,okfnbr,36,13,1,14,0.734191,0.546677,0.006323,"#825403"
421304039,MikevanTreek,22,0,1,1,0.605744,0.618844,0,"#00e8b2"
421347949,calzonconblonda,49,0,2,2,0.436456,0.494494,0.000486,"#ff7007"
421378508,jamesmolina90,34,0,1,1,0.558293,0.344248,0,"#ff0d69"
421577499,DrAriaHalliday,34,0,2,2,0.365713,0.412371,0.000486,"#ff0d69"
421722996,XavierMarcet,8,11,10,21,0.654288,0.337493,0.009728,"#00ed5d"
421801512,CarmenSofaSarac,3,0,2,2,0.477555,0.66436,0.000486,"#ffb3ff"
421912290,AnneBaillot,49,0,1,1,0.344976,0.468925,0,"#ff7007"
422187831,MariaQuejigo,15,0,2,2,0.589992,0.644981,0.000486,"#008ebb"
422579729,JTlatelpa,49,1,4,5,0.485825,0.614026,0.001946,"#ff7007"
422721396,PelagiosNetwork,49,18,4,22,0.464359,0.490775,0.010214,"#ff7007"
422769971,mirkaplagon,0,0,1,1,0.356941,0.542758,0,"#8ecfec"
422923556,lidt82,15,0,2,2,0.602775,0.558511,0.000486,"#008ebb"
422936038,Maite_her,2,0,1,1,0.650732,0.654379,0,"#ffa64e"
422942161,MCallejaPuerta,22,33,0,33,0.643095,0.592994,0.015564,"#00e8b2"
423221238,morethangrass,36,0,1,1,0.400796,0.580407,0,"#825403"
423309466,FIMarx,19,1,0,1,0.660151,0.768178,0,"#00d3ff"
423337846,Maria,30,1,0,1,0.580297,0.543212,0,"#ff77ff"
423399130,OlgaRamrez1,8,0,1,1,0.258265,0.269243,0,"#00ed5d"
423686476,enfermerojesus,31,0,1,1,0.637628,0.517876,0,"#3e93ff"
424102262,inefmadrid,31,4,0,4,0.59535,0.585443,0.001459,"#3e93ff"
424122771,HerriBizia,36,7,0,7,0.359833,0.220743,0.002918,"#825403"
424172759,natacarbonell,49,0,1,1,0.311364,0.296276,0,"#ff7007"
424309595,Conexionesimpro,31,2,0,2,0.679803,0.593916,0.000486,"#3e93ff"
424386209,carlosfonzeca,13,0,1,1,0.461877,0.242193,0,"#3bec00"
424456664,alinaeunice,41,0,1,1,0.317416,0.388227,0,"#697b00"
424906707,jordigoula,8,2,0,2,0.678515,0.247859,0.000486,"#00ed5d"
425024208,cortesangelama,37,0,2,2,0.533319,0.777284,0.000486,"#006032"
425025049,QhacerLasPalmas,30,0,2,2,0.584266,0.604436,0.000486,"#ff77ff"
425287584,Unidad_Igualdad,19,3,8,11,0.631983,0.679696,0.004864,"#00d3ff"
425322919,Marrtapm,30,0,1,1,0.272545,0.633772,0,"#ff77ff"
425327224,PattPlanner,50,0,1,1,0.55689,0.011859,0,"#ff76c3"
425419433,ideahector,13,0,2,2,0.447378,0.403139,0.000486,"#3bec00"
425942074,ReneCarvajal1,21,0,2,2,0.241848,0.226522,0.000486,"#c6cc85"
425947121,CIRICWALES,36,0,1,1,0.3974,0.334842,0,"#825403"
426151035,ultimahoramx,49,3,0,3,0.424405,0.601875,0.000973,"#ff7007"
426553603,crai_bima,14,0,3,3,0.518618,0.547595,0.000973,"#00eeff"
426569366,MaitePelacho,14,0,1,1,0.557967,0.583643,0,"#00eeff"
426672026,Pausilypo,38,0,1,1,0.096472,0.421007,0,"#662859"
426784922,lirondos,14,33,12,45,0.528295,0.529969,0.021401,"#00eeff"
426793713,JFTitone,13,0,2,2,0.392677,0.437864,0.000486,"#3bec00"
426806109,JRsanzvilla,58,0,3,3,0.594231,0.28495,0.000973,"#005076"
426856955,EduDeAgreda,1,0,1,1,0.352043,0.730015,0,"#b6cb00"
426864031,LidiaKantero,37,0,1,1,0.657033,0.387509,0,"#006032"
426892225,goncharev,49,3,0,3,0.481491,0.641082,0.000973,"#ff7007"
426968963,RobertoGomezIgl,31,2,7,9,0.650254,0.567018,0.003891,"#3e93ff"
427118392,areckmann,49,0,4,4,0.373309,0.465094,0.001459,"#ff7007"
427126935,amerbacmx,13,1,0,1,0.421041,0.300323,0,"#3bec00"
427191229,ariel_beramendi,49,1,0,1,0.386617,0.670673,0,"#ff7007"
427323266,glamwiki,13,1,3,4,0.453372,0.488126,0.001459,"#3bec00"
427595521,Letrealetrea,14,0,2,2,0.621608,0.560864,0.000486,"#00eeff"
427640187,Gemamerche,13,0,1,1,0.395302,0.496836,0,"#3bec00"
427811541,makingpolicy,36,2,2,4,0.419233,0.494264,0.001459,"#825403"
427883416,naskicet,49,3,0,3,0.424243,0.387296,0.000973,"#ff7007"
428513442,Innovaspain,0,1,1,2,0.347564,0.518425,0.000486,"#8ecfec"
428540085,JoaquinLiwski,37,4,0,4,0.582088,0.341942,0.001459,"#006032"
428566917,mrshufflepuff93,30,0,3,3,0.508893,0.602773,0.000973,"#ff77ff"
428649129,Alan_G_W,49,2,0,2,0.414186,0.563554,0.000486,"#ff7007"
428698394,chavez_2,34,0,1,1,0.59291,0.322624,0,"#ff0d69"
428706091,chuysoloeso,13,0,1,1,0.478701,0.392042,0,"#3bec00"
428732102,LmhgslPhD,49,0,1,1,0.347459,0.48019,0,"#ff7007"
428832403,jlborruell,30,0,1,1,0.643129,0.689066,0,"#ff77ff"
429016836,nacho_salcedo,37,0,1,1,0.714575,0.503697,0,"#006032"
429038611,MECotera,34,31,0,31,0.417417,0.440112,0.014591,"#ff0d69"
429097204,jaumebalmes,30,2,1,3,0.524627,0.647992,0.000973,"#ff77ff"
429138639,BernardoMasini,13,0,1,1,0.339015,0.241602,0,"#3bec00"
429243053,analauraprofe,37,0,2,2,0.636,0.631973,0.000486,"#006032"
429404396,Revista_Somos,49,1,0,1,0.30858,0.611641,0,"#ff7007"
429752273,khcoder,37,0,1,1,0.373527,0.488857,0,"#006032"
429812273,estrodju,22,0,1,1,0.525775,0.676952,0,"#00e8b2"
430062589,datacultura,49,2,2,4,0.405223,0.59578,0.001459,"#ff7007"
430095006,Miluccid,1,0,1,1,0.47314,0.620606,0,"#b6cb00"
430102075,martinelli_si,8,0,3,3,0.495527,0.520559,0.000973,"#00ed5d"
430169297,benbatppl,36,1,0,1,0.483492,0.281077,0,"#825403"
430320904,vegaaa99,3,0,1,1,0.473769,0.765124,0,"#ffb3ff"
430612865,SILVIAGMEZ4,42,0,1,1,0.710249,0.455504,0,"#66e087"
430842796,tophistoria,22,1,10,11,0.537442,0.596002,0.004864,"#00e8b2"
430869087,MADAMENEUROSlS,38,0,1,1,0.670602,0.365765,0,"#662859"
430902996,EntreN,49,1,0,1,0.332108,0.667515,0,"#ff7007"
431135835,rapphasantana,36,0,1,1,0.516676,0.327543,0,"#825403"
431186438,IDieste,30,0,3,3,0.582759,0.609841,0.000973,"#ff77ff"
431193726,sz_25,49,0,1,1,0.489104,0.611313,0,"#ff7007"
431528862,mendezs_irene,31,0,2,2,0.536879,0.635507,0.000486,"#3e93ff"
431749251,nohemiShinita,13,1,0,1,0.397072,0.398203,0,"#3bec00"
432018662,letterabooks,49,1,0,1,0.326643,0.689623,0,"#ff7007"
432254715,JRoldin,49,1,0,1,0.315623,0.609164,0,"#ff7007"
432352352,GemaGruesoOtalo,14,0,1,1,0.600675,0.492681,0,"#00eeff"
432381959,FAJEnetwork,31,0,2,2,0.645653,0.51959,0.000486,"#3e93ff"
432455143,IILP_UV,55,1,1,2,0.662717,0.571669,0.000486,"#cb3f32"
432771746,Soniaporto7,1,0,3,3,0.636882,0.47205,0.000973,"#b6cb00"
432827061,LarociMoreno,31,1,2,3,0.582858,0.507119,0.000973,"#3e93ff"
432978550,GiselleGHipola,31,0,4,4,0.595641,0.519779,0.001459,"#3e93ff"
433078281,ledacartum,49,1,0,1,0.421787,0.464059,0,"#ff7007"
433313515,ismaelpalacin,8,2,0,2,0.582979,0.386363,0.000486,"#00ed5d"
433553175,LAZAROFLORIDO,49,1,0,1,0.432628,0.696636,0,"#ff7007"
433553641,xhuncahuiini,5,0,1,1,0.620359,0.288969,0,"#b2dd44"
433652813,dtokra,38,0,1,1,0.439444,0.76837,0,"#662859"
433696930,De_Paiz,58,13,9,22,0.469297,0.570111,0.010214,"#005076"
433742667,pmarrai,31,4,8,12,0.558113,0.490919,0.00535,"#3e93ff"
433799748,santiagollach,49,0,1,1,0.320003,0.542242,0,"#ff7007"
433822510,dmorin_mx,7,0,1,1,0.413235,0.328835,0,"#ffb800"
433848001,cimesalvador,8,0,1,1,0.239763,0.275628,0,"#00ed5d"
433990623,lamontero1,40,0,1,1,0.639852,0.042191,0,"#ff12a3"
434133747,EduardoFonsec31,24,1,0,1,0.139028,0.621979,0,"#ff9b8f"
434345713,LeonorZozaya,30,23,23,46,0.539135,0.549573,0.021887,"#ff77ff"
434366411,LeireLeguina,30,0,1,1,0.489369,0.621056,0,"#ff77ff"
434429597,GuillemPumbap,1,0,1,1,0.463307,0.626575,0,"#b6cb00"
434481656,Stormende,17,0,4,4,0.679631,0.238733,0.001459,"#ff9cc7"
434504908,bivianabarcasne,38,0,1,1,0.606254,0.346245,0,"#662859"
434719881,lauramsrz,7,0,1,1,0.397003,0.198647,0,"#ffb800"
434751528,ernestoschrank,22,2,21,23,0.539708,0.562661,0.0107,"#00e8b2"
434832286,LesegLeyendo,22,0,1,1,0.407723,0.606658,0,"#00e8b2"
434869378,rosa_tovar_l,22,0,3,3,0.561416,0.567827,0.000973,"#00e8b2"
434928819,AridaniAcosta,40,0,1,1,0.616165,0.002003,0,"#ff12a3"
434968866,eadh_org,36,143,24,167,0.462971,0.524963,0.080739,"#825403"
435029976,inmitros,13,0,2,2,0.461296,0.403442,0.000486,"#3bec00"
435111755,DiariodeCLM,15,1,0,1,0.627706,0.675184,0,"#008ebb"
435299501,DeniseDresserG,17,2,0,2,0.731538,0.217762,0.000486,"#ff9cc7"
435378131,bobbylsmiley,13,0,1,1,0.429326,0.501129,0,"#3bec00"
435701186,MarcNadasan,49,1,0,1,0.377364,0.663614,0,"#ff7007"
435945325,alexfg66,49,0,3,3,0.729958,0.751172,0.000973,"#ff7007"
435948485,Vid_Santos,34,1,3,4,0.502822,0.500859,0.001459,"#ff0d69"
435950593,ana_hueso,1,0,2,2,0.65672,0.458671,0.000486,"#b6cb00"
435970422,DH_Oxford,30,14,2,16,0.500467,0.502944,0.007296,"#ff77ff"
435976850,armida_aponte,7,0,1,1,0.390858,0.210835,0,"#ffb800"
436095587,MeghaninMotion,34,0,3,3,0.382974,0.420974,0.000973,"#ff0d69"
436573380,Faborama,3,1,0,1,0.49142,0.753478,0,"#ffb3ff"
436626279,FundacionUR,24,0,1,1,0.152344,0.628646,0,"#ff9b8f"
436793617,unacosa2,30,0,1,1,0.511655,0.62638,0,"#ff77ff"
436834443,atencioncultura,38,2,1,3,0.576163,0.388594,0.000973,"#662859"
436918257,RoviraSara,14,0,1,1,0.694792,0.423806,0,"#00eeff"
436924152,ShakespeareArg,49,2,1,3,0.611788,0.651061,0.000973,"#ff7007"
437195971,IDRH_KU,41,18,15,33,0.412076,0.464414,0.015564,"#697b00"
437364590,CarlosRomeroUCV,35,0,1,1,0.724495,0.419504,0,"#00faff"
437591452,irynakuchma,13,0,1,1,0.491706,0.366664,0,"#3bec00"
437660451,martenduering,34,59,0,59,0.495742,0.463764,0.02821,"#ff0d69"
437806408,__malamujer,49,0,1,1,0.375126,0.585839,0,"#ff7007"
437837999,elenagbg,30,239,51,290,0.503118,0.551781,0.140564,"#ff77ff"
437846133,IcoryBu,31,1,0,1,0.71317,0.671445,0,"#3e93ff"
438333966,HelsinHashtags,34,0,3,3,0.356425,0.456215,0.000973,"#ff0d69"
438413504,RapaCarballo,14,0,1,1,0.673677,0.518387,0,"#00eeff"
438431916,merceditasX,3,0,1,1,0.482092,0.778668,0,"#ffb3ff"
438569011,mayorserrano,58,0,1,1,0.451741,0.650947,0,"#005076"
438586179,drorre,21,0,1,1,0.233046,0.201468,0,"#c6cc85"
438688821,marcondysap,36,0,1,1,0.483935,0.351207,0,"#825403"
439243467,PostigoElena,15,6,10,16,0.51614,0.641755,0.007296,"#008ebb"
439353044,soacedo,31,0,2,2,0.720834,0.46032,0.000486,"#3e93ff"
439370858,mantillamaria95,37,0,1,1,0.691349,0.330609,0,"#006032"
439747637,ElisetePaes,48,0,3,3,0.224201,0.663613,0.000973,"#ff7a78"
440164590,TaloBotaestufes,14,1,0,1,0.306706,0.432002,0,"#00eeff"
440826871,mcctravieso,30,0,2,2,0.555821,0.612727,0.000486,"#ff77ff"
440867151,urbaniza_2,49,2,0,2,0.396463,0.587223,0.000486,"#ff7007"
441382828,criserrot,36,0,1,1,0.509404,0.325339,0,"#825403"
441401321,MAPorrua,13,0,1,1,0.759573,0.637079,0,"#3bec00"
441465196,yuselycaraja,7,0,2,2,0.453942,0.401393,0.000486,"#ffb800"
441512712,LuisPabloAngel,41,0,1,1,0.344507,0.38242,0,"#697b00"
441795572,AlumniUPO,1,3,3,6,0.420884,0.538204,0.002432,"#b6cb00"
441843136,Jorgepb96,15,0,4,4,0.557611,0.566829,0.001459,"#008ebb"
441927873,braintrustcs,49,2,0,2,0.411092,0.571158,0.000486,"#ff7007"
442027863,Neferchitty,22,1,0,1,0.744711,0.445119,0,"#00e8b2"
442148989,MLeoCrespo,37,0,1,1,0.720006,0.593201,0,"#006032"
442359572,EdRezaD,13,0,2,2,0.483859,0.413867,0.000486,"#3bec00"
442725376,ainoa_castro,30,4,18,22,0.507091,0.564127,0.010214,"#ff77ff"
442801553,fuenteheridos,22,0,1,1,0.720408,0.612073,0,"#00e8b2"
442811622,alarconcasanova,49,2,0,2,0.413604,0.573225,0.000486,"#ff7007"
442886822,diyclassics,34,1,20,21,0.480125,0.471502,0.009728,"#ff0d69"
443026077,FernandoRamasco,0,0,2,2,0.440965,0.598653,0.000486,"#8ecfec"
443424403,CONICETLaPlata,49,4,0,4,0.479593,0.576272,0.001459,"#ff7007"
443479181,HenrySiqueiros,22,0,2,2,0.827361,0.296362,0.000486,"#00e8b2"
443576117,BNE_museo,30,4,1,5,0.540828,0.609207,0.001946,"#ff77ff"
443813466,santiusti,49,1,0,1,0.417935,0.648472,0,"#ff7007"
443948284,montsefeu,34,9,3,12,0.443266,0.450397,0.00535,"#ff0d69"
444010505,presadelazar,21,0,1,1,0.219583,0.223337,0,"#c6cc85"
444130899,MaryEmilyRed,37,0,1,1,0.221275,0.431885,0,"#006032"
444220703,FrutosLaura,55,0,2,2,0.68291,0.642112,0.000486,"#cb3f32"
444252079,enzotomas96,3,0,2,2,0.439421,0.554147,0.000486,"#ffb3ff"
444643307,sf_kath,38,0,1,1,0.732901,0.459419,0,"#662859"
445119000,gortazarbelvis,55,1,10,11,0.635576,0.622203,0.004864,"#cb3f32"
445207317,vicdurcas,13,1,3,4,0.538066,0.446634,0.001459,"#3bec00"
445516603,majothebear,55,0,4,4,0.692415,0.628601,0.001459,"#cb3f32"
445640969,marta_chillaron,14,1,0,1,0.740592,0.535861,0,"#00eeff"
445811947,mcarterSKW,36,0,1,1,0.446957,0.594733,0,"#825403"
446324242,maurotrujillo21,38,0,1,1,0.331869,0.289762,0,"#662859"
446468669,suricatem,38,1,3,4,0.612728,0.463173,0.001459,"#662859"
446626758,Oscarelo2x,49,1,0,1,0.340343,0.653614,0,"#ff7007"
446631932,Ciao_sono_Paola,22,0,1,1,0.672487,0.472654,0,"#00e8b2"
447394796,JavieraEstela,21,0,2,2,0.249667,0.243865,0.000486,"#c6cc85"
447438782,arroyo_vicky,17,0,1,1,0.800327,0.224343,0,"#ff9cc7"
447925903,AulaTICPYMEs,49,1,0,1,0.351063,0.671018,0,"#ff7007"
447931865,antonmanton,31,0,1,1,0.639084,0.502917,0,"#3e93ff"
448087712,AlcaldiaDeCali,49,1,0,1,0.336047,0.615919,0,"#ff7007"
448091508,YosoySuku,13,9,7,16,0.484071,0.460764,0.007296,"#3bec00"
448092052,JosepMLozano,8,5,0,5,0.642886,0.363441,0.001946,"#00ed5d"
448095929,_EstaLindaLaMar,3,11,28,39,0.558028,0.539615,0.018482,"#ffb3ff"
448513515,patriciajerezt,38,0,1,1,0.165273,0.430068,0,"#662859"
448550811,JavierMejiaC,38,1,1,2,0.588147,0.418747,0.000486,"#662859"
448797445,colguin7,22,0,2,2,0.607238,0.571733,0.000486,"#00e8b2"
448818875,consescat,8,1,0,1,0.654455,0.256214,0,"#00ed5d"
449011594,i_bazanestrada,13,2,1,3,0.488256,0.496639,0.000973,"#3bec00"
449090826,fundeticbolivia,49,0,1,1,0.378698,0.580395,0,"#ff7007"
449141031,_Artemisa_v,4,0,1,1,0.365101,0.441441,0,"#f4c8cf"
449190802,_athal,1,2,3,5,0.463834,0.554847,0.001946,"#b6cb00"
449308758,aainhoaaa,0,0,1,1,0.429784,0.560194,0,"#8ecfec"
449647519,vickyllorens,3,0,1,1,0.446619,0.652357,0,"#ffb3ff"
449894703,mecuencal,38,0,1,1,0.684593,0.466696,0,"#662859"
450002311,LUCIAPOLANIA,15,0,3,3,0.569124,0.710025,0.000973,"#008ebb"
450002467,fdpadilla2012,49,1,0,1,0.309696,0.657983,0,"#ff7007"
450555248,LaurelLibros,21,0,1,1,0.148241,0.618471,0,"#c6cc85"
450618095,UnimetAlumni,34,0,1,1,0.557277,0.34398,0,"#ff0d69"
450853334,blayams,1,0,2,2,0.73185,0.558339,0.000486,"#b6cb00"
451005800,alomortiz,49,1,0,1,0.366419,0.615496,0,"#ff7007"
451394738,ValentinaTruth,2,0,1,1,0.674162,0.383108,0,"#ffa64e"
451414924,samcineclube,49,0,1,1,0.493298,0.352923,0,"#ff7007"
452214320,Basilrastrol,7,0,2,2,0.566346,0.489455,0.000486,"#ffb800"
452343173,ElviFernandez16,49,1,0,1,0.378396,0.662796,0,"#ff7007"
452443472,txellblay,30,0,1,1,0.264154,0.638658,0,"#ff77ff"
452904608,CEHUM_UMinho,36,3,0,3,0.623717,0.467302,0.000973,"#825403"
452910214,CIESEComillas,22,10,3,13,0.559367,0.630874,0.005837,"#00e8b2"
453864030,upoemprende,1,1,0,1,0.473663,0.590678,0,"#b6cb00"
454150303,alchasai,30,0,2,2,0.500382,0.597793,0.000486,"#ff77ff"
454810857,GuidoBlogs,22,0,1,1,0.431307,0.704655,0,"#00e8b2"
455259911,cedocuib,37,0,3,3,0.628371,0.65126,0.000973,"#006032"
455409829,MauricioHoyos4,38,0,7,7,0.514862,0.435088,0.002918,"#662859"
455451340,msanhuezacelsi,21,0,1,1,0.134778,0.617625,0,"#c6cc85"
455605329,DoloresRomero_,30,150,202,352,0.525292,0.53142,0.17072,"#ff77ff"
455639423,JVillaFreixa,8,1,0,1,0.662143,0.239682,0,"#00ed5d"
456012667,cuaieedunam,13,12,9,21,0.507672,0.482705,0.009728,"#3bec00"
456136684,la_pool,55,0,1,1,0.66309,0.55949,0,"#cb3f32"
456143365,AGNMex,49,6,1,7,0.395004,0.48254,0.002918,"#ff7007"
456538187,evabugs_padi,19,3,0,3,0.670547,0.737823,0.000973,"#00d3ff"
456633892,BairdCampbell,49,1,0,1,0.302275,0.357353,0,"#ff7007"
456751217,CEIColmex,7,6,4,10,0.447426,0.360078,0.004377,"#ffb800"
457090748,auroraggf,7,4,4,8,0.473485,0.4279,0.003405,"#ffb800"
457173243,marce_echeverri,9,0,3,3,0.695226,0.676609,0.000973,"#008f7b"
457206575,pipesarmientom,38,0,1,1,0.591019,0.336863,0,"#662859"
457613501,Gabacer,13,6,5,11,0.543758,0.44463,0.004864,"#3bec00"
457637965,jsr_javi,40,0,1,1,0.606799,0.012324,0,"#ff12a3"
457712899,InmaFalcon1,35,3,0,3,0.548519,0.461265,0.000973,"#00faff"
457881584,marisamuseu,31,1,0,1,0.635154,0.480772,0,"#3e93ff"
458400129,Redazione_ROARS,38,3,0,3,0.51642,0.422615,0.000973,"#662859"
458459235,AcademiaAgp,22,0,1,1,0.589678,0.621265,0,"#00e8b2"
458670065,Patricia__Vega,37,2,1,3,0.413297,0.435624,0.000973,"#006032"
458758530,Anadejampa,36,0,1,1,0.436618,0.369462,0,"#825403"
458797160,profjuliette,4,2,1,3,0.622489,0.415892,0.000973,"#f4c8cf"
459202451,BECAES_,30,0,1,1,0.585066,0.667552,0,"#ff77ff"
459411454,colombiahoy,38,11,0,11,0.612072,0.413885,0.004864,"#662859"
459498108,throughthe_veil,36,0,13,13,0.435838,0.469051,0.005837,"#825403"
459695054,SwimFerreyra,30,0,2,2,0.528268,0.636087,0.000486,"#ff77ff"
459780476,rodasmilian,7,0,1,1,0.385406,0.20159,0,"#ffb800"
459823469,LeVoyagedeTete,13,0,2,2,0.522954,0.420203,0.000486,"#3bec00"
460076508,Euroforum_ES,49,4,0,4,0.435489,0.569453,0.001459,"#ff7007"
460084942,inforarea,22,0,3,3,0.595593,0.581508,0.000973,"#00e8b2"
460138490,SilvanaCASERO,55,0,3,3,0.649049,0.639246,0.000973,"#cb3f32"
460255493,UZH_en,36,7,0,7,0.515222,0.40524,0.002918,"#825403"
460440037,SinfonicaCol,38,0,1,1,0.594227,0.357852,0,"#662859"
460466319,m_agonizo,49,2,0,2,0.441119,0.635992,0.000486,"#ff7007"
460490682,MiroVillar,0,0,1,1,0.384329,0.610986,0,"#8ecfec"
460527338,CapitanZar,38,0,2,2,0.695885,0.595577,0.000486,"#662859"
460797252,MarxArriaga,1,2,4,6,0.372994,0.49196,0.002432,"#b6cb00"
460964190,unedcantabria,30,0,3,3,0.524032,0.583407,0.000973,"#ff77ff"
461282274,FundacioBofill,8,2,1,3,0.605213,0.389776,0.000973,"#00ed5d"
461291053,Rick1503o_O,12,1,2,3,0.846438,0.59998,0.000973,"#00a04a"
461301760,AdHoc22,31,0,9,9,0.549214,0.540535,0.003891,"#3e93ff"
461302986,AprendiendoSM,49,1,0,1,0.39828,0.632404,0,"#ff7007"
461347648,einyelg,22,0,2,2,0.668728,0.642024,0.000486,"#00e8b2"
461911970,clatormo,22,0,1,1,0.382178,0.596762,0,"#00e8b2"
462269675,edgaralbert29,35,0,1,1,0.556799,0.420189,0,"#00faff"
462322959,lrlfigueroa,14,0,1,1,0.630606,0.601574,0,"#00eeff"
462396490,Jaritah_Lu,31,1,2,3,0.634217,0.539652,0.000973,"#3e93ff"
462630430,jhfloriang,13,0,1,1,0.524066,0.38661,0,"#3bec00"
462845338,saloeslava,1,0,5,5,0.561791,0.54451,0.001946,"#b6cb00"
463078713,Juan_Melia,0,0,2,2,0.571373,0.651788,0.000486,"#8ecfec"
463207079,KidadaEWilliams,34,0,2,2,0.364816,0.421068,0.000486,"#ff0d69"
463280317,LuisMFdzC,49,2,3,5,0.413877,0.580857,0.001946,"#ff7007"
463612014,MorganRDZ,0,4,0,4,0.362305,0.471804,0.001459,"#8ecfec"
463758700,Robleskywalker,38,0,1,1,0.067182,0.446072,0,"#662859"
463962528,MarioAGuzmanR,17,0,1,1,0.806902,0.226776,0,"#ff9cc7"
463978322,epiagranollers,8,1,1,2,0.67902,0.323597,0.000486,"#00ed5d"
464418324,raprig,49,1,0,1,0.313112,0.611119,0,"#ff7007"
464600521,VincentVega45,40,0,1,1,0.588566,0.050757,0,"#ff12a3"
464744323,NatyEsquenazi,37,0,1,1,0.265512,0.467252,0,"#006032"
464762135,Mcotsar,34,1,3,4,0.513004,0.513577,0.001459,"#ff0d69"
464786445,mgilfour,0,1,0,1,0.299095,0.397304,0,"#8ecfec"
464875025,evagalansempere,30,0,1,1,0.841785,0.6361,0,"#ff77ff"
464962999,ImaginedReaders,30,1,0,1,0.606858,0.547215,0,"#ff77ff"
465027830,Krysstell_Marin,31,0,1,1,0.62356,0.599163,0,"#3e93ff"
465189997,candy_isa_75,7,0,2,2,0.382068,0.36701,0.000486,"#ffb800"
465289637,lbiedma17,13,0,1,1,0.638544,0.981915,0,"#3bec00"
465628233,Dejusticia,38,1,0,1,0.54179,0.367613,0,"#662859"
465690991,CJimenezC_,37,0,2,2,0.664832,0.519088,0.000486,"#006032"
465709212,santiago130745,31,0,1,1,0.660489,0.537036,0,"#3e93ff"
465809483,JimenaAlmenara,30,0,2,2,0.553331,0.642067,0.000486,"#ff77ff"
465912277,Hermosa_Panama,49,1,0,1,0.403243,0.683021,0,"#ff7007"
465955725,PCEGetafe,19,1,0,1,0.659235,0.783859,0,"#00d3ff"
466003460,madridcyp,58,0,1,1,0.592151,0.181795,0,"#005076"
466833856,ClaudiaVAlonso,37,0,1,1,0.629781,0.437855,0,"#006032"
466880427,GulKultur,0,0,2,2,0.572175,0.653127,0.000486,"#8ecfec"
466903436,nataliasilvapra,14,13,15,28,0.53736,0.482183,0.013132,"#00eeff"
466949354,Mario_Cabrero,58,0,2,2,0.595088,0.297733,0.000486,"#005076"
467162210,lissbarniz,30,0,2,2,0.52441,0.506785,0.000486,"#ff77ff"
467210481,Karoluciana,7,0,2,2,0.422394,0.334654,0.000486,"#ffb800"
467341825,UCM_fghis,30,15,3,18,0.532325,0.645822,0.008268,"#ff77ff"
467373252,NOVAunl,36,7,3,10,0.525664,0.411325,0.004377,"#825403"
467551928,ERC_Research,30,2,0,2,0.505526,0.607507,0.000486,"#ff77ff"
467655057,AppDemography,34,0,1,1,0.389707,0.45504,0,"#ff0d69"
467708979,diazs_maria,49,1,0,1,0.360422,0.65568,0,"#ff7007"
467872558,JHCifuentesM,13,1,2,3,0.564164,0.438855,0.000973,"#3bec00"
467876886,Javier_Jover,22,0,6,6,0.517184,0.592651,0.002432,"#00e8b2"
468076687,erinroseglass,13,0,4,4,0.4499,0.482391,0.001459,"#3bec00"
468201342,griso_unav,1,10,0,10,0.507995,0.553628,0.004377,"#b6cb00"
468248605,TamarSalazar,49,1,0,1,0.328125,0.679703,0,"#ff7007"
468249929,BLMedieval,7,1,0,1,0.383447,0.292758,0,"#ffb800"
468271526,ARDITMedieval,22,1,1,2,0.533786,0.633423,0.000486,"#00e8b2"
468415981,Ingenio_CsicUpv,22,0,4,4,0.556013,0.56296,0.001459,"#00e8b2"
468486171,patrimonioeduca,22,0,1,1,0.634486,0.614282,0,"#00e8b2"
468533110,ElUltimoShaolin,49,1,0,1,0.311453,0.691147,0,"#ff7007"
468622007,CONDEMATEAS,15,0,2,2,0.569153,0.63189,0.000486,"#008ebb"
468738172,HijoDeDonCarlos,15,0,1,1,0.718033,0.59867,0,"#008ebb"
468789036,estherfl_,49,2,0,2,0.405081,0.569839,0.000486,"#ff7007"
468800480,dansalcat,40,0,1,1,0.624223,0.017146,0,"#ff12a3"
468918188,marcelaramos24,49,1,0,1,0.347761,0.65952,0,"#ff7007"
469261892,lascuatroninias,34,0,1,1,0.489673,0.379358,0,"#ff0d69"
469501029,sursiendo,13,23,3,26,0.429685,0.510324,0.01216,"#3bec00"
469537125,m_alexandre98,58,0,3,3,0.292866,0.512026,0.000973,"#005076"
469562236,JuanFRueda,14,0,2,2,0.606153,0.495815,0.000486,"#00eeff"
470030287,RaquelVenegas,3,0,3,3,0.484018,0.67926,0.000973,"#ffb3ff"
470221258,ViNikima,36,0,2,2,0.541445,0.432142,0.000486,"#825403"
470346497,natbag83,7,0,1,1,0.808581,0.555495,0,"#ffb800"
470399069,Mr_Manuel_V,14,1,0,1,0.729666,0.529978,0,"#00eeff"
470586933,victorMsanchis,30,0,1,1,0.631495,0.613699,0,"#ff77ff"
470646552,e_morituri,13,1,0,1,0.476177,0.391168,0,"#3bec00"
470906647,grisalla,14,0,2,2,0.646425,0.53406,0.000486,"#00eeff"
470961089,mcarpegar,0,0,1,1,0.378521,0.56705,0,"#8ecfec"
471325907,l_alejandre,8,0,1,1,0.242091,0.265377,0,"#00ed5d"
471351155,AMIC_com,7,7,1,8,0.402879,0.58461,0.003405,"#ffb800"
471390293,AuroraAlvarez97,49,1,0,1,0.390727,0.663811,0,"#ff7007"
471516384,vievararosel,30,0,1,1,0.497447,0.618835,0,"#ff77ff"
471603614,HeribCaballero,13,0,2,2,0.503684,0.415828,0.000486,"#3bec00"
471619996,MartinelliPaola,48,0,1,1,0.239086,0.719695,0,"#ff7a78"
471926670,EspacioFTef,0,77,23,100,0.482453,0.561049,0.048152,"#8ecfec"
472131244,MabelYescas,37,0,1,1,0.629251,0.208073,0,"#006032"
472139026,ScienceMetrix,22,1,0,1,0.5605,0.640806,0,"#00e8b2"
472210485,aromina_m,3,2,1,3,0.480117,0.665228,0.000973,"#ffb3ff"
472217141,ILCEedu,3,17,12,29,0.484429,0.556282,0.013619,"#ffb3ff"
472266257,raulmoncadaf,4,0,1,1,0.868639,0.224599,0,"#f4c8cf"
472336787,cafelluvia,42,11,7,18,0.610838,0.522313,0.008268,"#66e087"
472360175,mluisadiez,30,2,8,10,0.531128,0.556564,0.004377,"#ff77ff"
472405313,Emilioch1,37,0,1,1,0.270216,0.475721,0,"#006032"
472828635,ElainaReioli,36,0,1,1,0.520161,0.23865,0,"#825403"
472889327,DigCurationUnit,36,0,2,2,0.461378,0.536151,0.000486,"#825403"
472898097,DaleLore,34,0,3,3,0.377271,0.429845,0.000973,"#ff0d69"
472919559,cmatain,1,2,4,6,0.563555,0.512243,0.002432,"#b6cb00"
473074192,fcortesga,58,1,0,1,0.688568,0.66342,0,"#005076"
473091810,VirginiaBazang,1,2,0,2,0.440541,0.5559,0.000486,"#b6cb00"
473238253,otrovagomass,3,0,1,1,0.477951,0.784842,0,"#ffb3ff"
473848776,aritzagere,31,0,2,2,0.635795,0.560134,0.000486,"#3e93ff"
473884335,CrueUniversidad,0,2,0,2,0.632148,0.620727,0.000486,"#8ecfec"
474168947,Danielmerino126,22,0,4,4,0.689193,0.363517,0.001459,"#00e8b2"
474461880,ivanhcastillom,3,0,1,1,0.475834,0.760473,0,"#ffb3ff"
474526546,musarian,34,0,2,2,0.389835,0.425594,0.000486,"#ff0d69"
474725736,raquelsanzmar,24,0,1,1,0.166223,0.624404,0,"#ff9b8f"
474753968,arteedadsilicio,31,1,0,1,0.634944,0.485051,0,"#3e93ff"
474773670,LuisMartinNuez,0,0,2,2,0.412963,0.55467,0.000486,"#8ecfec"
474775311,DDPNacho,0,0,4,4,0.4153,0.600845,0.001459,"#8ecfec"
474812471,hmontalvo2012,8,0,1,1,0.271762,0.262022,0,"#00ed5d"
474834196,IberoVervuert,0,1,3,4,0.505672,0.555225,0.001459,"#8ecfec"
474887690,CSICCat,22,10,12,22,0.527791,0.599148,0.010214,"#00e8b2"
475026877,a_gserrano,30,21,5,26,0.538426,0.567568,0.01216,"#ff77ff"
475240029,ASELE_ELE,1,58,7,65,0.464312,0.644421,0.031128,"#b6cb00"
475319630,RosadoMendoza10,4,0,1,1,0.839035,0.224548,0,"#f4c8cf"
475359198,JaZamoraBonilla,15,0,2,2,0.553819,0.731717,0.000486,"#008ebb"
475377277,film9597,21,0,1,1,0.199184,0.242594,0,"#c6cc85"
475633573,mvbertomeu,13,0,1,1,0.418452,0.422197,0,"#3bec00"
476008897,FWFOpenAccess,13,0,1,1,0.487315,0.366357,0,"#3bec00"
476014717,CMasAlvarez,1,0,3,3,0.467493,0.689148,0.000973,"#b6cb00"
476192104,CarlosMeher,49,1,0,1,0.366477,0.666862,0,"#ff7007"
476284674,ElenaEtchemendy,55,0,2,2,0.538484,0.518422,0.000486,"#cb3f32"
476388649,labticunipe,22,1,0,1,0.615383,0.693196,0,"#00e8b2"
476797700,dacomesana,49,2,0,2,0.430443,0.584517,0.000486,"#ff7007"
477075410,PascuSantos,22,0,3,3,0.585679,0.574893,0.000973,"#00e8b2"
477728660,romanistik_de,30,2,7,9,0.498425,0.550373,0.003891,"#ff77ff"
478134330,guerraenmadrid,19,0,1,1,0.637641,0.784713,0,"#00d3ff"
478295252,CamachoMerc,13,0,1,1,0.457898,0.404629,0,"#3bec00"
478510248,lamadrazacccugr,31,1,13,14,0.616772,0.57404,0.006323,"#3e93ff"
478538836,isabelatecno,14,0,1,1,0.466002,0.286301,0,"#00eeff"
478697791,miguelcid1,7,0,1,1,0.787067,0.581939,0,"#ffb800"
478736764,celisdi,2,0,1,1,0.664535,0.373028,0,"#ffa64e"
478825954,subupo,21,0,2,2,0.231488,0.335759,0.000486,"#c6cc85"
478889932,cunygcdi,34,8,8,16,0.457676,0.408826,0.007296,"#ff0d69"
478975707,MangleRojoOrg,49,2,0,2,0.338871,0.707328,0.000486,"#ff7007"
479072220,jupasom,30,0,2,2,0.602201,0.605857,0.000486,"#ff77ff"
479120161,CorralMilagros,30,0,1,1,0.53693,0.449477,0,"#ff77ff"
479165236,josedapik,21,0,1,1,0.028151,0.626077,0,"#c6cc85"
479212000,eleahlane,34,11,1,12,0.470564,0.425638,0.00535,"#ff0d69"
479484571,Euroaula,8,0,2,2,0.691117,0.318807,0.000486,"#00ed5d"
479720712,michatis,34,0,9,9,0.50431,0.442046,0.003891,"#ff0d69"
479750873,rosariogd9,1,0,2,2,0.655111,0.439254,0.000486,"#b6cb00"
479774287,VanesaRegaladoV,22,0,3,3,0.546305,0.585561,0.000973,"#00e8b2"
479784061,BibliotecasPUJ,37,21,9,30,0.565598,0.407766,0.014105,"#006032"
479816944,paujournaliste,30,0,1,1,0.596084,0.676772,0,"#ff77ff"
479885889,VRaikuzu,38,0,2,2,0.696789,0.581632,0.000486,"#662859"
479956548,CarmenSubiabre,21,0,2,2,0.26542,0.228056,0.000486,"#c6cc85"
480236585,Miko_Stanek,22,0,2,2,0.62213,0.423198,0.000486,"#00e8b2"
480557521,AkalEditor,38,20,3,23,0.669307,0.471695,0.0107,"#662859"
481015959,oasisll95,4,0,2,2,0.406752,0.38064,0.000486,"#f4c8cf"
481165470,TheCmalpica,14,0,1,1,0.702989,0.566406,0,"#00eeff"
481216292,JuanMEscribano,1,5,18,23,0.499876,0.701367,0.0107,"#b6cb00"
481231680,gecatolico,38,0,1,1,0.676711,0.461866,0,"#662859"
481260788,no_identd,36,2,0,2,0.404527,0.365155,0.000486,"#825403"
481547953,Oskar_Almazan_,22,2,1,3,0.37866,0.714836,0.000973,"#00e8b2"
481583328,JessicaHermosi2,21,0,1,1,0.159006,0.603485,0,"#c6cc85"
481872177,loa_82,8,0,1,1,0.254462,0.255869,0,"#00ed5d"
481920295,manuelaparralo,30,0,1,1,0.613593,0.665681,0,"#ff77ff"
481937926,robertodelledo,30,0,1,1,0.43257,0.621539,0,"#ff77ff"
482096482,SandraaLorente,49,1,0,1,0.385176,0.685368,0,"#ff7007"
482264378,itemtrad,58,0,2,2,0.550477,0.604488,0.000486,"#005076"
482519940,amparojesusct,2,0,1,1,0.648293,0.649701,0,"#ffa64e"
482810341,JaviPuente1976,49,1,0,1,0.292411,0.61735,0,"#ff7007"
482842277,Paula_LGG,4,0,2,2,0.502524,0.385974,0.000486,"#f4c8cf"
482969367,isabelherrera34,30,0,1,1,0.509429,0.665073,0,"#ff77ff"
483039134,janmoreno_tgn,1,0,4,4,0.448653,0.643935,0.001459,"#b6cb00"
483045008,carbadol,22,0,4,4,0.542301,0.631405,0.001459,"#00e8b2"
483295501,bqh2,10,0,2,2,0.39405,0.325284,0.000486,"#52d7c0"
483307618,piazol,21,0,1,1,0.333833,0.440101,0,"#c6cc85"
483555465,lexicgrace,34,0,1,1,0.344866,0.433543,0,"#ff0d69"
483699626,Jucaquma,49,1,0,1,0.410396,0.684647,0,"#ff7007"
483929704,PixelXen1,14,0,1,1,0.666205,0.53862,0,"#00eeff"
483998929,nuriastweets,37,0,1,1,0.644349,0.491934,0,"#006032"
484022466,Rechercher7,46,0,1,1,0.483761,0.151813,0,"#403538"
484182452,cafenecesario,3,0,1,1,0.628568,0.575914,0,"#ffb3ff"
484194793,arxiverslleida,30,0,1,1,0.518256,0.637794,0,"#ff77ff"
484311140,LWieck,34,0,1,1,0.306768,0.410048,0,"#ff0d69"
484446163,Estuaria8,21,0,2,2,0.196748,0.255047,0.000486,"#c6cc85"
484634911,noktuae,36,0,7,7,0.482621,0.498774,0.002918,"#825403"
484756923,aliciacbu,14,11,28,39,0.505785,0.538068,0.018482,"#00eeff"
484861681,ant_mrubio,1,0,6,6,0.482563,0.59664,0.002432,"#b6cb00"
485053239,HoraAmerica,14,0,2,2,0.433489,0.532047,0.000486,"#00eeff"
485109912,NautilusMag,36,1,0,1,0.438493,0.29842,0,"#825403"
485178465,Assumpta16,0,0,1,1,0.82506,0.436194,0,"#8ecfec"
485219094,eliolaureano,49,2,0,2,0.406223,0.565098,0.000486,"#ff7007"
485328267,Jimena_Clavijo_,7,0,1,1,0.392054,0.348812,0,"#ffb800"
485490370,herranz_c,37,1,0,1,0.679257,0.393042,0,"#006032"
485538735,ciencia_uc3m,19,3,2,5,0.63279,0.620589,0.001946,"#00d3ff"
485593296,susen23,13,0,4,4,0.436294,0.484132,0.001459,"#3bec00"
485649319,gcamanez,19,0,2,2,0.665001,0.756504,0.000486,"#00d3ff"
485718905,lefteye91,49,0,3,3,0.457669,0.673356,0.000973,"#ff7007"
485853975,Miguel_RHs,8,0,2,2,0.669984,0.306613,0.000486,"#00ed5d"
486007768,ldabcn,22,0,1,1,0.753555,0.425545,0,"#00e8b2"
486056498,MargrietHoogvli,36,0,1,1,0.766994,0.511967,0,"#825403"
486481939,lola_pez,0,3,0,3,0.912872,0.711616,0.000973,"#8ecfec"
486926802,BBChretienXVI,38,0,3,3,0.575612,0.445296,0.000973,"#662859"
486937118,pssdelarco,30,0,2,2,0.535978,0.59967,0.000486,"#ff77ff"
487039030,xrxxdnxs,37,0,1,1,0.370113,0.329079,0,"#006032"
487405053,Masimva,1,0,2,2,0.464768,0.691717,0.000486,"#b6cb00"
487443153,SindicaEstudian,19,1,0,1,0.624342,0.77762,0,"#00d3ff"
487552078,BlancaSanjuanbe,22,2,2,4,0.525223,0.575865,0.001459,"#00e8b2"
487645334,DboTalmon,49,1,0,1,0.420849,0.700141,0,"#ff7007"
487656141,monigra64,38,0,1,1,0.576543,0.704979,0,"#662859"
487702107,franjoseen,38,0,1,1,0.088027,0.42893,0,"#662859"
487873280,NinfaOceanide,13,0,4,4,0.48598,0.439565,0.001459,"#3bec00"
487905012,Marenclaudesol,34,0,1,1,0.580575,0.350748,0,"#ff0d69"
488481422,IndustriaDigCol,38,1,0,1,0.672749,0.482463,0,"#662859"
488492530,TelefonicaEmpCA,49,1,0,1,0.405696,0.637801,0,"#ff7007"
488669120,arqueomaniaprod,30,0,1,1,0.523241,0.62836,0,"#ff77ff"
488688602,cintiatg88,49,0,1,1,0.491237,0.690211,0,"#ff7007"
488751049,Ninhursaq,0,0,3,3,0.424823,0.550834,0.000973,"#8ecfec"
488775194,edrodven,49,1,0,1,0.301344,0.617681,0,"#ff7007"
488951611,OPR_71,49,29,33,62,0.510304,0.531247,0.029669,"#ff7007"
489156276,dedosrosados,30,0,3,3,0.564572,0.592479,0.000973,"#ff77ff"
489170753,DOABooks,49,1,0,1,0.397691,0.68138,0,"#ff7007"
489404622,Ana_Lobo_,58,1,3,4,0.51041,0.612933,0.001459,"#005076"
489567992,JoseMCaamanoLop,2,0,1,1,0.389846,0.554376,0,"#ffa64e"
489758413,fredverbeke,22,0,3,3,0.547825,0.696216,0.000973,"#00e8b2"
489772333,patodiazGNU,55,9,4,13,0.625927,0.623262,0.005837,"#cb3f32"
490406323,ILeoLee16,42,0,1,1,0.766365,0.443044,0,"#66e087"
490649494,sandralles,22,0,1,1,0.612553,0.592156,0,"#00e8b2"
490720843,schelbertgeorg,30,0,1,1,0.489432,0.63319,0,"#ff77ff"
490807432,victor_iniesta,15,0,1,1,0.610948,0.634208,0,"#008ebb"
490832294,Kenny_DiazPR,31,2,0,2,0.646084,0.482975,0.000486,"#3e93ff"
491200214,culturasucm,58,15,10,25,0.532825,0.560718,0.011673,"#005076"
491409568,JoaquimPrats,8,2,1,3,0.666909,0.293718,0.000973,"#00ed5d"
491484735,FacultadeHyD,30,5,1,6,0.81818,0.548953,0.002432,"#ff77ff"
491536375,beamas1,13,0,1,1,0.476295,0.339468,0,"#3bec00"
491605533,antonquik1111,21,0,1,1,0.465626,0.956809,0,"#c6cc85"
491663397,StSchulte,30,1,0,1,0.593822,0.572494,0,"#ff77ff"
492009914,junjudapi,14,0,1,1,0.714175,0.037383,0,"#00eeff"
492179849,ArantxaSt,15,0,3,3,0.567411,0.615809,0.000973,"#008ebb"
492184231,Patriciadcm,31,5,3,8,0.492317,0.577049,0.003405,"#3e93ff"
492334407,BCCSpeakers,49,1,0,1,0.301689,0.623221,0,"#ff7007"
492341140,complitca,15,1,1,2,0.421552,0.636709,0.000486,"#008ebb"
492447179,UNIRResearch,14,14,1,15,0.478063,0.510977,0.006809,"#00eeff"
492567212,lau_devil,37,2,1,3,0.663277,0.496823,0.000973,"#006032"
492619153,a_ortigosa,37,0,1,1,0.571927,0.463407,0,"#006032"
492624664,p_westman,13,2,0,2,0.397955,0.52218,0.000486,"#3bec00"
492649740,BibliotecadeMx,13,0,2,2,0.483022,0.432578,0.000486,"#3bec00"
492650091,HisAmbyPol,38,4,8,12,0.553338,0.466658,0.00535,"#662859"
492696585,Jordin_Morales,42,1,0,1,0.774809,0.42902,0,"#66e087"
492932268,Idiap_ch,14,1,0,1,0.653089,0.610285,0,"#00eeff"
493117643,JoseIgnacioSama,38,0,6,6,0.586129,0.518662,0.002432,"#662859"
493274033,alfayomegasem,49,1,0,1,0.315799,0.672369,0,"#ff7007"
493298468,Miguel_RamFey,10,0,2,2,0.364858,0.516829,0.000486,"#52d7c0"
493509695,bunebas,34,0,3,3,0.499309,0.43,0.000973,"#ff0d69"
493677194,clujanaldana,10,0,1,1,0.679814,0.795549,0,"#52d7c0"
493916582,IreneAdlerLives,30,0,1,1,0.634187,0.610299,0,"#ff77ff"
494009126,Alruizortiz,30,0,1,1,0.571477,0.697077,0,"#ff77ff"
494041400,_minecogob,49,3,0,3,0.439081,0.619469,0.000973,"#ff7007"
494088333,dapamon3,31,0,3,3,0.603207,0.511916,0.000973,"#3e93ff"
494215236,guzmana_angel,49,0,2,2,0.572857,0.566969,0.000486,"#ff7007"
494306860,INED21,49,1,0,1,0.416225,0.663355,0,"#ff7007"
494325431,pinvisibles,2,38,0,38,0.688798,0.519128,0.017996,"#ffa64e"
494370026,josemaromeros,31,0,3,3,0.560288,0.558663,0.000973,"#3e93ff"
494432272,ammont82,22,0,1,1,0.579201,0.62033,0,"#00e8b2"
494837827,accaminero,30,9,18,27,0.497325,0.562201,0.012646,"#ff77ff"
494949967,GuillermoRoz1,15,0,2,2,0.620558,0.513931,0.000486,"#008ebb"
494979428,PepeGalisteo,55,0,1,1,0.660446,0.561828,0,"#cb3f32"
494988085,ESICSevilla,49,1,0,1,0.419138,0.659445,0,"#ff7007"
494994779,PauCabrera_A,21,0,1,1,0.219357,0.218868,0,"#c6cc85"
495081834,SergiBravo,38,0,3,3,0.599433,0.526824,0.000973,"#662859"
495153224,data_fiend,36,0,4,4,0.447917,0.502884,0.001459,"#825403"
495229857,soylaheredera,31,4,0,4,0.577469,0.473819,0.001459,"#3e93ff"
495243533,REX_GERMANUS,30,2,1,3,0.588943,0.43326,0.000973,"#ff77ff"
495288193,_ALDEE,30,0,1,1,0.612271,0.655972,0,"#ff77ff"
495312774,jorgetopo1963,19,0,1,1,0.635314,0.780052,0,"#00d3ff"
495399812,elsemantico,30,0,2,2,0.512659,0.605474,0.000486,"#ff77ff"
495445539,iReputacion,49,1,0,1,0.37562,0.62623,0,"#ff7007"
495473617,Juanmanuelmaci,22,10,3,13,0.278765,0.654646,0.005837,"#00e8b2"
495562702,KWaldenPhD,13,0,1,1,0.383602,0.439115,0,"#3bec00"
495775527,BPELUS,30,0,2,2,0.537463,0.530425,0.000486,"#ff77ff"
496926641,eElenaVG,30,0,2,2,0.527166,0.680078,0.000486,"#ff77ff"
496931713,bgmps,22,0,5,5,0.570809,0.540088,0.001946,"#00e8b2"
496971636,patcheschasse,34,0,1,1,0.476019,0.374729,0,"#ff0d69"
496971869,malagalab,31,0,3,3,0.592905,0.540078,0.000973,"#3e93ff"
497105706,CaroCiudadana,21,0,1,1,0.172309,0.24954,0,"#c6cc85"
497191321,FerLLaneza,49,1,0,1,0.368215,0.65001,0,"#ff7007"
497207729,shaun_riordan,15,0,1,1,0.625963,0.626905,0,"#008ebb"
497280607,gismeross,14,0,3,3,0.516035,0.561648,0.000973,"#00eeff"
497308097,antiguoscafes,58,0,2,2,0.62135,0.304445,0.000486,"#005076"
497838391,Edu21_cat,8,2,0,2,0.630992,0.331069,0.000486,"#00ed5d"
497889775,manufernandezba,30,0,2,2,0.567972,0.530724,0.000486,"#ff77ff"
497987194,RamosRuizA,31,3,4,7,0.594373,0.524859,0.002918,"#3e93ff"
498088166,menesmanuel,49,1,0,1,0.390805,0.626117,0,"#ff7007"
498162955,mjcolmenero,34,34,5,39,0.500423,0.48094,0.018482,"#ff0d69"
498220254,encar_sepe,22,0,1,1,0.57234,0.629432,0,"#00e8b2"
498251978,Blablablamuseos,31,0,2,2,0.619358,0.471486,0.000486,"#3e93ff"
498459433,ockis2403,7,0,1,1,0.389313,0.206827,0,"#ffb800"
498967997,AliMatturro,31,0,1,1,0.822535,0.52462,0,"#3e93ff"
498993203,MarceGT67,30,0,2,2,0.502729,0.606862,0.000486,"#ff77ff"
499036642,dorotheakleine,49,0,1,1,0.35612,0.491599,0,"#ff7007"
499403853,UniversitasH,13,3,0,3,0.508712,0.439437,0.000973,"#3bec00"
499624389,rromeromedina,14,1,2,3,0.490962,0.526408,0.000973,"#00eeff"
499657507,vilamuseu,2,0,1,1,0.661078,0.379918,0,"#ffa64e"
499683768,joanqueralto,8,1,0,1,0.677497,0.25065,0,"#00ed5d"
499717805,mj_palomo,22,0,1,1,0.646572,0.465325,0,"#00e8b2"
499911925,anaiggo_archive,22,0,7,7,0.522921,0.580682,0.002918,"#00e8b2"
500245826,NeyBh,36,0,1,1,0.375462,0.342319,0,"#825403"
500290457,DefNatalia,10,0,1,1,0.671559,0.798766,0,"#52d7c0"
501006489,ConeixHistoria,19,1,4,5,0.633837,0.746715,0.001946,"#00d3ff"
501193600,ncangros,30,1,0,1,0.605012,0.43868,0,"#ff77ff"
501301330,jpinasco,37,1,0,1,0.706337,0.475618,0,"#006032"
501486617,PMClavero,15,0,2,2,0.523456,0.669531,0.000486,"#008ebb"
501636943,Leyre_Martin,1,31,34,65,0.48172,0.567326,0.031128,"#b6cb00"
501730852,videoenredo,22,0,1,1,0.649698,0.471848,0,"#00e8b2"
501831002,Chilealinstante,31,1,0,1,0.599973,0.475138,0,"#3e93ff"
502005651,TVMORFOSIS,3,5,4,9,0.501536,0.687864,0.003891,"#ffb3ff"
502005672,AmparoAlonsoB,14,10,4,14,0.533196,0.552647,0.006323,"#00eeff"
502232863,Cindymontoyal,38,1,0,1,0.688784,0.316267,0,"#662859"
502948738,m__s_s,49,2,0,2,0.401104,0.571958,0.000486,"#ff7007"
503329326,MelinaZerreitug,21,0,2,2,0.268264,0.237241,0.000486,"#c6cc85"
504299333,MWCapital,7,3,0,3,0.799744,0.60547,0.000973,"#ffb800"
504407014,mara_rivas,4,0,2,2,0.506863,0.336201,0.000486,"#f4c8cf"
504476147,prubioremiro,14,0,1,1,0.29733,0.45061,0,"#00eeff"
504628889,Mmacedo_tweets,36,1,0,1,0.578756,0.390945,0,"#825403"
504648347,CamiloETorresP,37,0,1,1,0.652049,0.381082,0,"#006032"
504704825,carolin31878546,37,0,1,1,0.379687,0.314989,0,"#006032"
504778509,RomiPistacchio,49,0,3,3,0.391752,0.419326,0.000973,"#ff7007"
504832642,ACEGRAF,37,1,1,2,0.5067,0.344221,0.000486,"#006032"
505731430,OVTTpt,31,2,2,4,0.572679,0.524145,0.001459,"#3e93ff"
505738863,CasaLector,2,5,0,5,0.560336,0.544216,0.001946,"#ffa64e"
505802646,fabianebicalho,36,1,1,2,0.574955,0.339625,0.000486,"#825403"
505828203,RaulValls1,19,0,1,1,0.645579,0.781764,0,"#00d3ff"
505996580,CeciliaGuemes,22,1,0,1,0.665213,0.526954,0,"#00e8b2"
506069531,UNIR_Investiga,14,14,7,21,0.498933,0.524605,0.009728,"#00eeff"
506163328,shahirakhair,36,1,0,1,0.466643,0.276398,0,"#825403"
506428106,StellaStellae,31,16,5,21,0.61176,0.489843,0.009728,"#3e93ff"
506489541,lexhortal,30,0,2,2,0.705539,0.647498,0.000486,"#ff77ff"
506661210,Tonnybeth,7,0,1,1,0.396607,0.288652,0,"#ffb800"
506903769,ehecdmx,10,1,11,12,0.361886,0.531533,0.00535,"#52d7c0"
506905237,MaPazPeirano,21,0,1,1,0.176179,0.211066,0,"#c6cc85"
507430818,rroman_galan,30,0,1,1,0.626926,0.670753,0,"#ff77ff"
507482535,CCHS_CSIC,22,175,86,261,0.54307,0.546755,0.126459,"#00e8b2"
507493680,bodegasanvalero,49,1,0,1,0.362947,0.659312,0,"#ff7007"
507509543,AdianezFernndez,49,1,0,1,0.344786,0.62646,0,"#ff7007"
507513706,IH_CSIC,22,1,0,1,0.600998,0.601625,0,"#00e8b2"
507518777,ILC_CSIC,22,1,0,1,0.613041,0.592622,0,"#00e8b2"
507524386,IPP_CSIC,22,0,1,1,0.605414,0.594103,0,"#00e8b2"
507656919,auxbib,13,2,3,5,0.516173,0.525163,0.001946,"#3bec00"
507687735,FicUdelar,55,22,2,24,0.651988,0.617901,0.011187,"#cb3f32"
507974310,LlanoSieteDias,38,1,0,1,0.60011,0.357306,0,"#662859"
508495802,DoreenA_Rios,0,1,0,1,0.631035,0.255317,0,"#8ecfec"
508573682,rabasf,2,65,3,68,0.632396,0.617467,0.032588,"#ffa64e"
508697400,SonSanchezr,0,0,2,2,0.43566,0.579629,0.000486,"#8ecfec"
508711833,sonarplusd,31,1,0,1,0.632374,0.505054,0,"#3e93ff"
508874757,intermediae,58,0,2,2,0.611756,0.302295,0.000486,"#005076"
508933177,MedicalHeritage,22,1,0,1,0.818118,0.707016,0,"#00e8b2"
508983271,quinteladedroso,7,0,2,2,0.541734,0.469113,0.000486,"#ffb800"
509121249,ErandenyOsorio,13,2,5,7,0.43172,0.438502,0.002918,"#3bec00"
509135662,Trini_Monroy,14,0,1,1,0.590653,0.484305,0,"#00eeff"
509355911,claumenoli,13,0,1,1,0.425651,0.41314,0,"#3bec00"
509707495,emiximemx,13,1,3,4,0.430687,0.432993,0.001459,"#3bec00"
509794054,Chepi_Org,13,0,1,1,0.520712,0.236039,0,"#3bec00"
510071832,UGRdivulga,31,1,4,5,0.593953,0.535867,0.001946,"#3e93ff"
510335664,angela_demiguel,22,11,2,13,0.245563,0.568254,0.005837,"#00e8b2"
510370731,AndrsSaumellLla,14,0,4,4,0.454447,0.534784,0.001459,"#00eeff"
510496086,Maestro_Montes,31,0,7,7,0.613989,0.537722,0.002918,"#3e93ff"
510513792,Romabepo,21,0,2,2,0.216368,0.250616,0.000486,"#c6cc85"
510722920,ElPostAntillano,49,1,0,1,0.411909,0.652621,0,"#ff7007"
510764402,gabcalarco,49,3,9,12,0.44866,0.537039,0.00535,"#ff7007"
511237967,Kiirua___,13,0,1,1,0.497852,0.393324,0,"#3bec00"
511642124,JaimeAlmansa,14,0,3,3,0.507945,0.563696,0.000973,"#00eeff"
511715556,beatrizponcela,0,0,2,2,0.436414,0.584166,0.000486,"#8ecfec"
512034290,AJL_actual,30,1,2,3,0.464991,0.631587,0.000973,"#ff77ff"
512052479,juandavid2812,49,4,0,4,0.448047,0.49091,0.001459,"#ff7007"
512158958,franmpasis,49,1,0,1,0.345429,0.680989,0,"#ff7007"
512312001,GeorgEckert,13,2,2,4,0.461718,0.496825,0.001459,"#3bec00"
512717858,Brianrgutierrez,49,0,2,2,0.460384,0.412242,0.000486,"#ff7007"
512913938,rjimenezasensio,30,1,0,1,0.721123,0.666085,0,"#ff77ff"
513076105,DcM87_,40,0,1,1,0.621422,0.007672,0,"#ff12a3"
513325480,duquebuitre,13,6,3,9,0.555836,0.494056,0.003891,"#3bec00"
513489366,PagesSonia,2,0,1,1,0.649546,0.645913,0,"#ffa64e"
513490588,ibanez_marti,5,0,1,1,0.623949,0.290418,0,"#b2dd44"
513608626,RosaTitos,0,0,2,2,0.847639,0.433505,0.000486,"#8ecfec"
514147221,evanishistory,19,1,0,1,0.646146,0.81248,0,"#00d3ff"
514185205,redtransfer_,31,0,4,4,0.630939,0.540978,0.001459,"#3e93ff"
514327352,ingealvarez68,3,0,1,1,0.455112,0.773719,0,"#ffb3ff"
514578189,SotoLoli,31,0,5,5,0.586692,0.500863,0.001946,"#3e93ff"
514592655,bibliotequesuv,22,3,0,3,0.494163,0.657975,0.000973,"#00e8b2"
514713953,aitziberurtasun,31,1,1,2,0.617839,0.496158,0.000486,"#3e93ff"
514856212,denalbz,49,2,0,2,0.424116,0.481481,0.000486,"#ff7007"
515415673,AlgaidaEditores,49,1,0,1,0.40085,0.652305,0,"#ff7007"
515553660,javier_larequi,1,0,2,2,0.662711,0.456883,0.000486,"#b6cb00"
515564510,_sentisis,49,1,0,1,0.412821,0.665923,0,"#ff7007"
515629997,SpainGivers,30,3,0,3,0.479561,0.588564,0.000973,"#ff77ff"
515690394,Izquierdo_mig,38,0,1,1,0.067283,0.426284,0,"#662859"
515787374,AlyssaA_DHSI,36,2,2,4,0.45292,0.344721,0.001459,"#825403"
515929304,brechaleal,7,0,2,2,0.471928,0.185742,0.000486,"#ffb800"
516158050,InfoTecarios,49,90,10,100,0.469714,0.560973,0.048152,"#ff7007"
516489756,BrigitteOrjuel1,31,0,1,1,0.641606,0.507336,0,"#3e93ff"
516591057,ForumMaria,30,0,3,3,0.459255,0.535593,0.000973,"#ff77ff"
516594165,ARTEKLAB,31,1,0,1,0.639834,0.486133,0,"#3e93ff"
516674922,RedesCursos,49,0,7,7,0.476688,0.624119,0.002918,"#ff7007"
516708506,CLIRnews,13,9,0,9,0.435018,0.461015,0.003891,"#3bec00"
516721223,xaviclick,49,1,0,1,0.340221,0.604346,0,"#ff7007"
516876979,chester55555555,49,1,0,1,0.350255,0.672402,0,"#ff7007"
516932638,EstherBlanco01,34,0,1,1,0.459877,0.382112,0,"#ff0d69"
517013007,Immerwarten,15,1,3,4,0.530839,0.670773,0.001459,"#008ebb"
517025997,Caroxever,49,1,0,1,0.37411,0.694218,0,"#ff7007"
517394817,ictp_promocion,22,0,2,2,0.638907,0.482116,0.000486,"#00e8b2"
517439881,Faico_innova,49,1,0,1,0.398839,0.652787,0,"#ff7007"
517463096,NBerberana,30,0,1,1,0.436607,0.696401,0,"#ff77ff"
517513481,Meri_SM,2,0,5,5,0.498131,0.541885,0.001946,"#ffa64e"
517883442,davi_akai,30,0,2,2,0.528928,0.612364,0.000486,"#ff77ff"
517883547,PosgradosUAndes,38,3,0,3,0.689033,0.335344,0.000973,"#662859"
517994061,gkm0011,49,1,0,1,0.378508,0.654882,0,"#ff7007"
518156632,xiomara_tori,34,0,1,1,0.339811,0.368662,0,"#ff0d69"
518324519,feaadah,2,0,2,2,0.616333,0.519017,0.000486,"#ffa64e"
518388197,ThinkBig_open,0,2,0,2,0.44699,0.639179,0.000486,"#8ecfec"
518412879,Vanesa_Redondo,2,0,1,1,0.64377,0.656983,0,"#ffa64e"
518414449,argeturv,37,0,1,1,0.642761,0.287706,0,"#006032"
518685701,arccturus,13,1,0,1,0.36582,0.512012,0,"#3bec00"
518694940,EstalinGranda,55,0,1,1,0.605496,0.425744,0,"#cb3f32"
518718994,txellbassolas,14,0,1,1,0.658072,0.607931,0,"#00eeff"
518730954,Barak_IT,49,2,0,2,0.420374,0.561693,0.000486,"#ff7007"
518796276,HernanArista,13,0,1,1,0.403167,0.49465,0,"#3bec00"
518845130,shuna74,30,0,1,1,0.586626,0.601876,0,"#ff77ff"
519036960,MariaRottler,49,0,1,1,0.365955,0.466938,0,"#ff7007"
519319371,alegallardo28,14,0,1,1,0.668158,0.503479,0,"#00eeff"
519769200,tableaupublic,30,1,0,1,0.625411,0.604493,0,"#ff77ff"
519809368,pilarmanchon,1,5,0,5,0.465162,0.551028,0.001946,"#b6cb00"
519897363,gemvent,49,0,1,1,0.308915,0.306497,0,"#ff7007"
520448524,HJaramilloS,37,0,1,1,0.504212,0.257765,0,"#006032"
520653311,AristeguiOnline,17,1,0,1,0.809413,0.190372,0,"#ff9cc7"
520714502,JuanIsaacSM,38,0,1,1,0.272822,0.612589,0,"#662859"
521295568,mbermejoivan,49,3,0,3,0.436297,0.576126,0.000973,"#ff7007"
521353800,PedroPablo_AM,37,2,2,4,0.645284,0.333152,0.001459,"#006032"
521510015,MarisaAvogadro,38,0,1,1,0.591065,0.345691,0,"#662859"
522126140,FTransicion,19,1,0,1,0.637391,0.76887,0,"#00d3ff"
522207347,onlinereaders1,13,0,1,1,0.498762,0.364911,0,"#3bec00"
522312804,gallegadesign,22,0,1,1,0.605642,0.648872,0,"#00e8b2"
522392854,mau_couturier,17,0,1,1,0.924226,0.390988,0,"#ff9cc7"
522398687,IraimaSandoval,49,1,0,1,0.334197,0.681658,0,"#ff7007"
522586945,Alba_1985,7,0,1,1,0.77995,0.635106,0,"#ffb800"
522617968,dorelipin,31,0,1,1,0.745797,0.922869,0,"#3e93ff"
522649341,OM_RCastro,37,0,1,1,0.695717,0.284947,0,"#006032"
522842208,brv57,13,0,1,1,0.438326,0.300636,0,"#3bec00"
523048819,Cienciagranada,31,0,5,5,0.607287,0.532039,0.001946,"#3e93ff"
523283943,Mavic_inves,21,1,2,3,0.349696,0.4988,0.000973,"#c6cc85"
523333572,DiazMorenoFer77,1,0,1,1,0.548261,0.700143,0,"#b6cb00"
523386042,pablocasado_,14,2,0,2,0.708482,0.694293,0.000486,"#00eeff"
523402470,historicopuj,37,11,4,15,0.560788,0.444325,0.006809,"#006032"
523740439,326chabela,49,1,0,1,0.354856,0.66611,0,"#ff7007"
523941155,angelejos,38,0,1,1,0.681579,0.467556,0,"#662859"
524237051,DisfrutaMalaga,14,0,3,3,0.600115,0.514349,0.000973,"#00eeff"
524412897,recorridosmype,49,0,1,1,0.353311,0.565678,0,"#ff7007"
524615097,AngieConter,13,0,1,1,0.349839,0.511471,0,"#3bec00"
524660207,NohoraRobayo,53,0,2,2,0.501032,0.662878,0.000486,"#008bdd"
524679015,azul_artt,27,0,4,4,0.123831,0.679951,0.001459,"#7e8b76"
524749036,xaquinnunez,0,6,0,6,0.439896,0.586597,0.002432,"#8ecfec"
524867803,IvonneCrdenas1,13,0,1,1,0.456738,0.393974,0,"#3bec00"
525306331,turbo3oficial,49,1,0,1,0.382873,0.700129,0,"#ff7007"
525338716,Anabelfemo,13,0,4,4,0.517715,0.500623,0.001459,"#3bec00"
525492035,MonicaBonillo,14,0,3,3,0.597288,0.546229,0.000973,"#00eeff"
525549634,FernandoUMA,14,26,47,73,0.55307,0.534089,0.035019,"#00eeff"
525562482,gamelicchio,36,0,3,3,0.469424,0.526962,0.000973,"#825403"
525806630,LaLlamabanSofi,38,0,1,1,0.116333,0.42869,0,"#662859"
525994536,griseldaceliar,37,1,0,1,0.569423,0.370134,0,"#006032"
526621470,WalterDGreason,34,0,1,1,0.321979,0.403761,0,"#ff0d69"
526731072,mlopezd33,22,0,1,1,0.371153,0.207339,0,"#00e8b2"
526864173,martinezgajulio,7,1,2,3,0.473724,0.242699,0.000973,"#ffb800"
526976183,MUOZZAVALA,21,0,1,1,0.486519,0.96201,0,"#c6cc85"
527794045,Mariapuramoreno,22,0,1,1,0.66135,0.527424,0,"#00e8b2"
528371618,melibeamemarea,22,1,2,3,0.507544,0.639679,0.000973,"#00e8b2"
528653821,Contraste_radio,49,1,0,1,0.373696,0.656241,0,"#ff7007"
528773666,albacastillo45,49,2,0,2,0.399373,0.560591,0.000486,"#ff7007"
528775642,elizablabe,49,1,0,1,0.350373,0.612404,0,"#ff7007"
528895247,calvarezag,40,0,1,1,0.654707,0.018999,0,"#ff12a3"
528926416,_Travesia,46,0,1,1,0.484784,0.142162,0,"#403538"
528996050,VaniStaaar,41,0,1,1,0.311547,0.384844,0,"#697b00"
529039861,PPhiloBiblon,58,26,7,33,0.527528,0.55868,0.015564,"#005076"
529171725,bonoradio,3,0,1,1,0.670934,0.701392,0,"#ffb3ff"
529267604,CarolinaSanchiz,14,6,2,8,0.446654,0.474621,0.003405,"#00eeff"
529452973,_akpiper,34,0,2,2,0.400072,0.455976,0.000486,"#ff0d69"
529790690,Tpaseadorcanino,49,1,0,1,0.331944,0.635854,0,"#ff7007"
531033226,fylunav,1,21,5,26,0.603958,0.491762,0.01216,"#b6cb00"
531146065,culthunting,15,5,1,6,0.596153,0.507216,0.002432,"#008ebb"
531242290,thomascauvin,34,0,3,3,0.468032,0.416944,0.000973,"#ff0d69"
531790026,AusinTxetxu,31,1,3,4,0.647371,0.52707,0.001459,"#3e93ff"
531806111,CintiaR83,13,0,1,1,0.529115,0.460361,0,"#3bec00"
532139660,H_Enea,18,0,3,3,0.609415,0.534855,0.000973,"#5456a6"
532155074,j_gred,34,0,4,4,0.513096,0.492536,0.001459,"#ff0d69"
532309885,linacruzgarcia,38,0,2,2,0.608092,0.392184,0.000486,"#662859"
532383320,CJRDopp,49,1,0,1,0.395644,0.645857,0,"#ff7007"
532384263,moniquirah,35,0,1,1,0.583738,0.264997,0,"#00faff"
532449573,OpenGLAM,38,4,8,12,0.550146,0.496019,0.00535,"#662859"
532990484,garcia_miren,22,0,7,7,0.553566,0.420256,0.002918,"#00e8b2"
533125840,CEAndaluces,22,7,2,9,0.496656,0.405906,0.003891,"#00e8b2"
533163305,DHDInfo,36,4,8,12,0.462407,0.490329,0.00535,"#825403"
533198978,bibliotecacln,30,4,2,6,0.542769,0.487559,0.002432,"#ff77ff"
533231026,Rafel_Arnal,40,0,1,1,0.583842,0.032936,0,"#ff12a3"
533272836,cursosypost_CL,49,1,0,1,0.360203,0.637347,0,"#ff7007"
533273906,Clauditaeileen,13,0,1,1,0.501432,0.316811,0,"#3bec00"
533403447,Gen_Kindle,55,1,0,1,0.627022,0.549638,0,"#cb3f32"
533424389,HWarpola,13,1,1,2,0.374658,0.457918,0.000486,"#3bec00"
533454875,langchatPLN,1,1,0,1,0.428307,0.788459,0,"#b6cb00"
533537289,humanavirtual,13,0,5,5,0.488594,0.431153,0.001946,"#3bec00"
534159296,cvherranz,15,0,7,7,0.496279,0.583752,0.002918,"#008ebb"
534191985,fuam_uam,30,1,1,2,0.680979,0.601933,0.000486,"#ff77ff"
534467882,IACatUCLA,34,0,2,2,0.353085,0.424172,0.000486,"#ff0d69"
535035949,alextoluco26,41,0,2,2,0.330883,0.305178,0.000486,"#697b00"
535591380,monicavinaras,2,3,3,6,0.457998,0.556184,0.002432,"#ffa64e"
535658941,eHumanista,14,5,0,5,0.507588,0.531733,0.001946,"#00eeff"
535707261,eldiarioes,14,4,0,4,0.550162,0.534147,0.001459,"#00eeff"
535765793,constantinogue,21,0,1,1,0.197253,0.20332,0,"#c6cc85"
535919698,GustavoFurtado4,36,0,2,2,0.540065,0.249144,0.000486,"#825403"
536299947,cloureiro80,13,0,1,1,0.522875,0.387973,0,"#3bec00"
536306874,IsabelVillagar,22,0,2,2,0.331011,0.73979,0.000486,"#00e8b2"
536367767,MADCFE,15,0,1,1,0.524497,0.68943,0,"#008ebb"
536380420,andreasemarea,3,0,1,1,0.530536,0.771613,0,"#ffb3ff"
536387263,ReskillingYou,14,0,1,1,0.643831,0.579112,0,"#00eeff"
536634845,anaoromi,8,0,1,1,0.595763,0.431339,0,"#00ed5d"
536810027,CambioSXXI,38,0,1,1,0.64188,0.416195,0,"#662859"
537133995,FDeHumanidades,15,0,1,1,0.552875,0.681045,0,"#008ebb"
537143032,CandelaOlle,14,1,1,2,0.609198,0.638557,0.000486,"#00eeff"
537259438,CarinGordillo,49,0,2,2,0.393971,0.583265,0.000486,"#ff7007"
537356333,rey_marisa,14,1,3,4,0.692976,0.458855,0.001459,"#00eeff"
537385421,_sandrafe,40,0,1,1,0.625373,0.035804,0,"#ff12a3"
537589531,carlosmoriyon,22,0,6,6,0.381619,0.555416,0.002432,"#00e8b2"
537665233,guido__ce,34,1,0,1,0.523595,0.370551,0,"#ff0d69"
537956021,MilciadesCP,13,0,3,3,0.461946,0.458418,0.000973,"#3bec00"
538097725,GCDH,30,0,5,5,0.499436,0.547429,0.001946,"#ff77ff"
538150548,Energya_VM,49,1,0,1,0.368362,0.671385,0,"#ff7007"
538471513,artesanachile,21,0,2,2,0.223459,0.231901,0.000486,"#c6cc85"
538546175,SebastiaanOlier,38,0,1,1,0.12261,0.820934,0,"#662859"
538558947,gabsonwheels,36,0,1,1,0.659889,0.221559,0,"#825403"
539489098,puic_unam,7,5,0,5,0.444605,0.303171,0.001946,"#ffb800"
539590907,maru_tadeo,15,0,3,3,0.483055,0.637439,0.000973,"#008ebb"
539899187,maximromanov,22,3,0,3,0.69567,0.668404,0.000973,"#00e8b2"
539904856,FGMoriyon,31,1,0,1,0.783627,0.466887,0,"#3e93ff"
540098505,isidroaguillo,22,25,41,66,0.527951,0.539862,0.031615,"#00e8b2"
540150424,mjgarpe,13,0,1,1,0.436949,0.398354,0,"#3bec00"
540359312,JuanLozanoI,13,0,3,3,0.479727,0.419334,0.000973,"#3bec00"
540427111,mariojordanp,49,2,0,2,0.383614,0.575663,0.000486,"#ff7007"
540620423,UV_Veracruz,52,0,2,2,0.702602,0.571399,0.000486,"#b56eed"
540739844,RemediosFdez,49,0,1,1,0.290585,0.29855,0,"#ff7007"
540757324,HackLabAl,2,0,3,3,0.69214,0.632466,0.000973,"#ffa64e"
540769000,geekcom2,37,3,0,3,0.528599,0.372123,0.000973,"#006032"
540830530,ebicet,49,9,6,15,0.503116,0.449939,0.006809,"#ff7007"
541058739,DigitalBourne,2,1,3,4,0.675868,0.589372,0.001459,"#ffa64e"
541250252,lorena_snchez,3,0,1,1,0.232314,0.669827,0,"#ffb3ff"
541258943,ehh_ptr,34,0,2,2,0.360066,0.415976,0.000486,"#ff0d69"
541474827,PolOficial,7,0,2,2,0.432983,0.319429,0.000486,"#ffb800"
541618094,MishaDunn,36,1,0,1,0.447785,0.293374,0,"#825403"
541623971,CoralUMU,22,0,2,2,0.677857,0.735372,0.000486,"#00e8b2"
541697427,Famelica_legion,19,1,0,1,0.672384,0.724058,0,"#00d3ff"
541759325,ordendeltiempo,1,8,10,18,0.475278,0.58199,0.008268,"#b6cb00"
541994047,NeyMariaM,36,0,2,2,0.52083,0.331915,0.000486,"#825403"
542031363,milagrostolon,15,16,1,17,0.569077,0.660085,0.007782,"#008ebb"
542079217,MLG39696692,49,0,2,2,0.404633,0.510183,0.000486,"#ff7007"
542654367,EducaSpain,1,0,1,1,0.43863,0.790449,0,"#b6cb00"
543392682,mora_federico,37,0,6,6,0.27496,0.522941,0.002432,"#006032"
543567716,Mel_Storni,2,0,2,2,0.593232,0.406585,0.000486,"#ffa64e"
543748840,mamesa75,8,0,2,2,0.386413,0.43127,0.000486,"#00ed5d"
543826815,laplebeya_,14,0,2,2,0.616386,0.571332,0.000486,"#00eeff"
543912932,conejibot,38,1,4,5,0.445333,0.375868,0.001946,"#662859"
544158224,helmetnews,3,0,2,2,0.449591,0.641499,0.000486,"#ffb3ff"
544643751,integracionbta,28,9,0,9,0.823971,0.39854,0.003891,"#cd5700"
544830477,alesguztotoro,21,0,1,1,0.19575,0.220277,0,"#c6cc85"
545281849,aiax2,49,0,3,3,0.444519,0.549248,0.000973,"#ff7007"
545731667,GiseleBEcerra,38,0,1,1,0.450425,0.786581,0,"#662859"
545879359,dpelissier1,36,1,0,1,0.442321,0.293548,0,"#825403"
546146202,Documania20,22,2,0,2,0.643896,0.605193,0.000486,"#00e8b2"
546303437,aic_it,30,0,1,1,0.493906,0.624351,0,"#ff77ff"
546420324,MariaSancheztw,30,0,1,1,0.476821,0.691941,0,"#ff77ff"
546454155,JennEBN,34,0,7,7,0.448094,0.515984,0.002918,"#ff0d69"
546930504,RebecaPardo,22,4,5,9,0.762403,0.667905,0.003891,"#00e8b2"
546978443,carloscquel,13,0,1,1,0.416692,0.466511,0,"#3bec00"
547293611,garridodulce,34,0,1,1,0.587005,0.324011,0,"#ff0d69"
547804990,FranciaBetty,55,0,4,4,0.675485,0.648515,0.001459,"#cb3f32"
547918767,PavaDuran26,13,0,1,1,0.448572,0.356865,0,"#3bec00"
547981488,LynetteHooft,49,1,0,1,0.396693,0.657787,0,"#ff7007"
548735389,martitaolaegui,22,0,2,2,0.570112,0.579376,0.000486,"#00e8b2"
548816066,ben_amin_tel,34,0,1,1,0.492058,0.374728,0,"#ff0d69"
548901829,judoley,13,11,6,17,0.466896,0.413042,0.007782,"#3bec00"
549386547,fxxxavierrr,13,0,1,1,0.406732,0.344196,0,"#3bec00"
549712808,karpa1977,40,0,1,1,0.573034,0.007066,0,"#ff12a3"
550064614,bastter001,37,0,3,3,0.577622,0.388263,0.000973,"#006032"
550180492,nachoteso,38,0,1,1,0.813038,0.635032,0,"#662859"
550207918,abceconomia,2,1,0,1,0.408612,0.548659,0,"#ffa64e"
550219184,asoc_aapid,22,1,1,2,0.527533,0.590756,0.000486,"#00e8b2"
550421870,encincovoy,36,2,0,2,0.52442,0.150629,0.000486,"#825403"
550510222,AMAlejandraSchv,49,0,1,1,0.373124,0.538504,0,"#ff7007"
551026217,Claritaylasgeme,30,6,8,14,0.507984,0.576495,0.006323,"#ff77ff"
551058238,DPWayman,30,0,1,1,0.584338,0.671578,0,"#ff77ff"
551075738,egiptologia_,37,1,0,1,0.626724,0.338673,0,"#006032"
551130311,DirAudiovisual,38,0,1,1,0.615996,0.348124,0,"#662859"
551148467,maguibecerril,17,0,1,1,0.936123,0.364499,0,"#ff9cc7"
551284787,isaresina,49,1,0,1,0.381509,0.672852,0,"#ff7007"
551371784,mangeleswebsoc,22,0,1,1,0.614225,0.616591,0,"#00e8b2"
551388767,casulunam,7,4,0,4,0.427579,0.315416,0.001459,"#ffb800"
551404830,Rebe_mq,7,0,1,1,0.36678,0.317005,0,"#ffb800"
551406671,ranayeye,13,0,1,1,0.432389,0.411184,0,"#3bec00"
551448044,ACDComic,14,0,3,3,0.773431,0.515319,0.000973,"#00eeff"
551750335,jfcarabano,31,0,4,4,0.612089,0.539325,0.001459,"#3e93ff"
551834354,khresta2,3,0,1,1,0.458707,0.749424,0,"#ffb3ff"
551847758,tiojeda,21,0,1,1,0.311971,0.460401,0,"#c6cc85"
551938477,mkarmelep,18,0,2,2,0.733093,0.610444,0.000486,"#5456a6"
552013050,cafernandezlo,22,0,1,1,0.658353,0.469399,0,"#00e8b2"
552072375,IBEROinvestiga,13,0,1,1,0.454984,0.309159,0,"#3bec00"
552173620,jmolinaml,49,1,0,1,0.348706,0.597454,0,"#ff7007"
552203304,pubhisint,38,1,0,1,0.554645,0.372089,0,"#662859"
552204871,RbnGP10,36,1,1,2,0.539599,0.514468,0.000486,"#825403"
552361665,chvapara,38,0,1,1,0.331169,0.170584,0,"#662859"
552515468,josemoralesll,19,0,1,1,0.640954,0.787712,0,"#00d3ff"
552526763,Cristo__Emanuel,7,0,2,2,0.42043,0.389826,0.000486,"#ffb800"
552547785,MaraliaA,14,0,1,1,0.647931,0.55565,0,"#00eeff"
552612776,ImpartGabinete,49,1,0,1,0.390245,0.691497,0,"#ff7007"
552622475,FIPLV,49,0,1,1,0.389266,0.53711,0,"#ff7007"
552665115,SEEC_ValCast,1,3,0,3,0.323301,0.699449,0.000973,"#b6cb00"
552795250,RadioCampusULL,22,0,2,2,0.644117,0.616274,0.000486,"#00e8b2"
552849883,felipes0789,34,2,0,2,0.573942,0.38458,0.000486,"#ff0d69"
552939356,tuitlibiesco,3,0,2,2,0.410674,0.504,0.000486,"#ffb3ff"
552965395,mjbautistac,30,0,2,2,0.520073,0.599594,0.000486,"#ff77ff"
553011990,LuchVillena95,38,0,1,1,0.075297,0.443852,0,"#662859"
553129577,marisolfi,49,23,17,40,0.446468,0.50614,0.018969,"#ff7007"
553154029,Alan_FernandezV,13,0,1,1,0.375441,0.38016,0,"#3bec00"
553177626,adralvsan,13,47,61,108,0.497928,0.488724,0.052043,"#3bec00"
553220159,CUO_UV,13,2,0,2,0.417901,0.490914,0.000486,"#3bec00"
553327380,NavegadorAntigo,3,0,1,1,0.304199,0.591118,0,"#ffb3ff"
553456318,IzquierdoLuisa,2,3,1,4,0.621584,0.649316,0.001459,"#ffa64e"
553868780,SANTOTOBGA,29,0,3,3,0.315942,0.137308,0.000973,"#1fab00"
553987364,cristhianogando,31,0,1,1,0.735575,0.930151,0,"#3e93ff"
554260369,MasArqueologia,30,0,2,2,0.314285,0.557757,0.000486,"#ff77ff"
554486933,RobinDesmeules,13,0,1,1,0.389744,0.385718,0,"#3bec00"
554535163,elenacantarell,13,0,1,1,0.432338,0.399403,0,"#3bec00"
554610589,NadiaLuna88,49,1,0,1,0.370477,0.689603,0,"#ff7007"
554734835,CarlosGimenezL,22,1,7,8,0.535715,0.515327,0.003405,"#00e8b2"
554974165,SilviaVerdu,14,0,23,23,0.535948,0.5256,0.0107,"#00eeff"
555099241,ImpactoTIC,38,44,12,56,0.598502,0.459234,0.026751,"#662859"
555300984,AsociacionALEPH,58,2,2,4,0.498167,0.613428,0.001459,"#005076"
555427430,Socialworktime,49,1,0,1,0.346022,0.664821,0,"#ff7007"
555449256,armando_bob,7,0,2,2,0.4457,0.399534,0.000486,"#ffb800"
555528318,CitepUBA,49,56,3,59,0.440394,0.539147,0.02821,"#ff7007"
555691016,GonzalezRJH,41,0,1,1,0.316268,0.377217,0,"#697b00"
555799128,LetUnite,21,0,2,2,0.262177,0.238365,0.000486,"#c6cc85"
555834987,FacGeoiH,35,3,0,3,0.409856,0.474786,0.000973,"#00faff"
555984374,dorothyk98,34,0,1,1,0.335145,0.430833,0,"#ff0d69"
556057928,Pilarhs1,2,0,1,1,0.657629,0.644705,0,"#ffa64e"
556203874,UniLaGuajira,9,1,0,1,0.718507,0.748535,0,"#008f7b"
556514047,revistaanfibia,49,1,0,1,0.410403,0.629903,0,"#ff7007"
556568276,neuralxolotl,34,0,1,1,0.476776,0.37897,0,"#ff0d69"
556766631,Red_Vertice,15,0,2,2,0.571003,0.57089,0.000486,"#008ebb"
556812662,yo_elmanuel,21,0,1,1,0.199654,0.246682,0,"#c6cc85"
556865558,Icict_Fiocruz,36,0,3,3,0.538586,0.263335,0.000973,"#825403"
556897573,ARAEpatrimonio,31,0,1,1,0.657301,0.432985,0,"#3e93ff"
556911179,AriadnaRazoS,13,5,4,9,0.394484,0.502206,0.003891,"#3bec00"
556983859,Patri1Anto,34,0,2,2,0.411335,0.534098,0.000486,"#ff0d69"
557018040,CheluiMF,31,2,4,6,0.58508,0.529819,0.002432,"#3e93ff"
557051869,ACICOMColombia,37,0,4,4,0.582972,0.451204,0.001459,"#006032"
557393074,madbydm,38,0,2,2,0.697385,0.588335,0.000486,"#662859"
557645626,ccsd_fr,22,0,1,1,0.550842,0.687119,0,"#00e8b2"
557703975,anavalverdem,14,7,2,9,0.564141,0.577082,0.003891,"#00eeff"
557818609,conectarlab,49,6,0,6,0.451506,0.596752,0.002432,"#ff7007"
557864184,cursos__ingles,49,1,0,1,0.351049,0.605974,0,"#ff7007"
558139830,lrodrrui,0,0,1,1,0.433075,0.610405,0,"#8ecfec"
558489841,G_A_Schwartz,13,2,1,3,0.574891,0.442752,0.000973,"#3bec00"
558823208,NoraKreimer,13,0,1,1,0.619133,0.990211,0,"#3bec00"
559079051,cesfeo,34,0,1,1,0.549102,0.345311,0,"#ff0d69"
559374708,AT_Medios,49,1,0,1,0.309966,0.674278,0,"#ff7007"
559417207,oliviavsan,15,0,1,1,0.621159,0.632624,0,"#008ebb"
559502966,ferdama2012,30,0,1,1,0.659938,0.58538,0,"#ff77ff"
559772995,lucasgautheron,49,1,0,1,0.364829,0.650158,0,"#ff7007"
559939973,shree_thorat,34,0,3,3,0.37007,0.421602,0.000973,"#ff0d69"
559943660,alexrubiogr,37,0,5,5,0.542952,0.535957,0.001946,"#006032"
560141114,mjlinguo,13,0,5,5,0.528718,0.424738,0.001946,"#3bec00"
560284037,kanpandegi,18,0,2,2,0.75823,0.618151,0.000486,"#5456a6"
560305796,SoDesignHistory,13,4,0,4,0.492347,0.454776,0.001459,"#3bec00"
560444102,ComparadasUGR,31,1,1,2,0.645301,0.524078,0.000486,"#3e93ff"
560917961,OTRI_UMU,22,3,3,6,0.723566,0.726366,0.002432,"#00e8b2"
560937338,CastellMaria,38,0,2,2,0.579724,0.457906,0.000486,"#662859"
561124947,AtrapaEditorial,19,2,0,2,0.676748,0.748034,0.000486,"#00d3ff"
561174293,CarmenHerrero14,31,6,2,8,0.514733,0.609032,0.003405,"#3e93ff"
561251159,biblioUPM,31,5,29,34,0.56743,0.581794,0.016051,"#3e93ff"
561254163,Ealvarezramos,30,1,4,5,0.524227,0.567133,0.001946,"#ff77ff"
561444419,profgabrielle,13,0,7,7,0.438749,0.468007,0.002918,"#3bec00"
561582463,FADeditorial,7,0,1,1,0.411361,0.242514,0,"#ffb800"
561835569,Patriamiaa,38,0,2,2,0.567549,0.382752,0.000486,"#662859"
561850028,fiormont,14,129,76,205,0.518051,0.497004,0.099222,"#00eeff"
561999301,DRibesLlados,14,0,1,1,0.784162,0.458218,0,"#00eeff"
562030778,Haciendapy,37,6,3,9,0.291427,0.505237,0.003891,"#006032"
562046797,Rakimenides,22,0,2,2,0.507203,0.639374,0.000486,"#00e8b2"
562202310,theastronxmer,10,0,1,1,0.315621,0.472222,0,"#52d7c0"
562224280,jccasco1964,49,1,0,1,0.367716,0.608063,0,"#ff7007"
562288482,Mindependencia,38,8,1,9,0.474216,0.424172,0.003891,"#662859"
562421184,legionario0108,58,0,1,1,0.585939,0.163946,0,"#005076"
562522326,Oreoderby,22,0,1,1,0.64787,0.456943,0,"#00e8b2"
562571172,FaDelfin,13,2,1,3,0.477529,0.42554,0.000973,"#3bec00"
562579334,abedice,7,0,2,2,0.529905,0.363831,0.000486,"#ffb800"
562932600,Olga_Hurtado66,49,1,0,1,0.349562,0.644874,0,"#ff7007"
563040909,JesusGMoran,14,0,7,7,0.556657,0.486297,0.002918,"#00eeff"
563177623,Herlinde_S,40,0,1,1,0.588963,0.01649,0,"#ff12a3"
563178908,Basso_sa,49,1,0,1,0.308213,0.650561,0,"#ff7007"
563304998,Yanethgis,13,0,1,1,0.442282,0.397124,0,"#3bec00"
563568982,mmmhiru,18,1,0,1,0.683844,0.54472,0,"#5456a6"
563642405,DigitHumanities,30,5,0,5,0.501665,0.570335,0.001946,"#ff77ff"
563646703,teamlabs,18,2,4,6,0.653249,0.559565,0.002432,"#5456a6"
564047156,susanaladra,14,15,2,17,0.505149,0.526343,0.007782,"#00eeff"
564050602,GeografosAragon,22,0,3,3,0.587004,0.477509,0.000973,"#00e8b2"
564069836,Antoniogomo,14,0,2,2,0.716599,0.484764,0.000486,"#00eeff"
564384604,luciaperez_es,14,0,2,2,0.51093,0.584,0.000486,"#00eeff"
564464648,colemontse,30,1,0,1,0.695038,0.642166,0,"#ff77ff"
564651869,PlanLecturaMed,38,12,0,12,0.237694,0.43822,0.00535,"#662859"
564667141,penguinlibroscl,21,0,1,1,0.235831,0.2181,0,"#c6cc85"
564746764,historiapresent,19,1,0,1,0.646304,0.778961,0,"#00d3ff"
564788462,ariasandgli,2,39,27,66,0.47268,0.548595,0.031615,"#ffa64e"
564793181,ComCienciaUNR,49,1,0,1,0.431784,0.678568,0,"#ff7007"
564865163,Mariaperezpere,1,0,1,1,0.704833,0.482104,0,"#b6cb00"
564896361,EmMcGinn,34,0,1,1,0.400223,0.284843,0,"#ff0d69"
565036505,TweetsRosa,30,0,1,1,0.589837,0.597557,0,"#ff77ff"
565611218,Santi_Navarro_,34,0,1,1,0.623025,0.435854,0,"#ff0d69"
565789266,JuanaMarcoGo,2,0,4,4,0.613383,0.579168,0.001459,"#ffa64e"
566221393,mcaralts,8,0,1,1,0.59454,0.432059,0,"#00ed5d"
566414140,jimedylan,22,11,2,13,0.333643,0.467052,0.005837,"#00e8b2"
566528106,curvaseis,36,0,1,1,0.527648,0.336514,0,"#825403"
567172393,UAM_Medicina,22,0,1,1,0.653324,0.467408,0,"#00e8b2"
567188286,IndexComu,31,15,1,16,0.558668,0.666209,0.007296,"#3e93ff"
567256073,Cedric_80,3,1,3,4,0.457874,0.792989,0.001459,"#ffb3ff"
567270649,PgMinaM,1,0,1,1,0.414526,0.591281,0,"#b6cb00"
567306676,tijeduma,49,1,0,1,0.354511,0.605286,0,"#ff7007"
567360618,edXOnline,31,6,0,6,0.556554,0.501195,0.002432,"#3e93ff"
567383786,fabianrosasgadi,35,0,1,1,0.56806,0.267728,0,"#00faff"
567422873,jordi_vallverdu,30,1,0,1,0.518587,0.61749,0,"#ff77ff"
567506950,weiler_mathias,37,0,1,1,0.206495,0.489111,0,"#006032"
567511686,Perratia,22,0,1,1,0.469721,0.700375,0,"#00e8b2"
567727922,midnucas,41,0,1,1,0.329096,0.352235,0,"#697b00"
568230818,DobleRojo,58,0,2,2,0.620926,0.307913,0.000486,"#005076"
568474353,alanyliu,49,8,6,14,0.466788,0.504666,0.006323,"#ff7007"
568520439,GianellaDel,30,1,6,7,0.596357,0.641476,0.002918,"#ff77ff"
568573658,Gabri91MG,0,2,0,2,0.3117,0.390299,0.000486,"#8ecfec"
568668306,LauraMorreale,36,0,1,1,0.478413,0.277123,0,"#825403"
568717018,IgnacioAchurra,21,58,0,58,0.05049,0.633974,0.027724,"#c6cc85"
569138843,mariaslasm,2,0,1,1,0.646961,0.665901,0,"#ffa64e"
569241461,Glilian_,7,0,2,2,0.418301,0.336402,0.000486,"#ffb800"
569334851,GlobalNET_info,49,1,0,1,0.305975,0.633565,0,"#ff7007"
569464389,ChuleriaMadrid,58,0,1,1,0.577381,0.177223,0,"#005076"
569771063,UVABiblioSegov,22,1,1,2,0.626633,0.565869,0.000486,"#00e8b2"
569784692,metriplica,22,1,0,1,0.51327,0.668222,0,"#00e8b2"
569847122,Pimarint,14,0,2,2,0.618728,0.56777,0.000486,"#00eeff"
569874227,InesVano,34,0,3,3,0.402245,0.411835,0.000973,"#ff0d69"
569993166,rkleinca,55,1,2,3,0.705245,0.670127,0.000973,"#cb3f32"
570029110,MzalesComoVamos,9,0,1,1,0.74001,0.675577,0,"#008f7b"
570250035,_rreichel,14,0,1,1,0.653048,0.493833,0,"#00eeff"
570287217,luca_toschi,58,1,0,1,0.497031,0.651787,0,"#005076"
570322798,Galia666,7,0,2,2,0.421931,0.360929,0.000486,"#ffb800"
570491094,VRI_UN,38,9,15,24,0.456629,0.428453,0.011187,"#662859"
570715127,Comillas_biblio,22,1,3,4,0.493088,0.572632,0.001459,"#00e8b2"
570819718,MiMusaMeInspira,37,0,1,1,0.624658,0.629373,0,"#006032"
570848073,ConchaTorresBeg,30,0,14,14,0.505574,0.543446,0.006323,"#ff77ff"
570913816,410Osorio,17,0,1,1,0.909505,0.386299,0,"#ff9cc7"
571082904,SEECadiz,58,2,2,4,0.689169,0.580403,0.001459,"#005076"
571202103,Medium,37,1,0,1,0.808929,0.493965,0,"#006032"
571430547,rebeccadactyl,0,2,13,15,0.872737,0.680255,0.006809,"#8ecfec"
571943368,JesGarGa,38,0,1,1,0.077768,0.448312,0,"#662859"
571974376,moradaamarilla,34,0,15,15,0.49337,0.391624,0.006809,"#ff0d69"
572136250,RAKarl,34,1,15,16,0.474787,0.418311,0.007296,"#ff0d69"
572158293,EnricCTbcn,49,0,1,1,0.33671,0.563969,0,"#ff7007"
572647834,j_lacs,13,0,1,1,0.494228,0.36898,0,"#3bec00"
572880339,Paulogaticacote,14,0,5,5,0.604486,0.447469,0.001946,"#00eeff"
572887150,eugenpedcas,36,0,1,1,0.684636,0.437728,0,"#825403"
572992263,FranJAlvarezCar,3,0,3,3,0.454134,0.569662,0.000973,"#ffb3ff"
572998618,E_d_u_,13,0,1,1,0.44167,0.400783,0,"#3bec00"
573025252,CKamposiori,14,1,0,1,0.575559,0.4697,0,"#00eeff"
573108973,abocito,49,1,0,1,0.321873,0.643792,0,"#ff7007"
573354345,evillarrealc,13,0,2,2,0.39703,0.382975,0.000486,"#3bec00"
573400581,maalp12,13,0,2,2,0.405467,0.369207,0.000486,"#3bec00"
573461675,NTFronterizo,30,0,1,1,0.574058,0.659154,0,"#ff77ff"
573667961,SUAYED_FCPYS,13,0,2,2,0.447663,0.36791,0.000486,"#3bec00"
573837055,germancito77,13,0,1,1,0.616788,0.994016,0,"#3bec00"
574009629,pg2711,10,0,3,3,0.431787,0.45968,0.000973,"#52d7c0"
574030246,filos_unam,13,83,4,87,0.482251,0.460397,0.041829,"#3bec00"
574057622,CNBMex,13,1,0,1,0.400509,0.40708,0,"#3bec00"
574163314,lianpol_osorio,13,0,1,1,0.450883,0.317318,0,"#3bec00"
574187838,emekasidiomas,49,0,2,2,0.422491,0.538652,0.000486,"#ff7007"
574188703,ebenitezp,49,1,0,1,0.402247,0.701714,0,"#ff7007"
574237766,Mayren_L,17,0,1,1,0.829108,0.222565,0,"#ff9cc7"
574395749,pilarsanchezupv,22,1,2,3,0.578395,0.340767,0.000973,"#00e8b2"
574472952,cllorcat,31,0,1,1,0.6441,0.514029,0,"#3e93ff"
574717652,PatrciaMMarcos,36,0,4,4,0.438532,0.420249,0.001459,"#825403"
574736150,Marylo88Lopez,0,0,2,2,0.445536,0.424778,0.000486,"#8ecfec"
574761832,eswikipedia,30,3,0,3,0.454365,0.542173,0.000973,"#ff77ff"
574935384,rchica03,49,0,1,1,0.479279,0.804133,0,"#ff7007"
575131836,Zabuchanab,37,0,1,1,0.278977,0.474432,0,"#006032"
575164783,GraciaGEscosura,22,0,1,1,0.614561,0.627402,0,"#00e8b2"
575378010,FundacionUBU,14,0,1,1,0.662047,0.601476,0,"#00eeff"
575486484,aaron_canseco,13,0,5,5,0.493281,0.430123,0.001946,"#3bec00"
575536185,marticabailo,55,0,5,5,0.646872,0.668144,0.001946,"#cb3f32"
575615374,EconomiaUAndes,34,1,0,1,0.607121,0.411659,0,"#ff0d69"
575641335,AmargadoRadio,7,0,1,1,0.426508,0.327756,0,"#ffb800"
576118859,LSanzMenendez,22,0,6,6,0.623948,0.55699,0.002432,"#00e8b2"
576225644,UofEHumanities,13,7,0,7,0.477079,0.441517,0.002918,"#3bec00"
576405095,RILMMusicLit,34,0,1,1,0.572716,0.34407,0,"#ff0d69"
576415313,Tolynacarolina,49,0,1,1,0.37969,0.583454,0,"#ff7007"
576419977,LauraBarbasRh,34,0,2,2,0.360965,0.413817,0.000486,"#ff0d69"
576494759,UNEDTalavera,30,0,4,4,0.518975,0.541267,0.001459,"#ff77ff"
576632354,adejuanas,30,0,1,1,0.52009,0.617086,0,"#ff77ff"
576648094,jomacima,49,2,0,2,0.42996,0.556336,0.000486,"#ff7007"
576813477,moiacost,8,0,3,3,0.450703,0.594882,0.000973,"#00ed5d"
576924497,XavierFerras,8,17,26,43,0.647856,0.350329,0.020428,"#00ed5d"
577058120,MJSantos5,58,0,1,1,0.484195,0.658119,0,"#005076"
577168570,manuuelagarciam,42,10,4,14,0.708522,0.462199,0.006323,"#66e087"
577202279,aesla_twit,30,10,3,13,0.480592,0.562376,0.005837,"#ff77ff"
577320368,TaneArqueologia,2,0,1,1,0.7638,0.521375,0,"#ffa64e"
577498259,luismartin2005,49,1,0,1,0.399749,0.660622,0,"#ff7007"
577561154,irens910,2,0,1,1,0.760662,0.509188,0,"#ffa64e"
577719734,diazsobac,17,0,3,3,0.549127,0.438305,0.000973,"#ff9cc7"
578196803,jvalbuenarod,31,1,8,9,0.629919,0.571891,0.003891,"#3e93ff"
578229694,investigausal,58,4,0,4,0.298323,0.545015,0.001459,"#005076"
578251489,FrankMorin,49,1,0,1,0.297284,0.647695,0,"#ff7007"
578299270,LuisHernandoOle,3,0,1,1,0.464464,0.744182,0,"#ffb3ff"
578882291,Hiperbrea,0,0,1,1,0.417457,0.389298,0,"#8ecfec"
578916336,Mhervas,31,4,1,5,0.787505,0.428316,0.001946,"#3e93ff"
579210845,Toniovetpath,30,0,7,7,0.575851,0.633547,0.002918,"#ff77ff"
579225973,JGarciaFronti,49,6,14,20,0.450049,0.526742,0.009241,"#ff7007"
579269375,helena_strecker,36,5,3,8,0.50542,0.326913,0.003405,"#825403"
579299305,Renata_Bastos1,36,0,1,1,0.505554,0.092823,0,"#825403"
579607329,j_o_santofimio,53,0,1,1,0.587313,0.759246,0,"#008bdd"
579715850,112Asturias,19,1,0,1,0.654654,0.781853,0,"#00d3ff"
579792548,DavidRArmitage,22,2,0,2,0.623982,0.603152,0.000486,"#00e8b2"
579838831,EmileMauss,22,1,0,1,0.649815,0.529228,0,"#00e8b2"
579869588,bibliodoc,22,0,1,1,0.567348,0.681307,0,"#00e8b2"
579874560,GavaxIndep,49,1,0,1,0.314483,0.663942,0,"#ff7007"
579936212,sintesisuaemex,41,8,9,17,0.361055,0.339967,0.007782,"#697b00"
580000741,eze_pz,49,1,0,1,0.416356,0.651325,0,"#ff7007"
580094828,AngelValdelamar,7,0,1,1,0.340979,0.359372,0,"#ffb800"
580245801,festivalcelsius,35,1,0,1,0.633789,0.445464,0,"#00faff"
580249792,Hipeastrum,2,0,2,2,0.601806,0.601379,0.000486,"#ffa64e"
580266554,Fernandoemag,4,0,1,1,0.843776,0.22677,0,"#f4c8cf"
580407385,roseva14,42,0,1,1,0.712111,0.463495,0,"#66e087"
580451217,AlfKastro,13,0,1,1,0.401791,0.501023,0,"#3bec00"
581070971,diana_rojasv,7,0,1,1,0.392341,0.342794,0,"#ffb800"
581109443,patosalazarv,9,4,7,11,0.624161,0.581761,0.004864,"#008f7b"
581151700,gordacosta,3,0,1,1,0.489882,0.760226,0,"#ffb3ff"
581312485,theHyperlab,13,1,0,1,0.345008,0.495263,0,"#3bec00"
581416381,guidoweks,37,2,2,4,0.284737,0.48038,0.001459,"#006032"
581867864,Ganimedes_Asoc,1,8,2,10,0.44448,0.621045,0.004377,"#b6cb00"
581887652,santy_pe,9,0,1,1,0.719635,0.679801,0,"#008f7b"
581948892,DelegaLitterae,1,0,1,1,0.423075,0.624173,0,"#b6cb00"
582082656,Rector_UAEM,41,1,0,1,0.307898,0.350512,0,"#697b00"
582097391,_Inquietudes_,1,0,1,1,0.34498,0.732535,0,"#b6cb00"
582615674,fmapfre,15,10,0,10,0.523012,0.634919,0.004377,"#008ebb"
582938117,JuanLuisArsuaga,58,2,0,2,0.572866,0.563278,0.000486,"#005076"
582977191,ConParticipa,49,1,0,1,0.360764,0.66879,0,"#ff7007"
582998381,deiris2012,22,0,1,1,0.59349,0.625503,0,"#00e8b2"
583233410,ElsevierConnect,13,2,0,2,0.464629,0.387727,0.000486,"#3bec00"
583436249,Lasa_Colombia,34,0,2,2,0.508872,0.410966,0.000486,"#ff0d69"
583442417,SeleLarenas,49,1,1,2,0.367711,0.54038,0.000486,"#ff7007"
583852912,zzzgar,13,0,2,2,0.449311,0.431065,0.000486,"#3bec00"
584080217,FCriadoBoado,14,11,6,17,0.52141,0.49601,0.007782,"#00eeff"
584112631,FEDUNArgentina,49,5,0,5,0.451779,0.696413,0.001946,"#ff7007"
584217736,cristinarivasm1,16,0,2,2,0.940654,0.676306,0.000486,"#c42c63"
584245907,AsocABDM,30,0,1,1,0.565189,0.46564,0,"#ff77ff"
584393988,Bereeps,7,0,1,1,0.397886,0.354521,0,"#ffb800"
584757764,E_Staniforth,14,0,1,1,0.568911,0.467765,0,"#00eeff"
585216750,Aviranetiano,14,0,4,4,0.573957,0.537333,0.001459,"#00eeff"
585771680,berelukis,13,0,3,3,0.481344,0.436136,0.000973,"#3bec00"
585824468,CarlesRocamora,4,0,4,4,0.925082,0.247123,0.001459,"#f4c8cf"
585918128,sa_manz,31,0,2,2,0.537165,0.464747,0.000486,"#3e93ff"
585960614,InAGaddaDaVidaa,36,0,1,1,0.540246,0.288975,0,"#825403"
586211339,tyfany440,38,0,1,1,0.597784,0.343057,0,"#662859"
586359641,QDestudio,22,0,2,2,0.704786,0.597232,0.000486,"#00e8b2"
586563203,PBJournal,13,0,1,1,0.379012,0.379113,0,"#3bec00"
586695861,LaCSolitaria,37,0,1,1,0.761449,0.493434,0,"#006032"
586714462,SeminarioSIELAE,14,23,0,23,0.497925,0.553247,0.0107,"#00eeff"
587020572,GenteConWalkman,0,0,3,3,0.544859,0.351069,0.000973,"#8ecfec"
587044245,nehmoran,7,0,1,1,0.349041,0.363677,0,"#ffb800"
587056908,RevComunicacion,31,1,1,2,0.583049,0.718305,0.000486,"#3e93ff"
587401635,AppCultura,22,3,2,5,0.634655,0.624873,0.001946,"#00e8b2"
587481127,jades77777,37,0,1,1,0.271733,0.46494,0,"#006032"
587564291,CarlosMGordiano,13,1,0,1,0.464719,0.392629,0,"#3bec00"
587670516,ignaciodt1,10,0,1,1,0.689531,0.797223,0,"#52d7c0"
587701679,la_rvlj,42,0,1,1,0.916349,0.43665,0,"#66e087"
587961964,joselogomdi,38,0,1,1,0.616497,0.360815,0,"#662859"
588197195,bid_dimad,22,5,0,5,0.54719,0.592182,0.001946,"#00e8b2"
588273178,FuhemEducacion,49,1,0,1,0.352938,0.662313,0,"#ff7007"
588402875,FDerechoUGR,31,6,3,9,0.610451,0.542692,0.003891,"#3e93ff"
588443429,PaulPreston8,19,1,0,1,0.665849,0.786277,0,"#00d3ff"
588566472,MantenimientoMI,49,3,0,3,0.419207,0.598944,0.000973,"#ff7007"
588727264,Edwmad,36,0,3,3,0.440867,0.492637,0.000973,"#825403"
588769661,siordialuis,49,0,1,1,0.533339,0.736689,0,"#ff7007"
588839311,josemiguelutand,30,0,1,1,0.469475,0.650529,0,"#ff77ff"
589072301,Marco_Erebus,30,0,2,2,0.480871,0.571477,0.000486,"#ff77ff"
589227912,pailos23,2,0,2,2,0.675795,0.659088,0.000486,"#ffa64e"
589277590,CulturaUniandes,34,4,0,4,0.469397,0.523052,0.001459,"#ff0d69"
589990677,esDBpedia,22,0,6,6,0.546268,0.640717,0.002432,"#00e8b2"
590181012,cipensoio_es,30,0,5,5,0.510714,0.516813,0.001946,"#ff77ff"
590260759,elvillanozapata,17,0,1,1,0.822425,0.235488,0,"#ff9cc7"
590390400,aytmorales,49,0,2,2,0.459877,0.603269,0.000486,"#ff7007"
590391131,JFCalderero,14,9,3,12,0.481551,0.554264,0.00535,"#00eeff"
590702211,jufemun,35,0,1,1,0.571806,0.260505,0,"#00faff"
590754035,carriazojr,30,35,25,60,0.51466,0.570862,0.028696,"#ff77ff"
591076731,leiatxu,14,1,0,1,0.32671,0.435531,0,"#00eeff"
591199916,CesarMundaca88,10,0,1,1,0.654606,0.80045,0,"#52d7c0"
591609903,KingCordoba,13,2,0,2,0.434615,0.437865,0.000486,"#3bec00"
591941411,mariwts,36,0,1,1,0.473118,0.221315,0,"#825403"
592113074,CarlaRFerrari,49,1,0,1,0.365027,0.620289,0,"#ff7007"
592164004,Cafevulgario,46,0,1,1,0.480304,0.144656,0,"#403538"
592181445,PsicEduM,13,0,2,2,0.534142,0.445402,0.000486,"#3bec00"
592360733,DianaMarieta,3,0,1,1,0.441084,0.746887,0,"#ffb3ff"
592401039,universidaduptc,13,1,0,1,0.489402,0.39926,0,"#3bec00"
592678414,FernandoBroncan,37,1,0,1,0.703836,0.553961,0,"#006032"
592731960,PabloLopezm34,2,0,10,10,0.528274,0.575032,0.004377,"#ffa64e"
592783774,Esther_Bismarck,49,0,1,1,0.41229,0.520168,0,"#ff7007"
592799120,ivnrguez,37,0,1,1,0.531214,0.202208,0,"#006032"
592815572,UAERUNAM,13,2,1,3,0.38809,0.374932,0.000973,"#3bec00"
592865322,norahlfy,2,0,1,1,0.671134,0.378491,0,"#ffa64e"
592951492,HaydeeDomic,21,0,1,1,0.330641,0.44295,0,"#c6cc85"
593196309,IxaTaldea,34,1,4,5,0.50381,0.48403,0.001946,"#ff0d69"
593525974,ESTYC1,22,0,1,1,0.676539,0.363619,0,"#00e8b2"
593618061,Uni_WUE,30,5,0,5,0.528558,0.501164,0.001946,"#ff77ff"
593769567,IxaGroup,34,1,5,6,0.501505,0.500865,0.002432,"#ff0d69"
594487193,_IPComunicacion,8,4,3,7,0.68642,0.352741,0.002918,"#00ed5d"
594865221,PonsEmpar,30,0,1,1,0.257956,0.469819,0,"#ff77ff"
594904946,gzmandaniel,13,0,1,1,0.402603,0.374925,0,"#3bec00"
594963553,elenasemino,55,1,0,1,0.706,0.522004,0,"#cb3f32"
595114749,ClaudiaJuradoG,9,2,2,4,0.720725,0.632308,0.001459,"#008f7b"
595144555,philismaria,34,0,2,2,0.361877,0.423897,0.000486,"#ff0d69"
595504098,IsabelMerpe,30,0,1,1,0.576027,0.559989,0,"#ff77ff"
595588585,UOCartshum,14,52,14,66,0.542709,0.531568,0.031615,"#00eeff"
595724234,Facsalud_UCEN,49,6,4,10,0.405546,0.502153,0.004377,"#ff7007"
596207368,paolomonella,14,14,12,26,0.499652,0.492724,0.01216,"#00eeff"
596311612,axenciaGAIN,14,2,0,2,0.518089,0.589514,0.000486,"#00eeff"
596388361,EdL_UB,22,0,1,1,0.596801,0.689913,0,"#00e8b2"
597039955,CarmenUrioste,49,0,1,1,0.407693,0.624153,0,"#ff7007"
597296079,mperezmontoro,19,0,2,2,0.575523,0.483478,0.000486,"#00d3ff"
597446050,CarmenVerdeAroc,34,2,1,3,0.581998,0.407721,0.000973,"#ff0d69"
597463216,dsotocarrasco,7,0,2,2,0.416507,0.373305,0.000486,"#ffb800"
597706344,asociacionruvid,22,5,9,14,0.551268,0.510829,0.006323,"#00e8b2"
597711712,macarenip,1,0,2,2,0.478549,0.611811,0.000486,"#b6cb00"
597777232,iratiherrera1,38,0,1,1,0.104942,0.418788,0,"#662859"
597825672,jo_frankie,36,6,1,7,0.45533,0.393561,0.002918,"#825403"
597966860,LaraCrescent,2,0,1,1,0.670876,0.387459,0,"#ffa64e"
598031186,choikepurun,0,0,2,2,0.4467,0.38845,0.000486,"#8ecfec"
598664749,morocha197,22,0,2,2,0.55263,0.502423,0.000486,"#00e8b2"
598859150,AldoNava2,19,0,2,2,0.543519,0.510303,0.000486,"#00d3ff"
598884891,YolandaMiramon2,7,0,2,2,0.384664,0.360841,0.000486,"#ffb800"
599122981,joseriello,14,1,1,2,0.584681,0.494104,0.000486,"#00eeff"
599133260,nottinauta,49,3,3,6,0.443888,0.510582,0.002432,"#ff7007"
599480425,EnTICconfio,30,1,0,1,0.542887,0.62438,0,"#ff77ff"
599863547,jenffo,38,0,2,2,0.26932,0.384527,0.000486,"#662859"
599933777,PlataformC,14,5,0,5,0.72285,0.471468,0.001946,"#00eeff"
600155340,feraagra,37,0,1,1,0.708185,0.467283,0,"#006032"
600188317,lalucastaneda,4,0,1,1,0.831453,0.248014,0,"#f4c8cf"
600415343,alicafiligrana,22,0,1,1,0.702783,0.616338,0,"#00e8b2"
600543206,normitaramsa,13,0,1,1,0.506219,0.31665,0,"#3bec00"
600561959,Crst_C,37,7,8,15,0.302237,0.488468,0.006809,"#006032"
600722721,Cacoluquia,35,1,0,1,0.48494,0.240173,0,"#00faff"
600760872,chrispereyra22,49,0,1,1,0.455879,0.730057,0,"#ff7007"
600815587,t_barcelo,2,7,2,9,0.506225,0.519643,0.003891,"#ffa64e"
600856814,lagoyidice,30,0,2,2,0.621095,0.588337,0.000486,"#ff77ff"
601006502,HacerCultural,9,5,0,5,0.569297,0.599604,0.001946,"#008f7b"
601144384,OscarG_Sanchez,31,1,0,1,0.710882,0.404628,0,"#3e93ff"
601352732,MlAlexalex,38,0,1,1,0.675779,0.465395,0,"#662859"
601415323,PHDELASOTA,31,0,1,1,0.648409,0.509142,0,"#3e93ff"
601519084,OrlandoDeavilaP,38,102,0,102,0.352586,0.24359,0.049125,"#662859"
601569652,GarciaGarfaroma,0,3,5,8,0.461791,0.514124,0.003405,"#8ecfec"
601638152,nmjqmi,37,0,3,3,0.670852,0.594509,0.000973,"#006032"
601657931,josorella,2,0,7,7,0.498303,0.544432,0.002918,"#ffa64e"
601841904,ARGENTUM_CBA,22,0,1,1,0.400433,0.613606,0,"#00e8b2"
602254044,VoyantTools,34,19,2,21,0.466773,0.491725,0.009728,"#ff0d69"
602255097,jestemmcant,13,0,2,2,0.45494,0.417086,0.000486,"#3bec00"
602328030,mfr20240487,36,1,0,1,0.543513,0.356726,0,"#825403"
602467716,Di_Moreno5,37,0,2,2,0.421303,0.39822,0.000486,"#006032"
602674286,JLBombardino,1,0,1,1,0.581852,0.823859,0,"#b6cb00"
602694748,uscfilosofia,55,0,2,2,0.558831,0.508838,0.000486,"#cb3f32"
602721353,BHumanitatsUAB,14,2,13,15,0.540522,0.559778,0.006809,"#00eeff"
602779858,jeftebatista99,36,0,2,2,0.521014,0.338996,0.000486,"#825403"
602801023,Marctanz,7,0,1,1,0.83161,0.556177,0,"#ffb800"
602877138,fj_alarcon,31,0,3,3,0.561884,0.558763,0.000973,"#3e93ff"
602962987,FylUex,30,12,0,12,0.535307,0.55402,0.00535,"#ff77ff"
602976287,Cadiznoticias,37,1,0,1,0.572806,0.36744,0,"#006032"
603032045,maestrimariana,49,0,1,1,0.437052,0.658319,0,"#ff7007"
603057987,marianietoalar,3,0,1,1,0.475765,0.780744,0,"#ffb3ff"
603063561,anaaf95,0,0,2,2,0.648801,0.607582,0.000486,"#8ecfec"
603097163,CIM_UNR,49,10,3,13,0.454099,0.586913,0.005837,"#ff7007"
603128399,OrquestaOUGR,31,1,0,1,0.681511,0.605584,0,"#3e93ff"
603257200,mrseleanor,13,0,1,1,0.367459,0.449324,0,"#3bec00"
603660434,SalomonLoRo,22,0,1,1,0.597883,0.612436,0,"#00e8b2"
603864949,derechoaleer,34,1,5,6,0.462461,0.441533,0.002432,"#ff0d69"
603985792,esthermar2012,13,0,3,3,0.486232,0.428367,0.000973,"#3bec00"
604056765,Stella7266,37,0,2,2,0.565083,0.500495,0.000486,"#006032"
604104831,dosisderadio,49,0,1,1,0.349818,0.56403,0,"#ff7007"
604393685,DanAuron,1,0,2,2,0.726534,0.556008,0.000486,"#b6cb00"
604509261,lopezacunad,31,0,1,1,0.654651,0.581617,0,"#3e93ff"
604668053,atomoverde_,38,7,2,9,0.498063,0.444288,0.003891,"#662859"
605102438,MiguelGC62,17,0,1,1,0.905391,0.371799,0,"#ff9cc7"
605506906,MarsasSastre,1,0,2,2,0.447397,0.584559,0.000486,"#b6cb00"
605522755,carlosffernand,14,0,2,2,0.529125,0.605413,0.000486,"#00eeff"
605685039,SaludSaluty,49,1,0,1,0.30937,0.629978,0,"#ff7007"
605780302,BibOsRo,3,0,2,2,0.451246,0.611768,0.000486,"#ffb3ff"
605816734,RodPeniche,13,0,1,1,0.484686,0.364461,0,"#3bec00"
606296247,ovidiuspictus,30,10,10,20,0.5032,0.569031,0.009241,"#ff77ff"
606311135,arioscazares,7,0,2,2,0.414716,0.165386,0.000486,"#ffb800"
606315649,arantzaozaeta,18,1,3,4,0.644574,0.561761,0.001459,"#5456a6"
606604240,etornosinza,55,1,3,4,0.798755,0.677709,0.001459,"#cb3f32"
606930198,unamita1,13,0,2,2,0.427676,0.352524,0.000486,"#3bec00"
607170913,InvestigaUS,1,15,10,25,0.47365,0.594288,0.011673,"#b6cb00"
607226409,AmaliaCEU,2,0,3,3,0.50291,0.525061,0.000973,"#ffa64e"
607245696,BrownInstitute,57,2,0,2,0.566979,0.473795,0.000486,"#b66f7a"
607316601,DazGuerra,38,0,1,1,0.605804,0.350159,0,"#662859"
607389928,csorianogomez,35,1,0,1,0.600714,0.393359,0,"#00faff"
607532355,Sharronapearl,34,0,2,2,0.401087,0.456339,0.000486,"#ff0d69"
607538044,Gajardonury,49,1,0,1,0.319395,0.613552,0,"#ff7007"
607574716,UCLA_DH,13,18,0,18,0.485897,0.484795,0.008268,"#3bec00"
607586799,vanesuarezce,15,0,1,1,0.482461,0.731546,0,"#008ebb"
607602141,ProgHist,34,541,79,620,0.48898,0.458489,0.30107,"#ff0d69"
607659086,FHyE_UCV,37,1,0,1,0.548272,0.764942,0,"#006032"
607853172,Irenelectora,7,0,2,2,0.733406,0.538042,0.000486,"#ffb800"
608036687,_polom,30,1,0,1,0.606387,0.629662,0,"#ff77ff"
608082622,CanalUNED,30,7,0,7,0.54848,0.519402,0.002918,"#ff77ff"
608115459,rhtxo,34,0,3,3,0.376688,0.428865,0.000973,"#ff0d69"
608144321,Gratiaetamore,14,0,3,3,0.562067,0.553753,0.000973,"#00eeff"
608185131,Novoneyra,13,0,3,3,0.515953,0.496705,0.000973,"#3bec00"
608221100,oJaison,34,0,2,2,0.35236,0.429242,0.000486,"#ff0d69"
608246641,WDiazCastagneto,21,0,1,1,0.22885,0.225659,0,"#c6cc85"
608260587,annabelmia,8,2,0,2,0.674795,0.240728,0.000486,"#00ed5d"
608500702,sauripez,30,2,5,7,0.517085,0.514984,0.002918,"#ff77ff"
608693812,IvanVillan_,0,0,1,1,0.36533,0.564303,0,"#8ecfec"
608754256,Carmencita_rps,42,8,8,16,0.651387,0.431803,0.007296,"#66e087"
609264068,shirobirok,10,0,1,1,0.326285,0.48308,0,"#52d7c0"
609659719,JudyMalloy,13,0,1,1,0.373243,0.462249,0,"#3bec00"
610596818,Angela_Ibanez,30,0,2,2,0.564602,0.595808,0.000486,"#ff77ff"
611206745,fatimatecpool,37,0,2,2,0.564814,0.330723,0.000486,"#006032"
611237247,ma_vicente,19,0,1,1,0.62974,0.640884,0,"#00d3ff"
611488789,ColpisCat,7,0,1,1,0.823676,0.553938,0,"#ffb800"
611526634,FundCreate,0,1,2,3,0.637238,0.591711,0.000973,"#8ecfec"
611544386,cerezoom,14,0,1,1,0.605851,0.480713,0,"#00eeff"
611551774,femcat,8,9,0,9,0.649494,0.31955,0.003891,"#00ed5d"
611647762,letibarrionuevo,37,5,2,7,0.514992,0.574262,0.002918,"#006032"
611716756,amv5_com,1,0,5,5,0.494828,0.661053,0.001946,"#b6cb00"
611867116,abelpr5,27,0,1,1,0.26438,0.660417,0,"#7e8b76"
611958317,ftb_abril,49,1,0,1,0.431301,0.687774,0,"#ff7007"
612026965,juanita_nani,14,29,75,104,0.501857,0.514203,0.050097,"#00eeff"
612045209,GPV_90,49,1,0,1,0.380638,0.635389,0,"#ff7007"
612357186,exPadaDDemonerd,13,0,1,1,0.473258,0.394315,0,"#3bec00"
612382284,Iza_Romanowska,34,0,2,2,0.515376,0.500018,0.000486,"#ff0d69"
612454570,FornielesRaquel,22,0,1,1,0.654472,0.503601,0,"#00e8b2"
612551388,hispaniaarq,37,1,0,1,0.620445,0.34114,0,"#006032"
612794988,Macra5,13,0,7,7,0.492642,0.479106,0.002918,"#3bec00"
612808132,santirguez91,22,0,6,6,0.568131,0.574615,0.002432,"#00e8b2"
612887272,for_Content,14,0,2,2,0.616656,0.446684,0.000486,"#00eeff"
613109244,RevJaveriana,38,0,1,1,0.58889,0.15284,0,"#662859"
613373645,Ceti_uclm,22,0,1,1,0.574833,0.678326,0,"#00e8b2"
613469003,CCriadoPerez,34,1,0,1,0.38383,0.445175,0,"#ff0d69"
613588161,MigSolo,38,0,1,1,0.705986,0.580031,0,"#662859"
613671577,bebepfm,17,0,1,1,0.939482,0.362056,0,"#ff9cc7"
613717245,VocacionReactor,13,17,4,21,0.433867,0.387624,0.009728,"#3bec00"
613740623,eldesconcierto,21,1,0,1,0.577434,0.317241,0,"#c6cc85"
613785565,Sasha__25,49,1,0,1,0.326648,0.602657,0,"#ff7007"
613788838,JanChvzSanti,13,1,0,1,0.422216,0.340887,0,"#3bec00"
613808763,SociedadCerfa,22,0,2,2,0.631137,0.458728,0.000486,"#00e8b2"
613929637,acarrillo_mx,49,1,0,1,0.347501,0.68271,0,"#ff7007"
614034910,re_blen,38,7,1,8,0.672877,0.368039,0.003405,"#662859"
614478936,HistoriayVideoj,38,11,0,11,0.652283,0.522355,0.004864,"#662859"
614492046,nancyariasvilla,37,0,4,4,0.308186,0.50407,0.001459,"#006032"
614520131,villamizarmonic,3,0,1,1,0.484125,0.769306,0,"#ffb3ff"
615153973,NITZIABANFIELD,49,0,1,1,0.0843,0.635894,0,"#ff7007"
615237962,dyneuf,35,0,2,2,0.540623,0.34616,0.000486,"#00faff"
615250781,WesternAmerica1,34,0,2,2,0.366714,0.430287,0.000486,"#ff0d69"
615320638,kindle_promoESP,55,1,0,1,0.486771,0.739259,0,"#cb3f32"
615413571,diana_pulido27,38,0,2,2,0.65862,0.375666,0.000486,"#662859"
615423502,nancy89755561,49,1,0,1,0.369553,0.617185,0,"#ff7007"
616158757,RodrigoLBarnes,49,1,0,1,0.416241,0.670764,0,"#ff7007"
616351521,Periplia,49,2,0,2,0.431258,0.552663,0.000486,"#ff7007"
616425142,JoserraMarcaida,22,8,7,15,0.508311,0.53584,0.006809,"#00e8b2"
616462345,lauracrescendo,14,4,5,9,0.544919,0.532652,0.003891,"#00eeff"
616509964,PerezPuenteL,34,5,13,18,0.453249,0.476935,0.008268,"#ff0d69"
616611494,abhumphreys,36,0,4,4,0.444078,0.346826,0.001459,"#825403"
616626802,Edrodriguez_ius,7,0,1,1,0.365483,0.370744,0,"#ffb800"
616665640,cchsur_oficial,13,0,1,1,0.423148,0.243952,0,"#3bec00"
616721418,velunica,13,0,1,1,0.506902,0.369445,0,"#3bec00"
616811658,lizliz_mtz,35,0,1,1,0.568693,0.272578,0,"#00faff"
617081582,isalillo97,49,1,0,1,0.390066,0.664309,0,"#ff7007"
617211140,DecirMs,21,0,2,2,0.324407,0.459742,0.000486,"#c6cc85"
617278135,keto_neo,37,2,0,2,0.521779,0.378077,0.000486,"#006032"
617333434,Docutradus,58,9,3,12,0.482916,0.587249,0.00535,"#005076"
617449314,VivianeBarradas,36,0,1,1,0.528055,0.28738,0,"#825403"
618308774,BenjiPrise,13,0,4,4,0.447702,0.445569,0.001459,"#3bec00"
618464598,davidsoIorzano,15,0,4,4,0.518555,0.540782,0.001459,"#008ebb"
618505563,nelcyvalenciao,30,0,3,3,0.541377,0.555061,0.000973,"#ff77ff"
618650280,mariadelmonton,3,0,1,1,0.459139,0.666728,0,"#ffb3ff"
619010262,NelsonEcheverr5,0,0,2,2,0.573685,0.560222,0.000486,"#8ecfec"
619212898,STEVENALCOBA,49,1,0,1,0.40986,0.638693,0,"#ff7007"
619290209,VillodreJulian,37,0,4,4,0.674712,0.520357,0.001459,"#006032"
619358408,MariloRodrigueC,1,0,1,1,0.36376,0.542601,0,"#b6cb00"
619461030,sickroose,49,1,0,1,0.343898,0.701685,0,"#ff7007"
619519362,julipardor,38,0,1,1,0.587814,0.34866,0,"#662859"
619542447,Latinohistory,34,0,3,3,0.380038,0.424001,0.000973,"#ff0d69"
619840909,xochizin,13,0,2,2,0.543739,0.382123,0.000486,"#3bec00"
620132527,LetiLiitaway,34,0,1,1,0.324749,0.40604,0,"#ff0d69"
620174374,USB_REBIUdeG,22,0,1,1,0.622228,0.622008,0,"#00e8b2"
620300688,luciav__,21,0,2,2,0.221376,0.24237,0.000486,"#c6cc85"
620672505,elculturalsm,49,0,3,3,0.390456,0.569486,0.000973,"#ff7007"
620796933,aldomaher,7,0,2,2,0.420351,0.356763,0.000486,"#ffb800"
620854207,mibarluz,22,0,1,1,0.582003,0.691778,0,"#00e8b2"
621228652,ROMEUBA1,49,4,0,4,0.459086,0.560224,0.001459,"#ff7007"
621712326,RuizCagigal,34,0,2,2,0.512702,0.393428,0.000486,"#ff0d69"
622022834,e_emilito,58,0,2,2,0.480614,0.654183,0.000486,"#005076"
622425781,Espelunco,21,2,1,3,0.296424,0.363765,0.000973,"#c6cc85"
622785360,angoco1963,38,0,1,1,0.573784,0.706764,0,"#662859"
622906040,NubeDidactica,31,5,4,9,0.502379,0.581899,0.003891,"#3e93ff"
622908793,DanielAlvesFCSH,36,103,126,229,0.52574,0.456687,0.110895,"#825403"
623019847,DailyArtApp,38,2,2,4,0.537983,0.42557,0.001459,"#662859"
623073930,isamaro57,40,0,1,1,0.618244,0.024284,0,"#ff12a3"
623150562,BlancaMiedes,1,0,1,1,0.485626,0.592756,0,"#b6cb00"
623419471,Tonatiuh250,4,0,3,3,0.428934,0.4142,0.000973,"#f4c8cf"
623957452,Amedinamejia,38,0,1,1,0.428211,0.76289,0,"#662859"
624063881,conaromadecafe8,55,0,1,1,0.609251,0.681692,0,"#cb3f32"
624105430,eldesplatao,3,0,1,1,0.52057,0.769347,0,"#ffb3ff"
624116600,mistike32,7,0,1,1,0.394198,0.215056,0,"#ffb800"
624232492,marilynsarai89,51,0,1,1,0.371042,0.181991,0,"#c44aac"
624239540,RitaRico,13,0,3,3,0.489159,0.437625,0.000973,"#3bec00"
624333299,LetyChumacero,30,0,1,1,0.505639,0.636151,0,"#ff77ff"
624559898,palaeoecology,22,0,1,1,0.534173,0.682274,0,"#00e8b2"
624603333,jmbolufer,0,0,2,2,0.426515,0.59699,0.000486,"#8ecfec"
624839528,Lilimarlene5,30,0,4,4,0.584127,0.583044,0.001459,"#ff77ff"
624863412,briesunaviajera,7,0,2,2,0.41293,0.371505,0.000486,"#ffb800"
625077639,GmezDul,34,0,1,1,0.49572,0.379921,0,"#ff0d69"
625146889,Larivazquezz,37,0,2,2,0.242156,0.491019,0.000486,"#006032"
625212977,AntirepresivaGu,19,2,0,2,0.66965,0.745598,0.000486,"#00d3ff"
626081645,ArenaTheOne,49,1,0,1,0.368554,0.682234,0,"#ff7007"
626139273,Taniapaol,17,0,1,1,0.834208,0.243059,0,"#ff9cc7"
626166984,negrita73bn,4,0,4,4,0.91154,0.244433,0.001459,"#f4c8cf"
626398293,cupumad,58,0,2,2,0.573022,0.590993,0.000486,"#005076"
626504359,UniversidadCarl,55,1,0,1,0.614702,0.563481,0,"#cb3f32"
626580677,sel_silvia,49,0,15,15,0.452822,0.572031,0.006809,"#ff7007"
626741849,angelportoles,31,0,2,2,0.610025,0.473431,0.000486,"#3e93ff"
627013647,Historia_UC,7,2,2,4,0.441406,0.278412,0.001459,"#ffb800"
627027430,marifer_changui,7,0,1,1,0.645654,0.378583,0,"#ffb800"
627058977,Monic2102,31,0,4,4,0.500706,0.522543,0.001459,"#3e93ff"
627288118,gamm_archiveros,22,0,1,1,0.38886,0.598813,0,"#00e8b2"
627453320,ArchivodeBogota,38,1,0,1,0.558759,0.380277,0,"#662859"
627469515,rogeriomadeira2,36,0,6,6,0.563067,0.422798,0.002432,"#825403"
627539634,DIIS_UZ,22,9,1,10,0.54184,0.665456,0.004377,"#00e8b2"
627768498,CGuevaraCasas,4,0,1,1,0.864352,0.216022,0,"#f4c8cf"
627809898,ppriani,13,0,1,1,0.474205,0.388727,0,"#3bec00"
627819801,coTrastevere1,49,1,0,1,0.367041,0.6827,0,"#ff7007"
628250634,abaco_news,22,2,1,3,0.629325,0.474967,0.000973,"#00e8b2"
628278342,micofvlc,49,1,0,1,0.324685,0.618664,0,"#ff7007"
628285611,MarHerrador,2,0,2,2,0.423388,0.550339,0.000486,"#ffa64e"
628347534,MargaretBrehony,34,0,1,1,0.347619,0.405241,0,"#ff0d69"
628596074,MinTIC_responde,9,1,0,1,0.745048,0.778151,0,"#008f7b"
628606004,bdh_uv,13,5,0,5,0.550582,0.500811,0.001946,"#3bec00"
628750106,_VicenteSerrano,17,1,0,1,0.737866,0.188422,0,"#ff9cc7"
628871742,JulianDFonseca,34,0,1,1,0.644644,0.312535,0,"#ff0d69"
629155988,ARockenberger,30,0,2,2,0.473947,0.569175,0.000486,"#ff77ff"
629192461,ContratiempoHis,35,7,0,7,0.626816,0.44762,0.002918,"#00faff"
629759916,JayroEfren,14,0,3,3,0.546079,0.57748,0.000973,"#00eeff"
629877726,SiobhanLeachman,36,0,1,1,0.458207,0.274578,0,"#825403"
630311428,SabineNuss,37,2,0,2,0.551489,0.424707,0.000486,"#006032"
630361760,dxbarradas,13,0,2,2,0.469309,0.385754,0.000486,"#3bec00"
630492496,Pilar_RguezLedo,8,0,1,1,0.243563,0.260316,0,"#00ed5d"
630608702,Flipgrid,41,2,0,2,0.344979,0.386149,0.000486,"#697b00"
631016900,UNIRRevista,14,6,4,10,0.459123,0.548841,0.004377,"#00eeff"
631260803,CCDmx,0,14,4,18,0.502304,0.476094,0.008268,"#8ecfec"
631312852,GloriaRSantana,14,0,1,1,0.674648,0.510675,0,"#00eeff"
631335110,FloresCollazo,22,1,4,5,0.544006,0.579658,0.001946,"#00e8b2"
631582012,VenezuelaAnons,49,1,0,1,0.351889,0.615946,0,"#ff7007"
631650534,COTICH_Informa,14,0,2,2,0.579629,0.549247,0.000486,"#00eeff"
631777234,maoistcenter,19,1,0,1,0.630879,0.800356,0,"#00d3ff"
632139519,jagv69,49,0,13,13,0.457052,0.474937,0.005837,"#ff7007"
632315069,Idhie_Iberopue,37,3,5,8,0.460305,0.302005,0.003405,"#006032"
632706787,antortl,22,2,2,4,0.625262,0.677491,0.001459,"#00e8b2"
632731274,mariaparrula,1,2,10,12,0.469221,0.596739,0.00535,"#b6cb00"
632731682,AndresRoblesCor,30,0,2,2,0.504669,0.603934,0.000486,"#ff77ff"
632837430,AmparoPerezCarb,37,0,1,1,0.757122,0.642514,0,"#006032"
632957861,JornetNuria,22,0,14,14,0.548228,0.553528,0.006323,"#00e8b2"
632989630,acafanmom,36,0,1,1,0.437377,0.261372,0,"#825403"
633072445,TotsonPops1,19,0,1,1,0.624523,0.78401,0,"#00d3ff"
633082843,AnaCasandra_,1,0,1,1,0.271968,0.72334,0,"#b6cb00"
633562121,LolaGergona,40,0,1,1,0.581153,0.028437,0,"#ff12a3"
633650572,elmalvadoZaroff,14,0,1,1,0.604302,0.502571,0,"#00eeff"
633700365,_lacion_,37,0,1,1,0.274403,0.463075,0,"#006032"
633910238,HellfreakerShow,0,0,2,2,0.441723,0.385751,0.000486,"#8ecfec"
633961342,tmycarlos,13,2,29,31,0.513798,0.456847,0.014591,"#3bec00"
633963776,KathrynEccles,13,1,0,1,0.546833,0.406206,0,"#3bec00"
634140141,SWarchivists,34,0,2,2,0.338571,0.41429,0.000486,"#ff0d69"
634338362,fjtorres,30,1,2,3,0.497344,0.599979,0.000973,"#ff77ff"
634532948,Nuriettt,22,0,9,9,0.538108,0.513716,0.003891,"#00e8b2"
634593678,TweetAlgernon,36,0,1,1,0.531987,0.356565,0,"#825403"
634769825,juanjocg96,22,0,1,1,0.463688,0.66967,0,"#00e8b2"
634773972,SeilafAeropolis,14,0,1,1,0.60234,0.46516,0,"#00eeff"
634963529,ElbaRoa,3,0,1,1,0.475116,0.788763,0,"#ffb3ff"
635058564,AngieJimenez05,38,1,0,1,0.604203,0.348697,0,"#662859"
635210697,Klauzen7,13,0,1,1,0.435702,0.313036,0,"#3bec00"
635385746,tangisalazar,21,0,1,1,0.212187,0.222282,0,"#c6cc85"
635734308,PrissilaEvans,49,1,0,1,0.399151,0.661759,0,"#ff7007"
635863647,mary_faviola,42,0,1,1,0.703573,0.437768,0,"#66e087"
635964582,LuisCh_97,13,0,1,1,0.370928,0.307319,0,"#3bec00"
636126399,ATUspain,31,6,19,25,0.579829,0.549572,0.011673,"#3e93ff"
636148779,jlfvindel,30,2,1,3,0.529971,0.497563,0.000973,"#ff77ff"
636268171,nusagatero,30,0,1,1,0.540117,0.699256,0,"#ff77ff"
636886632,isaromerodeleon,19,0,3,3,0.650987,0.75819,0.000973,"#00d3ff"
637185447,CValcrcel,55,2,1,3,0.641439,0.430775,0.000973,"#cb3f32"
637266063,aladeva,31,0,5,5,0.573788,0.533209,0.001946,"#3e93ff"
700501170,bwbohl,36,0,3,3,0.441184,0.501084,0.000973,"#825403"
700568280,SamuelLealG,40,0,1,1,0.61068,0.026249,0,"#ff12a3"
700645712,MLG_66,40,0,1,1,0.585787,0.025127,0,"#ff12a3"
701045258,VanHammersly42,34,0,1,1,0.321855,0.422947,0,"#ff0d69"
701084922,YesicaCeciliaNe,31,0,1,1,0.645041,0.496292,0,"#3e93ff"
701288267,CClauuudioo,49,1,0,1,0.328994,0.596651,0,"#ff7007"
701709276,vocesenelfenix,49,6,0,6,0.452065,0.592347,0.002432,"#ff7007"
701804250,MorenoAmc,30,0,5,5,0.530516,0.605251,0.001946,"#ff77ff"
701879023,ChocoroChelle,13,1,0,1,0.57254,0.43272,0,"#3bec00"
701967595,medialabufrj,36,25,6,31,0.488033,0.290662,0.014591,"#825403"
702001376,Wawitasny,22,2,0,2,0.680726,0.671749,0.000486,"#00e8b2"
702986880,andreasuarezo,38,0,1,1,0.587963,0.344972,0,"#662859"
703068096,Sagarq_,34,0,6,6,0.536606,0.442953,0.002432,"#ff0d69"
703247820,ParolearTradu,14,0,1,1,0.678185,0.501759,0,"#00eeff"
703289767,lfuentes_a,3,0,1,1,0.611189,0.712025,0,"#ffb3ff"
703784586,gabarrical,13,0,1,1,0.511252,0.318992,0,"#3bec00"
704058068,GlennHdz,31,0,1,1,0.654624,0.564261,0,"#3e93ff"
704091917,grarmen,49,1,0,1,0.357428,0.652479,0,"#ff7007"
705506810,corchadojm,58,5,1,6,0.347666,0.57449,0.002432,"#005076"
706628761,PalomaMoruno,22,0,1,1,0.669248,0.530093,0,"#00e8b2"
707531682,rgamezsa,1,0,1,1,0.481844,0.623323,0,"#b6cb00"
707902006,edupgv,58,0,2,2,0.619143,0.29817,0.000486,"#005076"
708017673,MariaCiAb,14,0,1,1,0.471068,0.633767,0,"#00eeff"
708090776,carlos_acostap,49,1,0,1,0.318396,0.607764,0,"#ff7007"
708428669,germanisabel77,31,0,2,2,0.598703,0.500574,0.000486,"#3e93ff"
708498941,ansermu57,2,0,2,2,0.667991,0.663334,0.000486,"#ffa64e"
709387640,GarciaRegaladou,4,0,2,2,0.512859,0.385868,0.000486,"#f4c8cf"
709969404,manu_taxiglass,13,1,0,1,0.384481,0.503718,0,"#3bec00"
710126455,dannymunoz77,7,0,3,3,0.763097,0.381056,0.000973,"#ffb800"
710157785,LauraNLezcano,31,0,1,1,0.630165,0.503596,0,"#3e93ff"
710540023,P__glamour,14,0,1,1,0.40545,0.527777,0,"#00eeff"
711113234,nomastonteras,21,0,1,1,0.499028,0.946558,0,"#c6cc85"
711445212,RevistaColoquio,49,2,0,2,0.397933,0.563515,0.000486,"#ff7007"
712595004,ArchivoHUR,37,38,8,46,0.597621,0.428143,0.021887,"#006032"
712928460,PilarM5,8,0,1,1,0.275416,0.262564,0,"#00ed5d"
712933657,damatapada,0,0,2,2,0.644597,0.621711,0.000486,"#8ecfec"
712964886,TeoGarciP,15,0,2,2,0.593473,0.694792,0.000486,"#008ebb"
713095106,paoaragonrivas,49,1,0,1,0.32688,0.665131,0,"#ff7007"
713185957,panatenaico,15,0,8,8,0.482323,0.520518,0.003405,"#008ebb"
713817882,u_henny,34,8,0,8,0.487801,0.492698,0.003405,"#ff0d69"
713965897,amgiralt,22,0,2,2,0.529994,0.492144,0.000486,"#00e8b2"
714273265,thevisualagency,13,0,1,1,0.312062,0.373031,0,"#3bec00"
714418874,socialtic,13,4,4,8,0.478939,0.463603,0.003405,"#3bec00"
714995149,jorgetrujillob,7,0,1,1,0.421195,0.320368,0,"#ffb800"
715143889,marintencionado,19,0,2,2,0.619278,0.456663,0.000486,"#00d3ff"
716351364,angelaherrejon,37,0,2,2,0.688136,0.358515,0.000486,"#006032"
716379432,Jesica_noticias,41,3,3,6,0.362718,0.382534,0.002432,"#697b00"
716468178,A_Machado_R,19,1,0,1,0.692294,0.7792,0,"#00d3ff"
716856831,jimecozza,49,1,0,1,0.341169,0.613564,0,"#ff7007"
716951804,ju_anacronica,49,1,1,2,0.407332,0.449454,0.000486,"#ff7007"
717130177,Staphylu,38,0,1,1,0.612513,0.369591,0,"#662859"
717886848,CSecundaria,30,0,2,2,0.520599,0.60391,0.000486,"#ff77ff"
717967304,OriolMD,13,0,1,1,0.430151,0.490289,0,"#3bec00"
718070102,embavenezSV,49,1,0,1,0.346503,0.611525,0,"#ff7007"
718166779,gabe_solis,34,0,2,2,0.341893,0.428194,0.000486,"#ff0d69"
718533691,netaz16,13,0,10,10,0.454041,0.416768,0.004377,"#3bec00"
718867890,Luissanz873,38,0,1,1,0.713453,0.577706,0,"#662859"
718933044,arqrosafelix,30,0,1,1,0.620699,0.663312,0,"#ff77ff"
719196147,lamalajuliana,3,0,1,1,0.419567,0.745762,0,"#ffb3ff"
719745056,FdezMallo,10,1,3,4,0.427265,0.484508,0.001459,"#52d7c0"
719791082,unedbarcelona,30,2,0,2,0.511478,0.609705,0.000486,"#ff77ff"
720186248,marciobdsilva,36,3,0,3,0.471023,0.428134,0.000973,"#825403"
720667363,educaendigital,0,1,1,2,0.22429,0.608931,0.000486,"#8ecfec"
720754110,FORCE11rescomm,49,11,2,13,0.463282,0.533005,0.005837,"#ff7007"
720978318,GusTribino,38,0,1,1,0.444184,0.781384,0,"#662859"
721303740,flargocaballero,19,1,0,1,0.592198,0.780476,0,"#00d3ff"
721428048,UsinadelArte,49,4,0,4,0.47652,0.577019,0.001459,"#ff7007"
722159041,PanamaPuntoCom,49,1,0,1,0.422388,0.664364,0,"#ff7007"
722835024,Anapassau,22,1,0,1,0.611429,0.699313,0,"#00e8b2"
723213948,fariasmlaura,1,0,6,6,0.604028,0.572031,0.002432,"#b6cb00"
724160432,Digiculturizar,3,0,1,1,0.608312,0.709653,0,"#ffb3ff"
724824990,Postmaquina,13,3,13,16,0.499326,0.503365,0.007296,"#3bec00"
726752450,RoigIgnacio,49,1,0,1,0.341417,0.63801,0,"#ff7007"
726831522,JuanCar2869,37,0,1,1,0.65515,0.376612,0,"#006032"
727004676,javikiev,49,0,1,1,0.752703,0.784346,0,"#ff7007"
727077372,maricarmenvz,17,0,1,1,0.90953,0.354787,0,"#ff9cc7"
728526132,JuanLeon1964,40,0,1,1,0.648288,0.027959,0,"#ff12a3"
729404478,NasserABDELLI,13,0,3,3,0.382591,0.35499,0.000973,"#3bec00"
729816362,carlosmarcialt,0,0,5,5,0.579068,0.319211,0.001946,"#8ecfec"
731284272,CEHBA,49,1,0,1,0.35791,0.628339,0,"#ff7007"
731549671,balimurcia,49,1,0,1,0.321533,0.611715,0,"#ff7007"
731927725,ErikaBsumek,34,0,2,2,0.339157,0.424063,0.000486,"#ff0d69"
733092900,DARIAHeu,30,72,11,83,0.509275,0.503035,0.039883,"#ff77ff"
733354165,Comunidad_UNAM,7,0,2,2,0.561898,0.320376,0.000486,"#ffb800"
733487125,pablomurciap,3,0,1,1,0.498384,0.758008,0,"#ffb3ff"
733704715,Kindle_Authors,55,1,0,1,0.63896,0.555419,0,"#cb3f32"
734283908,CaroEAlonso,41,0,1,1,0.373668,0.403585,0,"#697b00"
734492658,AnaNieva4,1,0,6,6,0.527534,0.566621,0.002432,"#b6cb00"
734745522,LianaEHE,49,1,0,1,0.311495,0.678731,0,"#ff7007"
735321360,rrh1968,38,0,3,3,0.583423,0.536254,0.000973,"#662859"
735737516,ErnestRunner,4,0,1,1,0.878962,0.236632,0,"#f4c8cf"
737802624,RedSolidariAnim,49,1,0,1,0.380497,0.625694,0,"#ff7007"
738801518,rafaelmcortina,0,2,3,5,0.437754,0.5652,0.001946,"#8ecfec"
738972350,DrDavidCooper,36,0,1,1,0.58445,0.390827,0,"#825403"
739132850,javierfcosoria,16,0,2,2,0.936063,0.657866,0.000486,"#c42c63"
739521302,AdrianaValdes8,21,1,1,2,0.35005,0.453076,0.000486,"#c6cc85"
741177482,carmen_mejia_s,31,0,1,1,0.642019,0.511461,0,"#3e93ff"
741219996,radiounr,49,0,1,1,0.318379,0.567293,0,"#ff7007"
741359996,LaNubeBLU,38,1,0,1,0.680054,0.489563,0,"#662859"
741575300,loyolahistdept,41,10,0,10,0.384697,0.372235,0.004377,"#697b00"
741806328,DonRanas,46,0,1,1,0.496157,0.147814,0,"#403538"
741821887,FriidaMh3,41,0,4,4,0.386955,0.410461,0.001459,"#697b00"
742896008,FilosofiaUP,22,9,2,11,0.771826,0.323577,0.004864,"#00e8b2"
743001282,c_regl,22,0,1,1,0.910376,0.757687,0,"#00e8b2"
743775992,UNAM_Historicas,13,41,4,45,0.453399,0.440218,0.021401,"#3bec00"
743987773,JonathanHsy,34,0,4,4,0.459856,0.483745,0.001459,"#ff0d69"
744181334,GWDHI,36,0,1,1,0.575981,0.41545,0,"#825403"
745770199,CEEColmex,7,4,2,6,0.461706,0.364332,0.002432,"#ffb800"
745842302,TERE_MIDELEGA,37,0,1,1,0.37923,0.319568,0,"#006032"
746271228,franklintc1,49,1,0,1,0.325426,0.65446,0,"#ff7007"
746349212,pauechev,21,0,1,1,0.19922,0.215937,0,"#c6cc85"
746829750,ARMH_Memoria,19,1,0,1,0.601072,0.785366,0,"#00d3ff"
747512432,Pennypol,58,0,2,2,0.600107,0.302657,0.000486,"#005076"
747834186,oscar_parrac,34,0,1,1,0.61211,0.317457,0,"#ff0d69"
748018813,theWinnower,13,1,2,3,0.530544,0.447297,0.000973,"#3bec00"
749522000,DJWrisley,49,34,27,61,0.483446,0.482636,0.029183,"#ff7007"
749686442,722Alexis,14,0,2,2,0.567223,0.596222,0.000486,"#00eeff"
750115159,Fran53458223,7,0,1,1,0.402448,0.725305,0,"#ffb800"
750445566,HdezDel,40,0,1,1,0.579198,0.03923,0,"#ff12a3"
750498206,jobpricecosc,49,1,0,1,0.376048,0.668914,0,"#ff7007"
752441527,H_R_A_S,13,0,3,3,0.444938,0.439294,0.000973,"#3bec00"
752592228,evaceliarod,49,1,0,1,0.411394,0.652539,0,"#ff7007"
753120432,ARodLopez_,58,0,1,1,0.454751,0.640292,0,"#005076"
753366439,robotmonstruo,38,0,1,1,0.608043,0.355261,0,"#662859"
754088335,MyriamEspindola,49,1,2,3,0.430187,0.562869,0.000973,"#ff7007"
754363038,RaigozaBeatriz,3,0,1,1,0.488046,0.745522,0,"#ffb3ff"
754559676,ActuExtereo,37,1,0,1,0.533442,0.228186,0,"#006032"
755153749,KarlaJimena02,3,0,1,1,0.44779,0.766996,0,"#ffb3ff"
755638632,MaqrollGarcia,30,0,1,1,0.615538,0.675071,0,"#ff77ff"
757513766,CatemacoVeracru,10,0,2,2,0.308025,0.474445,0.000486,"#52d7c0"
758266808,Superalitita,49,1,0,1,0.383208,0.67636,0,"#ff7007"
758650820,natelsonsouz,36,0,4,4,0.531413,0.422536,0.001459,"#825403"
759068652,AntiquityJ,4,0,1,1,0.361855,0.440191,0,"#f4c8cf"
759276504,efreyre2,30,0,1,1,0.584285,0.676802,0,"#ff77ff"
759328052,AskMuseo,30,0,2,2,0.577526,0.65832,0.000486,"#ff77ff"
759561529,scannopolis,49,11,4,15,0.461873,0.510912,0.006809,"#ff7007"
759574526,fbetancortreyes,14,0,2,2,0.60964,0.677287,0.000486,"#00eeff"
760165981,IFLALAC,14,4,2,6,0.532142,0.495773,0.002432,"#00eeff"
760334054,priscomgc,14,0,2,2,0.432276,0.536448,0.000486,"#00eeff"
761159640,ceterio,36,9,6,15,0.423627,0.394505,0.006809,"#825403"
761898876,vasmujo,13,0,1,1,0.460943,0.237023,0,"#3bec00"
762345164,AsambleaSV,7,1,0,1,0.795713,0.609774,0,"#ffb800"
762597577,Lavits_,36,0,1,1,0.479623,0.209233,0,"#825403"
763952581,svilardyq,34,0,1,1,0.592882,0.320008,0,"#ff0d69"
764265590,siquieresmelees,21,0,2,2,0.240729,0.257005,0.000486,"#c6cc85"
764288696,_otroSebastian,3,0,1,1,0.48609,0.755601,0,"#ffb3ff"
764902788,wikipt,36,1,2,3,0.532321,0.297934,0.000973,"#825403"
766204621,juliorogero,40,0,1,1,0.633309,0.024486,0,"#ff12a3"
767206208,caec_espinoza,22,0,2,2,0.546621,0.630376,0.000486,"#00e8b2"
769226372,PaCuCoAragones,30,0,3,3,0.53851,0.607198,0.000973,"#ff77ff"
769579399,clia_g,0,0,9,9,0.497937,0.59308,0.003891,"#8ecfec"
769694005,DanielSalinas00,4,2,3,5,0.47235,0.489343,0.001946,"#f4c8cf"
770114930,_anitapast,19,6,0,6,0.631167,0.761093,0.002432,"#00d3ff"
770404915,formacionasuniv,58,0,1,1,0.791141,0.570704,0,"#005076"
770509489,CarlosFVasquezG,30,0,1,1,0.462471,0.602656,0,"#ff77ff"
771551934,AnpuhRS,36,2,0,2,0.493689,0.329444,0.000486,"#825403"
772503966,MafeOrtizBecerr,49,1,0,1,0.366452,0.671203,0,"#ff7007"
772569692,soynefelibato,14,0,2,2,0.527928,0.4797,0.000486,"#00eeff"
773252293,PeFuCas,49,1,0,1,0.316093,0.63725,0,"#ff7007"
774013213,ManuelRuizAdame,1,1,2,3,0.466329,0.526196,0.000973,"#b6cb00"
774252348,BiotecBienEstar,43,0,1,1,0.867916,0.555963,0,"#fcae7e"
774297944,alidamayne,49,0,3,3,0.388672,0.428764,0.000973,"#ff7007"
774426811,AndyAreynolds,13,1,3,4,0.447093,0.470689,0.001459,"#3bec00"
776322404,SC3UIS,34,4,5,9,0.60939,0.230459,0.003891,"#ff0d69"
777855859,Bochancita,33,0,1,1,0.246648,0.621388,0,"#ff8c00"
778011846,AngelTorresSnch,15,0,2,2,0.601093,0.522593,0.000486,"#008ebb"
778084398,etitulo,22,0,1,1,0.855039,0.752202,0,"#00e8b2"
778206032,sgrivadeneira,8,0,1,1,0.493988,0.804288,0,"#00ed5d"
779173472,jhestradam,3,0,1,1,0.492006,0.776472,0,"#ffb3ff"
779948652,einfachcool1,13,0,1,1,0.391531,0.494187,0,"#3bec00"
780425474,FrancescPedroED,31,4,0,4,0.597578,0.483596,0.001459,"#3e93ff"
780799057,conchisirvent,30,0,9,9,0.526121,0.570867,0.003891,"#ff77ff"
781170002,elenayayi,49,1,0,1,0.394469,0.653822,0,"#ff7007"
781605720,djherreram,10,6,1,7,0.401961,0.377981,0.002918,"#52d7c0"
781798356,maurocampo09,3,0,1,1,0.458617,0.741839,0,"#ffb3ff"
782425058,JosCarlosGmez7,14,0,1,1,0.322096,0.555504,0,"#00eeff"
782666660,95_roni,19,3,10,13,0.646712,0.730858,0.005837,"#00d3ff"
782851686,urrutiaconcejal,2,0,1,1,0.681642,0.380953,0,"#ffa64e"
783268086,camiymomo,49,0,1,1,0.178177,0.632695,0,"#ff7007"
784691708,derecho_uaq,13,2,0,2,0.382882,0.492951,0.000486,"#3bec00"
785239554,ConnectBogota,49,1,0,1,0.427149,0.657273,0,"#ff7007"
785311214,dgraficoandina,9,0,4,4,0.629921,0.516685,0.001459,"#008f7b"
785339821,LancsDigHum,4,10,14,24,0.483385,0.485687,0.011187,"#f4c8cf"
785756804,CorreaMaLeticia,36,0,7,7,0.504593,0.354683,0.002918,"#825403"
786658802,eniubo,0,1,0,1,0.525516,0.400958,0,"#8ecfec"
786967358,glass_grant,30,0,3,3,0.484711,0.520398,0.000973,"#ff77ff"
787082000,dara_info,36,0,1,1,0.549313,0.624771,0,"#825403"
787235358,estebantecno7,8,1,0,1,0.292212,0.679475,0,"#00ed5d"
787373431,Dominic_Bergman,36,0,1,1,0.441455,0.59451,0,"#825403"
787522873,sam85_9,3,0,1,1,0.43739,0.748782,0,"#ffb3ff"
787702321,EstoriadEspanna,30,1,5,6,0.482082,0.530142,0.002432,"#ff77ff"
787752828,sarapalvarez,41,0,2,2,0.413276,0.406997,0.000486,"#697b00"
787869678,JCCavallero,7,0,4,4,0.443945,0.411233,0.001459,"#ffb800"
787932224,hiperderecho,13,1,0,1,0.430821,0.629769,0,"#3bec00"
788379716,maquis28,19,1,0,1,0.668829,0.773186,0,"#00d3ff"
788818664,LaVozdeAlcala_,1,1,0,1,0.438403,0.641602,0,"#b6cb00"
789503900,antigua_roma,2,35,0,35,0.636762,0.449162,0.016537,"#ffa64e"
789534272,CCESantiago,21,0,1,1,0.172444,0.204242,0,"#c6cc85"
789685158,MaribelMatanza,35,0,1,1,0.733677,0.417489,0,"#00faff"
789908905,ZozayaMaria,22,7,9,16,0.525709,0.506374,0.007296,"#00e8b2"
790036196,RBTothAssociate,14,3,0,3,0.363187,0.431292,0.000973,"#00eeff"
790089560,4sWeb,49,2,1,3,0.378249,0.475714,0.000973,"#ff7007"
790166647,RobertoValero6,49,1,0,1,0.304462,0.625611,0,"#ff7007"
790360285,llbaker1707,34,0,2,2,0.508655,0.394159,0.000486,"#ff0d69"
790412708,UCESVirtual,49,4,0,4,0.445332,0.528888,0.001459,"#ff7007"
790439281,German05Ramirez,42,0,4,4,0.74185,0.433876,0.001459,"#66e087"
791971134,Ladiezradio,49,1,0,1,0.362865,0.683114,0,"#ff7007"
792729032,KuroOokamiSama,13,0,1,1,0.500688,0.308616,0,"#3bec00"
793034323,JanetGGA,13,0,1,1,0.424697,0.427993,0,"#3bec00"
793674642,giulia_taurino,49,0,1,1,0.409323,0.522959,0,"#ff7007"
793680038,lourdesprades,30,1,0,1,0.471952,0.793936,0,"#ff77ff"
793947324,montesdeocapl,22,0,2,2,0.319864,0.732308,0.000486,"#00e8b2"
794111803,SpaDiSyn,14,0,1,1,0.313087,0.704697,0,"#00eeff"
794962825,CallMeYuna_,41,0,1,1,0.256159,0.339501,0,"#697b00"
795094333,LuvianoLupita,3,0,1,1,0.501927,0.807931,0,"#ffb3ff"
796967083,luciiiarojas,31,0,1,1,0.622737,0.596083,0,"#3e93ff"
797541242,cesartavo_,34,0,2,2,0.540795,0.38733,0.000486,"#ff0d69"
797606144,kuroshiroAD,30,0,1,1,0.61447,0.483449,0,"#ff77ff"
798394423,kaluapiscis,2,0,1,1,0.659522,0.645518,0,"#ffa64e"
799546034,homoplatos,7,0,1,1,0.814805,0.55301,0,"#ffb800"
800204574,rafasarralde,31,0,2,2,0.576122,0.597591,0.000486,"#3e93ff"
800830944,unedcoma,30,1,0,1,0.537202,0.663306,0,"#ff77ff"
801209570,LaPrimera889,49,1,0,1,0.291912,0.637965,0,"#ff7007"
801783660,AyralAngel,13,0,1,1,0.494411,0.3149,0,"#3bec00"
801916482,JEEGut,34,0,6,6,0.479583,0.439956,0.002432,"#ff0d69"
802403863,DISCuniandes,38,1,1,2,0.689251,0.4117,0.000486,"#662859"
802777862,maria_yubero,22,1,0,1,0.529951,0.686058,0,"#00e8b2"
803435317,alegrimson,49,1,0,1,0.348229,0.679557,0,"#ff7007"
803785105,silviajustinaca,30,0,1,1,0.61457,0.657159,0,"#ff77ff"
804047612,ScolarTIC,3,1,1,2,0.485597,0.712925,0.000486,"#ffb3ff"
804125887,GrauCIC_UB,30,4,2,6,0.594223,0.646404,0.002432,"#ff77ff"
805711332,RubenVL_7,13,0,1,1,0.386109,0.491882,0,"#3bec00"
806626152,aloba67,30,0,7,7,0.527532,0.575252,0.002918,"#ff77ff"
807163556,uniovi_info,22,0,1,1,0.663642,0.597923,0,"#00e8b2"
807411919,fcsudelar,55,25,0,25,0.665495,0.646777,0.011673,"#cb3f32"
807511327,hild_de,36,0,2,2,0.423821,0.512708,0.000486,"#825403"
807648726,AECTUIT,22,0,1,1,0.369419,0.200518,0,"#00e8b2"
808451894,Buco_es,30,0,2,2,0.534837,0.611212,0.000486,"#ff77ff"
808943102,RedLGC,13,5,0,5,0.476485,0.462679,0.001946,"#3bec00"
809504210,GonzaloVegaMX,41,0,1,1,0.257669,0.344082,0,"#697b00"
809583912,camilopunto,38,0,1,1,0.733575,0.37842,0,"#662859"
811023956,Le_TIC,49,0,2,2,0.456937,0.599454,0.000486,"#ff7007"
811485997,AdelaVV,22,1,1,2,0.691671,0.542414,0.000486,"#00e8b2"
811718696,alfgonsorobles,22,0,1,1,0.281223,0.652284,0,"#00e8b2"
812010895,OsvaldoOba2007,49,1,0,1,0.362816,0.668427,0,"#ff7007"
812097685,TrilceAldeano,49,1,0,1,0.372162,0.657169,0,"#ff7007"
812380152,juliadavila__,34,0,3,3,0.397194,0.450265,0.000973,"#ff0d69"
812765426,alcazar_miguel,19,0,1,1,0.677255,0.793191,0,"#00d3ff"
813078852,adrianacorreav,38,5,0,5,0.670482,0.414691,0.001946,"#662859"
813222199,sergemont,34,7,1,8,0.54885,0.306108,0.003405,"#ff0d69"
813345582,IdaisOrozco1,42,0,5,5,0.69848,0.452175,0.001946,"#66e087"
813660854,MaiteTurandot,30,0,1,1,0.515723,0.659098,0,"#ff77ff"
815041855,AngelinaCostaP,30,0,1,1,0.613789,0.566198,0,"#ff77ff"
815119620,IGeociencias,22,4,1,5,0.550326,0.577614,0.001946,"#00e8b2"
815653964,eScire_MX,13,2,0,2,0.407529,0.313917,0.000486,"#3bec00"
816157441,Letra_zeta,1,0,2,2,0.458442,0.61001,0.000486,"#b6cb00"
816195325,HDellOnte,49,1,0,1,0.31355,0.676378,0,"#ff7007"
816258002,GarciaReidy,58,17,12,29,0.512743,0.536107,0.013619,"#005076"
817226966,EINAunizar,37,1,0,1,0.436943,0.743684,0,"#006032"
817406832,leticiatobalina,35,27,24,51,0.544224,0.491387,0.024319,"#00faff"
817736070,TalaiosKoop,36,0,1,1,0.342431,0.150805,0,"#825403"
817925767,angie_izz,7,0,1,1,0.414207,0.312979,0,"#ffb800"
817969393,MarinaMario2,37,1,0,1,0.568741,0.359146,0,"#006032"
818229818,plebeyoardiente,7,0,1,1,0.782815,0.626024,0,"#ffb800"
818355990,Frecuenc1as,34,0,2,2,0.466708,0.401433,0.000486,"#ff0d69"
818617891,abrego_s,13,0,1,1,0.503866,0.313412,0,"#3bec00"
819369228,ThiagoKrause2,36,10,0,10,0.516853,0.330226,0.004377,"#825403"
819809576,24clm,30,10,1,11,0.519119,0.612626,0.004864,"#ff77ff"
820774502,DenisRBara,38,0,1,1,0.091062,0.423241,0,"#662859"
821814254,UofT,13,5,0,5,0.518953,0.47985,0.001946,"#3bec00"
821868907,ana_me_so,49,1,0,1,0.309184,0.638802,0,"#ff7007"
822207002,Mariaemiliacor7,49,2,3,5,0.445932,0.606922,0.001946,"#ff7007"
822314004,Montequinto_,49,1,0,1,0.336664,0.666386,0,"#ff7007"
822369152,daviddiaz1827,3,0,1,1,0.457887,0.753379,0,"#ffb3ff"
822922795,MariaRodrim,22,0,1,1,0.563357,0.681197,0,"#00e8b2"
823081291,Miguel_GciaFdez,22,0,2,2,0.494802,0.595595,0.000486,"#00e8b2"
823443997,l_casal,55,2,2,4,0.357663,0.545145,0.001459,"#cb3f32"
823473655,Juanillo5401,13,0,1,1,0.40501,0.490669,0,"#3bec00"
823491859,vera_baltanas,30,0,1,1,0.520486,0.633052,0,"#ff77ff"
823591849,teodora76279859,38,0,2,2,0.59158,0.349974,0.000486,"#662859"
823702658,LAM_UAMX,49,0,2,2,0.423872,0.563423,0.000486,"#ff7007"
823791758,DefiningDH,49,0,3,3,0.502069,0.577821,0.000973,"#ff7007"
824121013,AcostMariela,8,0,1,1,0.356649,0.785299,0,"#00ed5d"
824834964,miren666,30,0,2,2,0.547483,0.596192,0.000486,"#ff77ff"
825551635,clauparquet,37,0,1,1,0.192598,0.482222,0,"#006032"
826176656,Ary_Earth,17,0,1,1,0.828848,0.233424,0,"#ff9cc7"
826321946,GERMANR91690712,3,0,1,1,0.509275,0.745788,0,"#ffb3ff"
827709104,CoordInformUAB,14,0,1,1,0.667589,0.576036,0,"#00eeff"
831183949,arsioli,36,0,2,2,0.54117,0.255691,0.000486,"#825403"
831204896,ferotecas,40,0,1,1,0.569616,0.029046,0,"#ff12a3"
831481729,OEITIC,31,0,2,2,0.529335,0.504756,0.000486,"#3e93ff"
831489060,ludictador,0,0,1,1,0.356308,0.548519,0,"#8ecfec"
831926436,DanielMig19,14,0,1,1,0.435661,0.572228,0,"#00eeff"
832077860,SantistebanKari,31,0,2,2,0.57629,0.528385,0.000486,"#3e93ff"
832280756,guio_oz,0,0,1,1,0.434462,0.385012,0,"#8ecfec"
832651687,AntropologiaGC,22,0,5,5,0.548486,0.553933,0.001946,"#00e8b2"
833083644,blasgarzon,30,0,3,3,0.472862,0.591181,0.000973,"#ff77ff"
833414754,KChatlosh,34,5,13,18,0.461579,0.433989,0.008268,"#ff0d69"
833479501,asumapaz,38,0,1,1,0.656317,0.36369,0,"#662859"
833614171,UMETeduar,49,15,4,19,0.469038,0.53823,0.008755,"#ff7007"
833619990,psycoinnovacom,1,0,5,5,0.599297,0.542142,0.001946,"#b6cb00"
833777688,guida_ramos2,36,1,9,10,0.513275,0.417959,0.004377,"#825403"
834024962,CatalinaAlou,15,0,1,1,0.661879,0.43694,0,"#008ebb"
834268088,ELEdeLeyre,14,0,8,8,0.528037,0.591433,0.003405,"#00eeff"
834831859,garciacontto,31,0,6,6,0.606804,0.553018,0.002432,"#3e93ff"
835427976,dri_ireland,36,0,2,2,0.466303,0.579952,0.000486,"#825403"
835728476,ksolano82,8,0,1,1,0.270524,0.25202,0,"#00ed5d"
835823304,AsociacionBETA,14,8,21,29,0.51784,0.512241,0.013619,"#00eeff"
837582084,RuizIsern,8,1,0,1,0.664913,0.255207,0,"#00ed5d"
837728172,TinaCuore,1,0,11,11,0.571875,0.446255,0.004864,"#b6cb00"
837963386,Onedirect_Es,49,2,0,2,0.443305,0.586843,0.000486,"#ff7007"
838360322,AdhikArrilucea,19,0,1,1,0.67337,0.840365,0,"#00d3ff"
839492940,desy_starlight,2,0,2,2,0.682841,0.653425,0.000486,"#ffa64e"
840223730,mangelquevedo,16,0,2,2,0.922097,0.680346,0.000486,"#c42c63"
840272348,Ignasi_Adiego,22,0,1,1,0.544523,0.645626,0,"#00e8b2"
840532310,thstraka,35,13,1,14,0.655545,0.430325,0.006323,"#00faff"
840956233,gallo_orlando,38,0,1,1,0.332704,0.17557,0,"#662859"
842385139,danielchapa82,34,0,3,3,0.480881,0.433163,0.000973,"#ff0d69"
842608134,LizzyLaurie,36,0,1,1,0.488439,0.283521,0,"#825403"
843070014,crismigo,49,3,0,3,0.426641,0.546148,0.000973,"#ff7007"
843144806,sexenios,31,2,0,2,0.734599,0.571428,0.000486,"#3e93ff"
843240109,UNIGISGirona,22,6,0,6,0.592987,0.543452,0.002432,"#00e8b2"
843900696,ibiriro,34,0,1,1,0.393621,0.460576,0,"#ff0d69"
844560350,kipus1,49,1,0,1,0.367378,0.662175,0,"#ff7007"
844587133,juanchocruz12,49,0,1,1,0.549472,0.434945,0,"#ff7007"
845136698,LlanosTobarra,30,0,11,11,0.534225,0.568952,0.004864,"#ff77ff"
846038257,IAlecha,1,0,2,2,0.672648,0.45228,0.000486,"#b6cb00"
846046160,HistArchChester,4,0,1,1,0.504832,0.373727,0,"#f4c8cf"
846062232,ceil_conicet,49,1,0,1,0.400862,0.624879,0,"#ff7007"
846256874,ihbcn,22,1,0,1,0.503403,0.68148,0,"#00e8b2"
846334267,crismartinpuent,58,0,1,1,0.598357,0.63925,0,"#005076"
847325940,guillermoesnal,31,0,1,1,0.65347,0.569398,0,"#3e93ff"
847548169,shoggoth_roof,37,0,5,5,0.59488,0.569295,0.001946,"#006032"
847665854,AtEmprendedores,8,0,1,1,0.22901,0.265334,0,"#00ed5d"
848079992,alumnosucm,19,1,0,1,0.643725,0.782276,0,"#00d3ff"
848138875,javi_cubillas,49,7,1,8,0.698898,0.732352,0.003405,"#ff7007"
848395262,Pelustratokinde,1,0,2,2,0.530957,0.61759,0.000486,"#b6cb00"
848503326,katrina_cp,34,0,1,1,0.350873,0.434376,0,"#ff0d69"
849019608,cdesevilla,1,1,0,1,0.247006,0.584063,0,"#b6cb00"
849125988,aliciapeaker,57,0,2,2,0.710574,0.531329,0.000486,"#b66f7a"
850037802,ASATI_ES,14,0,2,2,0.573955,0.552087,0.000486,"#00eeff"
851237132,aldanaAlemilar,34,0,3,3,0.471,0.41731,0.000973,"#ff0d69"
851371795,flacoromanuk,49,1,0,1,0.295846,0.649931,0,"#ff7007"
851928439,ETCLatUVic,36,1,1,2,0.512577,0.323173,0.000486,"#825403"
852357576,franmassot,7,0,1,1,0.84048,0.551645,0,"#ffb800"
852640309,OrquestaUMU,22,1,2,3,0.671998,0.727881,0.000973,"#00e8b2"
854071338,inah_tv,13,1,0,1,0.408617,0.292511,0,"#3bec00"
854459400,Selegna27499890,40,0,1,1,0.650326,0.029919,0,"#ff12a3"
854587268,MencheAstur,19,11,11,22,0.615665,0.74116,0.010214,"#00d3ff"
855308119,Buscameblog,19,6,32,38,0.627877,0.68932,0.017996,"#00d3ff"
855308834,orientacastulo,8,0,2,2,0.345303,0.528144,0.000486,"#00ed5d"
855313903,positivepepe,14,0,3,3,0.475613,0.572521,0.000973,"#00eeff"
855809316,Carl0sReyes,34,0,15,15,0.476812,0.434196,0.006809,"#ff0d69"
856152912,MemoriasenRed,30,1,0,1,0.585446,0.570538,0,"#ff77ff"
856560396,JimMc_Grath,49,0,3,3,0.414492,0.453035,0.000973,"#ff7007"
856787564,Domicialucida,22,0,10,10,0.515347,0.504186,0.004377,"#00e8b2"
856913256,PaquiDark,37,0,3,3,0.546643,0.528517,0.000973,"#006032"
857648287,SilviaArano,30,0,8,8,0.512332,0.545317,0.003405,"#ff77ff"
857691266,laBnF,7,1,0,1,0.390051,0.290846,0,"#ffb800"
857836315,becasMEX,1,2,6,8,0.43201,0.544554,0.003405,"#b6cb00"
857917802,UB_IL3,49,1,0,1,0.332487,0.64828,0,"#ff7007"
858006601,crisblabue,14,0,1,1,0.480684,0.285311,0,"#00eeff"
858089791,Frantiento,22,0,10,10,0.521726,0.553732,0.004377,"#00e8b2"
858349830,DCH_DC,36,0,1,1,0.379894,0.482882,0,"#825403"
858453506,D_Ri88,13,0,3,3,0.484791,0.428025,0.000973,"#3bec00"
858696079,WendytheDH,34,0,3,3,0.455986,0.439431,0.000973,"#ff0d69"
858719593,DistArtes,49,1,0,1,0.417303,0.693987,0,"#ff7007"
859356090,josejuanarranz,58,0,1,1,0.554226,0.167275,0,"#005076"
859572384,MarianoCres,49,1,0,1,0.352948,0.624533,0,"#ff7007"
859580269,ICManchester,1,0,1,1,0.429153,0.713891,0,"#b6cb00"
859995816,GalloAlgebraico,13,0,15,15,0.479401,0.478166,0.006809,"#3bec00"
860109943,lacalledelasoci,41,1,2,3,0.334728,0.312937,0.000973,"#697b00"
860116921,27edualipa,4,0,1,1,0.862695,0.251233,0,"#f4c8cf"
860207720,IAalFuturo,49,1,0,1,0.369703,0.638836,0,"#ff7007"
861012408,soytowanda,38,0,1,1,0.276341,0.630036,0,"#662859"
861045229,wlesmen,38,0,1,1,0.585525,0.348152,0,"#662859"
861097886,InmaLuanco,1,0,1,1,0.423706,0.795051,0,"#b6cb00"
861121453,42MadridFTef,0,7,3,10,0.438233,0.538635,0.004377,"#8ecfec"
861148796,EulogioMR,22,1,5,6,0.522144,0.611926,0.002432,"#00e8b2"
861177481,umhsapiens,22,0,3,3,0.649903,0.393709,0.000973,"#00e8b2"
861213698,AlcazabaAlmeria,14,0,2,2,0.621719,0.501783,0.000486,"#00eeff"
861403758,CienciaUCHCEU,31,0,2,2,0.697863,0.421138,0.000486,"#3e93ff"
861792282,Fenix_Liberal,58,0,1,1,0.592189,0.169776,0,"#005076"
862108423,comunidad_eme,49,1,0,1,0.333669,0.671966,0,"#ff7007"
862391946,maynor_alvarado,57,0,3,3,0.654915,0.498623,0.000973,"#b66f7a"
862616520,inakiformacion,49,3,0,3,0.369938,0.587981,0.000973,"#ff7007"
862729148,UOCeimt,37,5,2,7,0.627016,0.328722,0.002918,"#006032"
862857254,LinguaLingua,49,1,0,1,0.387353,0.617193,0,"#ff7007"
863005010,radioalpilon,24,0,1,1,0.269242,0.641521,0,"#ff9b8f"
863241644,Deob71,22,1,6,7,0.597018,0.62746,0.002918,"#00e8b2"
863471354,claumarher,21,0,1,1,0.232074,0.203524,0,"#c6cc85"
863803430,rizzo_pubhist,34,0,4,4,0.428188,0.443717,0.001459,"#ff0d69"
864206418,ProfeLuisR,37,0,1,1,0.316689,0.505608,0,"#006032"
864460226,angallego_,14,6,6,12,0.385208,0.657132,0.00535,"#00eeff"
864463280,ALTRACARA,8,0,1,1,0.246911,0.260868,0,"#00ed5d"
864900541,pedrojulianrm,31,0,3,3,0.620924,0.556356,0.000973,"#3e93ff"
864933529,ClassicsIreland,30,0,1,1,0.514398,0.626742,0,"#ff77ff"
865751406,Susyta29,22,0,2,2,0.587292,0.590371,0.000486,"#00e8b2"
865761414,GregCruzm,13,0,2,2,0.447046,0.418593,0.000486,"#3bec00"
865871990,llavordesaberut,15,0,3,3,0.572873,0.524594,0.000973,"#008ebb"
865971338,digicademy,36,2,0,2,0.544959,0.519844,0.000486,"#825403"
866568126,darioldc,49,3,0,3,0.427802,0.597424,0.000973,"#ff7007"
866636178,Bolchiro_Books,0,1,1,2,0.65327,0.53217,0.000486,"#8ecfec"
866767268,sonesc2013,22,0,1,1,0.603111,0.614034,0,"#00e8b2"
866823830,claramolerop,1,0,2,2,0.44828,0.700692,0.000486,"#b6cb00"
866898811,Anafeliz354,13,0,2,2,0.446851,0.429568,0.000486,"#3bec00"
866952014,I_Mitxitorena,1,0,2,2,0.659676,0.451562,0.000486,"#b6cb00"
866974772,DafneConchaF,0,0,2,2,0.449338,0.383656,0.000486,"#8ecfec"
867445728,AndresCamargoB1,13,0,1,1,0.406965,0.426475,0,"#3bec00"
867527137,Lidia_Bocanegra,31,61,38,99,0.565894,0.545726,0.047665,"#3e93ff"
867574753,RinconBioGeo,14,0,1,1,0.471128,0.284387,0,"#00eeff"
867631994,Comillas_iuem,22,1,0,1,0.588206,0.292859,0,"#00e8b2"
867699750,peinadormarta,14,4,4,8,0.559554,0.528563,0.003405,"#00eeff"
867763046,ExpToulouse,31,0,1,1,0.672364,0.547171,0,"#3e93ff"
868097696,lilysan86,13,20,21,41,0.512657,0.456137,0.019455,"#3bec00"
868540814,CNT_Guadalajara,19,1,0,1,0.682492,0.760598,0,"#00d3ff"
868566271,BibliotecasUAQ,13,10,0,10,0.464222,0.441178,0.004377,"#3bec00"
868601726,Myriam_ff,14,15,6,21,0.470622,0.531991,0.009728,"#00eeff"
868806248,joxeali,0,0,1,1,0.387741,0.567238,0,"#8ecfec"
869594173,HeesThierry,30,0,1,1,0.64237,0.709385,0,"#ff77ff"
869779124,iris_r_alcaide,15,0,1,1,0.608177,0.560621,0,"#008ebb"
869972678,josemaenfermero,31,1,3,4,0.631439,0.519636,0.001459,"#3e93ff"
870034296,apps_tic_ei,30,0,2,2,0.563982,0.537842,0.000486,"#ff77ff"
870131646,dikingo,37,0,1,1,0.453538,0.213722,0,"#006032"
870226454,esiuclm,15,1,0,1,0.520512,0.741608,0,"#008ebb"
870548443,sombradoble,14,0,4,4,0.579453,0.542289,0.001459,"#00eeff"
870722138,Doctor_Pirata,30,1,0,1,0.53968,0.624029,0,"#ff77ff"
871141880,kuepa,3,0,1,1,0.462534,0.664607,0,"#ffb3ff"
871331719,BrandFeel,0,0,1,1,0.396167,0.555381,0,"#8ecfec"
871565748,euridice_carmen,19,0,1,1,0.647098,0.626136,0,"#00d3ff"
871568334,pilar55085453,30,0,1,1,0.531177,0.655726,0,"#ff77ff"
872098734,SeecCat,58,1,1,2,0.656724,0.567634,0.000486,"#005076"
872699562,victorrpolo,38,0,1,1,0.424292,0.758259,0,"#662859"
873297379,Rocieco,58,9,6,15,0.503162,0.608875,0.006809,"#005076"
873644258,88lamaga,49,1,0,1,0.36445,0.677524,0,"#ff7007"
874052953,NuriaEspuny,8,2,0,2,0.659316,0.260404,0.000486,"#00ed5d"
874260307,FundacionAquae,30,0,1,1,0.439172,0.694054,0,"#ff77ff"
874530494,Masofigp,38,1,2,3,0.440048,0.650651,0.000973,"#662859"
874824751,FafuC,49,1,0,1,0.336003,0.5975,0,"#ff7007"
875851338,elpobal,22,0,1,1,0.530311,0.652927,0,"#00e8b2"
875854808,collaresmi,36,0,1,1,0.501384,0.243243,0,"#825403"
876244344,JonayQuintana,14,0,2,2,0.617057,0.679744,0.000486,"#00eeff"
876335550,memoriademadrid,58,79,2,81,0.572961,0.344387,0.038911,"#005076"
876800750,Telefonica_Col,0,2,2,4,0.359358,0.576705,0.001459,"#8ecfec"
877755836,anna_kijas,36,2,3,5,0.396252,0.477813,0.001946,"#825403"
878092579,wscholger,13,1,3,4,0.452614,0.459743,0.001459,"#3bec00"
878152400,MajoAlRiv,34,0,1,1,0.567946,0.232584,0,"#ff0d69"
878326538,CQgtwtt,30,0,1,1,0.61104,0.66211,0,"#ff77ff"
878937936,shuri_any,36,0,1,1,0.454711,0.163813,0,"#825403"
879286968,TheXavivalen,40,0,1,1,0.610929,0.006757,0,"#ff12a3"
879828138,heyitsanag,38,0,1,1,0.092488,0.418534,0,"#662859"
881291916,DominicaStateCo,14,1,0,1,0.590884,0.481799,0,"#00eeff"
882346514,xicanohistorian,34,0,11,11,0.432169,0.448657,0.004864,"#ff0d69"
882645290,GobDeCoahuila,17,10,0,10,0.741283,0.738226,0.004377,"#ff9cc7"
882709832,MAmbBioquimUCLM,22,0,2,2,0.588266,0.538468,0.000486,"#00e8b2"
884217295,DolsR,30,0,1,1,0.616111,0.440343,0,"#ff77ff"
884598272,lcampossegui,49,1,0,1,0.386645,0.698872,0,"#ff7007"
884643103,Julio_GL_,49,2,0,2,0.457777,0.577925,0.000486,"#ff7007"
884928920,CarmenMSnchez,1,1,3,4,0.517377,0.520198,0.001459,"#b6cb00"
885052908,TICE_UCLM,0,0,4,4,0.51515,0.556111,0.001459,"#8ecfec"
885367284,patricioyjelena,31,0,3,3,0.552018,0.489175,0.000973,"#3e93ff"
885448748,redmatrioshka,0,0,1,1,0.359408,0.557788,0,"#8ecfec"
885806964,LinaZapataCasas,49,3,14,17,0.465731,0.507021,0.007782,"#ff7007"
886265978,SFEDS3,58,0,1,1,0.44939,0.558772,0,"#005076"
886292347,Sibhilla_UAB,14,0,3,3,0.632723,0.54446,0.000973,"#00eeff"
886413337,moriolvico,30,0,2,2,0.572704,0.660311,0.000486,"#ff77ff"
886738434,SolidaritatUB,19,0,1,1,0.657999,0.73812,0,"#00d3ff"
887001133,HumAplicadas,30,3,1,4,0.506168,0.642666,0.001459,"#ff77ff"
887100348,Ruth13L,34,0,5,5,0.387247,0.431368,0.001946,"#ff0d69"
887197122,typ3en1,7,0,1,1,0.650306,0.369491,0,"#ffb800"
887286799,RadioUV,13,1,0,1,0.357032,0.5178,0,"#3bec00"
887526282,karogoel,14,0,2,2,0.600706,0.472475,0.000486,"#00eeff"
887627858,pohesiade,22,0,1,1,0.523329,0.813263,0,"#00e8b2"
888094112,o_redonda,58,0,1,1,0.375016,0.589674,0,"#005076"
888227372,GacetaBlackout,37,0,1,1,0.707441,0.596653,0,"#006032"
888367488,UCOMILLAS,13,1,0,1,0.403528,0.479889,0,"#3bec00"
888476509,SmMixer,49,1,0,1,0.3466,0.616612,0,"#ff7007"
888516162,PoliScienceUPV,22,1,0,1,0.557155,0.636829,0,"#00e8b2"
888668334,FernandezNistal,49,1,0,1,0.326771,0.618463,0,"#ff7007"
888914514,CaSEsbcn,22,3,1,4,0.572746,0.594424,0.001459,"#00e8b2"
888971388,kuri_pablo,34,0,2,2,0.518622,0.435253,0.000486,"#ff0d69"
889240064,jcyl,22,4,0,4,0.322123,0.564944,0.001459,"#00e8b2"
889431199,oscgomeza,3,0,1,1,0.507277,0.76471,0,"#ffb3ff"
889702884,adubcovskyj,34,0,2,2,0.354068,0.436795,0.000486,"#ff0d69"
889951436,LeoVazquezC,13,1,0,1,0.56788,0.412084,0,"#3bec00"
890196978,emily_m_davis,41,0,2,2,0.343538,0.352004,0.000486,"#697b00"
891007807,cruzmosu,49,6,1,7,0.437719,0.460099,0.002918,"#ff7007"
891048242,m4bcn,22,4,8,12,0.589142,0.553493,0.00535,"#00e8b2"
891473934,gcastanyer,30,0,1,1,0.647524,0.707058,0,"#ff77ff"
891728138,JulioBorrell,49,1,0,1,0.365208,0.623263,0,"#ff7007"
892209824,panchochiroleu,30,0,1,1,0.57846,0.66886,0,"#ff77ff"
892852525,FILTRADCOMUV,31,3,3,6,0.631157,0.408177,0.002432,"#3e93ff"
893544139,profedeele,1,1,0,1,0.417712,0.741426,0,"#b6cb00"
893744982,serge_factor,13,0,1,1,0.420939,0.457076,0,"#3bec00"
894021074,IdcaranCo,13,0,3,3,0.498388,0.357351,0.000973,"#3bec00"
894920761,ANTONIACUE,30,0,2,2,0.597665,0.64134,0.000486,"#ff77ff"
895546730,ainat_89,22,0,2,2,0.599483,0.570166,0.000486,"#00e8b2"
895699740,FerdlSanz,13,0,1,1,0.399508,0.496139,0,"#3bec00"
895956164,Darck21857,38,0,1,1,0.094705,0.446091,0,"#662859"
896450874,Miguel_a_Rendon,21,0,1,1,0.272061,0.208687,0,"#c6cc85"
896594239,AlejandraMonz10,8,0,1,1,0.522651,0.790559,0,"#00ed5d"
896877487,MESHS_Lille,14,1,1,2,0.556635,0.490392,0.000486,"#00eeff"
896912448,GildaMoheno,7,0,1,1,0.642695,0.377439,0,"#ffb800"
897403544,Educaixa,49,1,0,1,0.328406,0.649715,0,"#ff7007"
897621266,Lmduran_ucv,49,0,1,1,0.343481,0.541544,0,"#ff7007"
897745196,anaritagsoares,36,0,1,1,0.613057,0.409832,0,"#825403"
898035272,ArmandoAgueroCo,13,0,1,1,0.389486,0.489406,0,"#3bec00"
898464996,AndariegosMX,7,0,1,1,0.349301,0.323997,0,"#ffb800"
898600874,ciaorugiada,49,1,0,1,0.33989,0.613672,0,"#ff7007"
899489707,montse_rius,1,0,4,4,0.47966,0.580366,0.001459,"#b6cb00"
899506260,CharlotteBRF,30,0,4,4,0.528696,0.539607,0.001459,"#ff77ff"
899612144,DigitalHumanTCD,30,0,1,1,0.435993,0.53926,0,"#ff77ff"
900114456,AnabiblioAna,49,0,2,2,0.415272,0.591597,0.000486,"#ff7007"
900268814,PocholoCastro,3,0,1,1,0.490863,0.667104,0,"#ffb3ff"
900325632,gloriaescribe,37,0,3,3,0.542556,0.555472,0.000973,"#006032"
900833238,CONADUHistorica,49,2,0,2,0.419152,0.568942,0.000486,"#ff7007"
901261938,artgizun,37,1,2,3,0.626885,0.403747,0.000973,"#006032"
901281158,ggalvezbehar,34,0,3,3,0.439565,0.450087,0.000973,"#ff0d69"
901407079,OndareBabesa,22,6,3,9,0.585084,0.652838,0.003891,"#00e8b2"
902225102,cosoproyectual,3,0,1,1,0.401693,0.760676,0,"#ffb3ff"
902704760,SharedStudios,14,0,2,2,0.668677,0.564021,0.000486,"#00eeff"
903063872,ClaudioFrescura,49,0,1,1,0.396611,0.516711,0,"#ff7007"
903249644,_trigol,21,0,2,2,0.209775,0.249458,0.000486,"#c6cc85"
903460076,Lirita_D,14,0,5,5,0.497168,0.50774,0.001946,"#00eeff"
903628440,latermicamlg,14,8,1,9,0.561189,0.548849,0.003891,"#00eeff"
903682986,Gabifcom,1,1,1,2,0.478403,0.606803,0.000486,"#b6cb00"
904240039,GuadalupChvez,34,0,9,9,0.497858,0.440433,0.003891,"#ff0d69"
904801027,DrEmrah0zcan,49,0,1,1,0.523216,0.348229,0,"#ff7007"
905533302,AnaGlezRms,31,0,2,2,0.62732,0.472624,0.000486,"#3e93ff"
906148490,LacaGram,21,0,1,1,0.030176,0.615863,0,"#c6cc85"
906569402,saracnash,34,0,2,2,0.343578,0.414701,0.000486,"#ff0d69"
906612331,JeffreyJDean,22,0,1,1,0.560373,0.655082,0,"#00e8b2"
907036518,responsociedad,17,0,1,1,0.60816,0.270177,0,"#ff9cc7"
910193832,haraheld,30,0,1,1,0.58703,0.601839,0,"#ff77ff"
910658696,maurus_gonz,21,0,1,1,0.048048,0.623811,0,"#c6cc85"
910902972,Julinarito,58,0,6,6,0.506386,0.580766,0.002432,"#005076"
910978158,becasmexico,1,1,0,1,0.39033,0.538609,0,"#b6cb00"
911184487,netcarlosgarcia,30,0,3,3,0.603361,0.636426,0.000973,"#ff77ff"
911265379,maramirez_mza,49,1,0,1,0.354435,0.681988,0,"#ff7007"
911487403,t_phyllobate,38,0,1,1,0.731762,0.324734,0,"#662859"
911630539,alexis_herreram,34,0,1,1,0.538801,0.186634,0,"#ff0d69"
911883216,storiadigitale,30,3,0,3,0.558799,0.609587,0.000973,"#ff77ff"
912307910,LolaRBrito,14,0,1,1,0.653023,0.535568,0,"#00eeff"
913033380,DeFabulaFanCine,37,0,1,1,0.507325,0.740282,0,"#006032"
913059631,CnSathya,21,0,1,1,0.260934,0.213872,0,"#c6cc85"
913303494,tinoguemes,22,0,2,2,0.588633,0.693566,0.000486,"#00e8b2"
913447502,NewLeftReview,36,6,0,6,0.56882,0.431757,0.002432,"#825403"
915117859,JenProf,36,0,1,1,0.426901,0.567245,0,"#825403"
915750098,Cerlalc,22,6,1,7,0.510222,0.673033,0.002918,"#00e8b2"
915981834,luquesa23,21,0,2,2,0.277055,0.242277,0.000486,"#c6cc85"
916270034,UrbanismoUNAM,13,1,0,1,0.390218,0.397278,0,"#3bec00"
917010000,sk_serge,36,13,7,20,0.485703,0.272848,0.009241,"#825403"
917687792,emilioleton,30,0,45,45,0.538649,0.559013,0.021401,"#ff77ff"
917702797,FSabateD,49,1,0,1,0.359141,0.66068,0,"#ff7007"
918045733,NicolasCorena,38,0,1,1,0.440245,0.761922,0,"#662859"
919853820,EContraonce,49,0,4,4,0.448493,0.558319,0.001459,"#ff7007"
920050484,DHandLib,13,12,3,15,0.435259,0.433852,0.006809,"#3bec00"
920401824,jcaacostamacia,34,0,13,13,0.500601,0.461522,0.005837,"#ff0d69"
920404452,aanotzin,8,0,2,2,0.468784,0.498876,0.000486,"#00ed5d"
920745883,LisbethORod,36,0,3,3,0.533562,0.449835,0.000973,"#825403"
920752116,ScienceLurker,22,0,1,1,0.643342,0.465592,0,"#00e8b2"
921232268,Sputnik_451,38,0,1,1,0.591273,0.340569,0,"#662859"
921269952,KalElSkywalker,37,0,1,1,0.293399,0.469866,0,"#006032"
922556508,CMejeur,34,1,0,1,0.329246,0.416489,0,"#ff0d69"
923083543,juanrasmt,42,9,5,14,0.686973,0.469729,0.006323,"#66e087"
923271840,rdarrellmeadows,34,0,3,3,0.394925,0.454189,0.000973,"#ff0d69"
923407154,AniKullock,49,0,5,5,0.418191,0.540743,0.001946,"#ff7007"
923563621,MacriElGato,38,0,1,1,0.596282,0.337858,0,"#662859"
923804605,EdoTech,49,1,0,1,0.341809,0.653712,0,"#ff7007"
925094108,msolervila,8,2,0,2,0.660174,0.258181,0.000486,"#00ed5d"
925515990,Clau_Dimi,14,0,1,1,0.600693,0.482641,0,"#00eeff"
925586802,javierlopez86vk,58,0,1,1,0.590738,0.167244,0,"#005076"
926072288,AMacharowski,31,0,4,4,0.605464,0.509464,0.001459,"#3e93ff"
926298102,moztrenko,13,0,1,1,0.39265,0.490465,0,"#3bec00"
928096634,eidedesign,22,0,1,1,0.608446,0.641486,0,"#00e8b2"
928253023,DeborahLRivas,38,0,1,1,0.82399,0.652372,0,"#662859"
928669573,luisram35881061,7,0,1,1,0.524031,0.186595,0,"#ffb800"
928800049,oasancheza,49,0,1,1,0.085256,0.631881,0,"#ff7007"
929391067,Alijiri,30,0,1,1,0.600369,0.657203,0,"#ff77ff"
929819324,pancho_jay,13,0,1,1,0.638368,0.986572,0,"#3bec00"
929826847,jeduardogonz,13,18,46,64,0.481165,0.491486,0.030642,"#3bec00"
929832451,EnvejecerCSIC,22,2,4,6,0.579754,0.480092,0.002432,"#00e8b2"
929859709,CSocialesPUJ,37,6,6,12,0.551691,0.420788,0.00535,"#006032"
930634986,ademec_enc,13,3,0,3,0.523881,0.363132,0.000973,"#3bec00"
930727717,carinareym,22,0,1,1,0.598368,0.622605,0,"#00e8b2"
930899286,mppm2,4,0,1,1,0.855383,0.254655,0,"#f4c8cf"
931188906,EdnaJoya,29,0,1,1,0.357132,0.159188,0,"#1fab00"
931850953,montenoso,30,0,1,1,0.657762,0.615968,0,"#ff77ff"
932297978,FormaRevista,30,0,1,1,0.425382,0.700471,0,"#ff77ff"
932747438,ps_tadler,49,0,4,4,0.426219,0.519609,0.001459,"#ff7007"
933035688,ledithvet2012,13,0,4,4,0.435874,0.433718,0.001459,"#3bec00"
933250814,isacristi03,38,0,3,3,0.630962,0.378034,0.000973,"#662859"
933364646,ecuanimax,13,0,2,2,0.38016,0.395275,0.000486,"#3bec00"
933496148,cibellycs,36,0,1,1,0.772872,0.609456,0,"#825403"
933901766,vicente_alcaniz,37,2,0,2,0.558105,0.429415,0.000486,"#006032"
934192146,Territori_UAB,14,0,2,2,0.587818,0.528786,0.000486,"#00eeff"
934323798,aarias14,2,0,3,3,0.499852,0.60172,0.000973,"#ffa64e"
934551116,paula_canarias,15,1,0,1,0.60259,0.563108,0,"#008ebb"
935150407,donbelfiore,30,0,5,5,0.484905,0.621331,0.001946,"#ff77ff"
935195028,Japerles,14,1,2,3,0.613709,0.530672,0.000973,"#00eeff"
935376614,ElaMartinez83,40,0,1,1,0.582754,0.023906,0,"#ff12a3"
935875842,cadexperto,34,0,1,1,0.372282,0.372216,0,"#ff0d69"
936789678,JuxtaCommons,30,2,0,2,0.476871,0.50053,0.000486,"#ff77ff"
936961322,walshbr,34,34,26,60,0.469892,0.46466,0.028696,"#ff0d69"
937463240,HDigitais,14,25,2,27,0.516961,0.47573,0.012646,"#00eeff"
937669512,velmolan,30,3,5,8,0.640613,0.620297,0.003405,"#ff77ff"
937827786,mariarchaves,37,0,1,1,0.694626,0.47195,0,"#006032"
938117460,martinarivera13,1,0,2,2,0.440831,0.709654,0.000486,"#b6cb00"
939265982,PatrimonioMscal,1,2,2,4,0.572161,0.754546,0.001459,"#b6cb00"
939505560,valle_arroyo,15,0,18,18,0.561222,0.588338,0.008268,"#008ebb"
940108332,pilarrosad,37,1,0,1,0.66753,0.271168,0,"#006032"
940133402,EdgarGonzalezGT,3,0,1,1,0.460302,0.746678,0,"#ffb3ff"
940592857,guadalupeecheg1,31,1,5,6,0.553738,0.489791,0.002432,"#3e93ff"
941198154,eskole,49,1,0,1,0.337508,0.514424,0,"#ff7007"
941281808,MiguelMigcalde,13,0,1,1,0.443827,0.404386,0,"#3bec00"
941500074,gloriabaigo,49,0,2,2,0.409599,0.390225,0.000486,"#ff7007"
941514565,AgoraAbierta,58,1,6,7,0.587941,0.587612,0.002918,"#005076"
941564448,anabelenp14,49,1,0,1,0.407531,0.668364,0,"#ff7007"
943226876,JavierMSJ1,58,0,2,2,0.405892,0.556131,0.000486,"#005076"
943646011,UTEoficial,22,4,1,5,0.560526,0.764092,0.001946,"#00e8b2"
945177936,pasajeraandante,49,3,0,3,0.428683,0.533926,0.000973,"#ff7007"
945268580,CaribbeanSAssoc,13,1,0,1,0.346767,0.438924,0,"#3bec00"
945567698,edita_gu,1,0,2,2,0.451089,0.675938,0.000486,"#b6cb00"
946022486,AnaRomera23,1,0,3,3,0.511146,0.601203,0.000973,"#b6cb00"
946659818,revistaHCSM,36,17,12,29,0.528246,0.363348,0.013619,"#825403"
946965716,professorcaz,13,14,2,16,0.431826,0.45729,0.007296,"#3bec00"
947789851,DH_OU,36,1,1,2,0.495924,0.455968,0.000486,"#825403"
948243710,HxxxKxxx,14,0,6,6,0.570201,0.486398,0.002432,"#00eeff"
948577484,Marini_112,58,0,1,1,0.615344,0.267706,0,"#005076"
948582787,ricklarotta,34,0,1,1,0.612597,0.325655,0,"#ff0d69"
948641467,CarlosG_Miranda,37,0,2,2,0.695957,0.506469,0.000486,"#006032"
948683648,Forbes_Mexico,10,1,0,1,0.232296,0.47632,0,"#52d7c0"
948888540,victoveda,22,0,1,1,0.503824,0.666555,0,"#00e8b2"
949476402,ArchivoUGR,31,0,3,3,0.61821,0.505426,0.000973,"#3e93ff"
949921106,martineta11,14,0,2,2,0.627408,0.569567,0.000486,"#00eeff"
950171954,Leonora_DiazMas,30,0,2,2,0.469054,0.553639,0.000486,"#ff77ff"
950188332,mariapazmarques,36,0,2,2,0.425686,0.478932,0.000486,"#825403"
950307746,LinuxMijas,0,0,1,1,0.829431,0.442485,0,"#8ecfec"
950358403,mundodemanana,49,1,0,1,0.357203,0.698322,0,"#ff7007"
950649348,FacDerechoUsal,58,1,0,1,0.49995,0.609454,0,"#005076"
950838697,Georginagonz,7,0,1,1,0.396941,0.722702,0,"#ffb800"
951363271,PedroBtz,22,6,3,9,0.367175,0.70967,0.003891,"#00e8b2"
951365702,SalamancaVivela,58,0,1,1,0.45933,0.6527,0,"#005076"
951578352,IELTFCSHUNL,36,8,6,14,0.521501,0.449682,0.006323,"#825403"
951767720,IncipitCSIC,14,40,13,53,0.512976,0.528645,0.025292,"#00eeff"
952152762,aurigamoon,42,0,2,2,0.730162,0.395561,0.000486,"#66e087"
953595966,moisomedrano,38,0,6,6,0.539568,0.47352,0.002432,"#662859"
954437468,elmemorioso06,38,0,4,4,0.528452,0.452717,0.001459,"#662859"
956321100,PaolaBe2,14,0,21,21,0.511948,0.506344,0.009728,"#00eeff"
956410147,MargaGCandeira,31,0,2,2,0.813168,0.439681,0.000486,"#3e93ff"
957115176,guelbusto,31,0,1,1,0.810581,0.563614,0,"#3e93ff"
957509173,JMFradeRue,30,107,62,169,0.492187,0.53377,0.081712,"#ff77ff"
957565831,OlgaMardonesA,21,0,2,2,0.228808,0.24829,0.000486,"#c6cc85"
957892608,javisanz_pub,15,0,4,4,0.583104,0.591855,0.001459,"#008ebb"
957898056,EmmaJBL,36,0,3,3,0.50001,0.404872,0.000973,"#825403"
958218955,ligaincom,1,3,2,5,0.44785,0.536666,0.001946,"#b6cb00"
958324482,fadu_udelar,55,4,5,9,0.657246,0.656742,0.003891,"#cb3f32"
958523821,greendersoul,13,0,2,2,0.414171,0.376625,0.000486,"#3bec00"
959122837,gaado14,3,0,1,1,0.452661,0.769737,0,"#ffb3ff"
959705784,camillafeltrin,49,1,0,1,0.329468,0.645114,0,"#ff7007"
960752922,Exprespol,19,9,3,12,0.638046,0.741414,0.00535,"#00d3ff"
961205156,CienciasUAndes,37,3,1,4,0.632074,0.372463,0.001459,"#006032"
961565618,m_lopez_ornelas,31,0,2,2,0.581204,0.703794,0.000486,"#3e93ff"
961652240,GustavoLo01,58,0,2,2,0.608728,0.312623,0.000486,"#005076"
962273634,MappingInteract,22,0,1,1,0.580793,0.612018,0,"#00e8b2"
963318692,Mich_Crosashe,17,0,4,4,0.50172,0.404377,0.001459,"#ff9cc7"
964037922,VolkswagenSt,30,0,2,2,0.475929,0.580996,0.000486,"#ff77ff"
964422998,fpalacioarce,22,0,1,1,0.596443,0.600356,0,"#00e8b2"
964809955,nubuker,49,0,1,1,0.352194,0.470978,0,"#ff7007"
965099960,mariela_fargas,13,0,8,8,0.554388,0.522151,0.003405,"#3bec00"
965980476,BarnatanMR,40,0,1,1,0.623625,0.019297,0,"#ff12a3"
965996816,PCDig,14,5,14,19,0.542216,0.522155,0.008755,"#00eeff"
966137557,miriadax,0,3,1,4,0.394028,0.5781,0.001459,"#8ecfec"
966422798,Fabio_Ciotti,14,5,13,18,0.505371,0.50579,0.008268,"#00eeff"
968383999,rebiun,22,12,2,14,0.535875,0.610193,0.006323,"#00e8b2"
968450480,Argivus,31,0,2,2,0.639431,0.550725,0.000486,"#3e93ff"
968987166,CarmenMdlR,0,7,7,14,0.466427,0.575714,0.006323,"#8ecfec"
970252244,Emilfe1,49,1,0,1,0.343534,0.640105,0,"#ff7007"
970297951,irisgonzalezaf,0,0,1,1,0.769911,0.601537,0,"#8ecfec"
970461038,berodsat,35,0,1,1,0.476582,0.686923,0,"#00faff"
970578068,IsaSolisA,30,1,5,6,0.523904,0.590123,0.002432,"#ff77ff"
970731607,hdpaulspence,30,106,149,255,0.511612,0.524483,0.123541,"#ff77ff"
971728339,alonsodeblas,0,0,1,1,0.769831,0.597207,0,"#8ecfec"
972028076,ManelMarquezB,19,5,1,6,0.640486,0.638923,0.002432,"#00d3ff"
972275912,craifgh,14,0,3,3,0.560946,0.548878,0.000973,"#00eeff"
972589231,memoqui02,9,0,2,2,0.666377,0.916859,0.000486,"#008f7b"
972932671,oldyellowbrick4,36,1,0,1,0.571302,0.316979,0,"#825403"
973228706,Cata_Gaete,21,0,1,1,0.195141,0.215243,0,"#c6cc85"
973844630,jorgema39660314,21,0,1,1,0.033023,0.630118,0,"#c6cc85"
974150228,Alfredo1g,49,1,0,1,0.402433,0.678695,0,"#ff7007"
974801498,MargaServate,49,2,0,2,0.401753,0.568981,0.000486,"#ff7007"
975267013,linis2613,38,0,1,1,0.425492,0.774392,0,"#662859"
976446546,IIIACSIC,14,0,3,3,0.604484,0.544323,0.000973,"#00eeff"
977207990,CarolinaPS11,7,0,2,2,0.428442,0.424836,0.000486,"#ffb800"
977665188,veronicapascboe,49,1,0,1,0.347588,0.691746,0,"#ff7007"
978230288,geografiamalaga,22,2,0,2,0.667277,0.489323,0.000486,"#00e8b2"
978397310,mnlzbl,3,0,1,1,0.441081,0.741753,0,"#ffb3ff"
978616568,shelleyerose,49,0,1,1,0.357266,0.532747,0,"#ff7007"
978765787,lacomunapresxs,19,1,5,6,0.642295,0.675189,0.002432,"#00d3ff"
978869258,SEECGalicia,58,5,3,8,0.742427,0.558098,0.003405,"#005076"
979844726,LuisMiguelAlbor,14,0,2,2,0.686344,0.739336,0.000486,"#00eeff"
980201034,desirebuh,22,0,3,3,0.474764,0.557796,0.000973,"#00e8b2"
980440302,rcastillo15,21,0,1,1,0.244992,0.20759,0,"#c6cc85"
980509975,BecasCOL,1,2,0,2,0.401764,0.5418,0.000486,"#b6cb00"
980747437,USAL_FLEO,37,1,0,1,0.418881,0.631598,0,"#006032"
980783300,Conviction19c,34,0,2,2,0.475886,0.411503,0.000486,"#ff0d69"
981602611,dhawards,13,40,2,42,0.486184,0.492909,0.019942,"#3bec00"
982457100,masterCM_UB,22,0,1,1,0.577554,0.642594,0,"#00e8b2"
983101658,otazu35,16,22,1,23,0.910789,0.662543,0.0107,"#c42c63"
983438088,futicool,15,0,1,1,0.609159,0.629856,0,"#008ebb"
983451194,paudsoto,36,0,3,3,0.541662,0.482494,0.000973,"#825403"
983936198,AlDieterNavarro,13,0,1,1,0.407527,0.458075,0,"#3bec00"
985241106,tallerdeloido,13,1,0,1,0.576292,0.430072,0,"#3bec00"
985287374,peraymanzana,34,0,2,2,0.473619,0.414841,0.000486,"#ff0d69"
985725570,arbustt,49,2,0,2,0.4307,0.556692,0.000486,"#ff7007"
986178732,IC_Milan,1,22,2,24,0.470114,0.633978,0.011187,"#b6cb00"
986525696,BibliotecaUCH,31,2,7,9,0.620586,0.457657,0.003891,"#3e93ff"
987216764,ZZate,8,0,2,2,0.678471,0.259829,0.000486,"#00ed5d"
987323496,marianacmalta,30,6,1,7,0.492047,0.554971,0.002918,"#ff77ff"
987636385,geografivirtual,38,0,1,1,0.606929,0.365843,0,"#662859"
988018153,luis_bejines,49,0,1,1,0.390856,0.523885,0,"#ff7007"
988405152,AlumniVillanuev,22,0,3,3,0.652562,0.500841,0.000973,"#00e8b2"
988582586,Conecta13,31,1,0,1,0.629013,0.528357,0,"#3e93ff"
988618082,EmancipateMLG,30,0,1,1,0.654485,0.594396,0,"#ff77ff"
989029970,CarmiaGonzlez1,3,0,1,1,0.487745,0.777387,0,"#ffb3ff"
989289619,marthaapariciol,13,3,0,3,0.437286,0.463838,0.000973,"#3bec00"
989366766,BibliotecaPeru,14,10,0,10,0.609127,0.539969,0.004377,"#00eeff"
989446764,sandrazafra,3,0,1,1,0.479459,0.76055,0,"#ffb3ff"
990057500,filosdie,13,0,4,4,0.466204,0.354462,0.001459,"#3bec00"
990380971,swisspeace,38,1,0,1,0.53304,0.361621,0,"#662859"
990571825,maateusreboucas,49,3,3,6,0.485221,0.408891,0.002432,"#ff7007"
990670248,SaradeAlbornoz,14,0,1,1,0.557559,0.551864,0,"#00eeff"
990840205,somescola,8,2,0,2,0.635996,0.334263,0.000486,"#00ed5d"
991081951,LiceoMichoacano,13,0,2,2,0.440896,0.424213,0.000486,"#3bec00"
991082047,Carmina_Banana,22,19,0,19,0.507738,0.546771,0.008755,"#00e8b2"
991890397,IES_AE,14,0,1,1,0.586838,0.931301,0,"#00eeff"
992977134,PlatInvestUCM,30,16,21,37,0.49109,0.563842,0.01751,"#ff77ff"
993013477,cgironella2005,55,0,6,6,0.670578,0.65272,0.002432,"#cb3f32"
993170330,Transmediaz,31,2,3,5,0.628986,0.534525,0.001946,"#3e93ff"
993463788,caprichodegaudi,22,2,2,4,0.597765,0.708063,0.001459,"#00e8b2"
993983862,DefiendDerechos,30,0,1,1,0.525136,0.623782,0,"#ff77ff"
994087574,MGG_2012,4,0,4,4,0.92226,0.251351,0.001459,"#f4c8cf"
994593811,the_candyspirit,22,0,2,2,0.566447,0.685977,0.000486,"#00e8b2"
994748959,IyC_es,55,1,0,1,0.662031,0.670376,0,"#cb3f32"
995289067,caissarl,49,0,3,3,0.435691,0.506122,0.000973,"#ff7007"
995596884,ispee1,49,0,1,1,0.765582,0.818488,0,"#ff7007"
995660179,Genealogistapro,22,1,3,4,0.571797,0.505606,0.001459,"#00e8b2"
996188809,Isaac_kiri,30,0,1,1,0.481761,0.647249,0,"#ff77ff"
997038068,lavaazulada,0,0,2,2,0.41111,0.546215,0.000486,"#8ecfec"
997507184,AChasAguion,14,0,5,5,0.535877,0.492211,0.001946,"#00eeff"
997641650,LinaOdena1,1,0,2,2,0.457545,0.698647,0.000486,"#b6cb00"
997826785,Co_Bosch,37,2,1,3,0.380815,0.70977,0.000973,"#006032"
998154931,en_bookle,2,0,2,2,0.437011,0.607945,0.000486,"#ffa64e"
998296369,Sanderyolo878,40,0,1,1,0.620796,0.04407,0,"#ff12a3"
998788268,CruzMolinaGaruz,22,0,2,2,0.517745,0.540719,0.000486,"#00e8b2"
998959628,seecmurcia,58,3,0,3,0.762791,0.482245,0.000973,"#005076"
999441762,AnnaTraveset,22,0,1,1,0.669016,0.47536,0,"#00e8b2"
1001249580,SalimaSanchez,49,1,0,1,0.425064,0.685327,0,"#ff7007"
1001971634,akhetaton11,14,0,3,3,0.52789,0.466845,0.000973,"#00eeff"
1002073819,CLACSBrownU,34,1,0,1,0.422152,0.350943,0,"#ff0d69"
1002325844,miltonkeynetaxi,34,1,1,2,0.425213,0.431137,0.000486,"#ff0d69"
1002326910,iromdmi01121999,30,0,1,1,0.530645,0.626218,0,"#ff77ff"
1002546919,Louis0587,7,0,1,1,0.402426,0.349388,0,"#ffb800"
1002822314,mas24661,49,1,0,1,0.3439,0.661483,0,"#ff7007"
1003080174,GH_UB,22,0,2,2,0.629387,0.558777,0.000486,"#00e8b2"
1003655713,FilosofiaUab,14,4,1,5,0.590066,0.469869,0.001946,"#00eeff"
1003938865,BIBLIOTH7QUE,49,0,1,1,0.457586,0.645875,0,"#ff7007"
1004499032,laninatiburon,13,0,1,1,0.42613,0.420467,0,"#3bec00"
1004727162,jgsanesteban,49,1,0,1,0.355768,0.680347,0,"#ff7007"
1004898306,engelein3,38,0,1,1,0.293063,0.189317,0,"#662859"
1005157356,deslixico,1,0,2,2,0.449161,0.650206,0.000486,"#b6cb00"
1005336188,FAGC_Anarquista,19,1,0,1,0.667059,0.795938,0,"#00d3ff"
1005807445,juanbasangulo,49,1,0,1,0.325304,0.661366,0,"#ff7007"
1006066214,abaraibar_griso,31,4,0,4,0.55127,0.552894,0.001459,"#3e93ff"
1006310448,MariaSaavedraI,2,0,5,5,0.561823,0.576579,0.001946,"#ffa64e"
1006439485,FyL_UVa,30,2,2,4,0.496434,0.587371,0.001459,"#ff77ff"
1007311039,ufbaempauta,36,5,0,5,0.523286,0.383422,0.001946,"#825403"
1007733295,indiramcm,38,0,1,1,0.66828,0.463472,0,"#662859"
1007833548,Germnhernndez16,13,0,7,7,0.505279,0.411312,0.002918,"#3bec00"
1008786625,teliarte,14,0,4,4,0.583769,0.517513,0.001459,"#00eeff"
1008958026,CulturaParaPepi,22,0,1,1,0.573206,0.692942,0,"#00e8b2"
1009128444,Luis_COL2007,37,1,0,1,0.701196,0.310374,0,"#006032"
1010071753,GerFCapriotti,8,0,1,1,0.51714,0.806554,0,"#00ed5d"
1011198872,jpersiva,8,0,1,1,0.675995,0.304131,0,"#00ed5d"
1011482664,CarmeOrs,14,0,1,1,0.605556,0.551462,0,"#00eeff"
1011949074,AlxAlameda,22,0,1,1,0.583684,0.612366,0,"#00e8b2"
1012459748,Berenice_LopezB,17,0,1,1,0.949509,0.372559,0,"#ff9cc7"
1012488631,BergisJules,13,1,0,1,0.367542,0.447155,0,"#3bec00"
1013201436,ArtEstudiantes,14,1,0,1,0.590368,0.580569,0,"#00eeff"
1013439774,chus_carrion,14,0,2,2,0.430987,0.536691,0.000486,"#00eeff"
1013465084,irakasleiker,49,1,0,1,0.338442,0.683304,0,"#ff7007"
1013658698,ReservaJuglair,36,1,2,3,0.498412,0.401552,0.000973,"#825403"
1014492164,carrontb,37,0,1,1,0.19954,0.475846,0,"#006032"
1014604596,MentedeCrystal,7,1,2,3,0.428162,0.37643,0.000973,"#ffb800"
1015534400,makiato_zoom,14,0,2,2,0.572031,0.49793,0.000486,"#00eeff"
1016117258,CardonaPatau,49,1,0,1,0.359159,0.617592,0,"#ff7007"
1016210628,InesLoustalet,30,3,7,10,0.53359,0.484289,0.004377,"#ff77ff"
1016379564,ComunicolocosOK,0,5,1,6,0.469225,0.556982,0.002432,"#8ecfec"
1016603988,danz_kelly,42,0,1,1,0.705592,0.444382,0,"#66e087"
1016881002,NatdiMontgo,37,0,2,2,0.662767,0.519821,0.000486,"#006032"
1017315523,ContrasteBilbao,49,1,0,1,0.43097,0.66622,0,"#ff7007"
1017429942,DOAJplus,49,22,0,22,0.463392,0.488132,0.010214,"#ff7007"
1017461527,PFDorado,30,41,53,94,0.547031,0.477797,0.045233,"#ff77ff"
1017749293,arteceha,14,16,3,19,0.485437,0.578887,0.008755,"#00eeff"
1018109354,MargemSultejano,36,0,1,1,0.555541,0.36376,0,"#825403"
1019969941,tobias_kraft,49,0,3,3,0.43902,0.492223,0.000973,"#ff7007"
1020012882,txedf,22,0,1,1,0.31101,0.665402,0,"#00e8b2"
1020140580,EEspigares,0,0,2,2,0.847458,0.438387,0.000486,"#8ecfec"
1020821706,anatranco,13,0,1,1,0.535415,0.464953,0,"#3bec00"
1021688372,evatebaeducando,31,0,1,1,0.67525,0.537069,0,"#3e93ff"
1021952828,MiriamSeghiri,14,1,0,1,0.298411,0.447957,0,"#00eeff"
1022299404,LancasterHistor,4,6,4,10,0.481675,0.464137,0.004377,"#f4c8cf"
1022994510,EMc_3,1,0,2,2,0.441965,0.648243,0.000486,"#b6cb00"
1023074611,noparesdcorrer,19,0,1,1,0.640295,0.628553,0,"#00d3ff"
1023194485,StarChild3197,38,0,1,1,0.102742,0.424588,0,"#662859"
1023670135,HuechaconaLuisa,34,0,1,1,0.546554,0.390241,0,"#ff0d69"
1023881922,AIPOes,22,0,1,1,0.652524,0.4707,0,"#00e8b2"
1024022088,GUNi_net,8,5,0,5,0.638312,0.36039,0.001946,"#00ed5d"
1024569362,AnaBejarano6,30,0,1,1,0.599596,0.662768,0,"#ff77ff"
1026149197,museebolo,1,3,0,3,0.47464,0.462005,0.000973,"#b6cb00"
1026160976,chanche97,42,0,1,1,0.741589,0.503543,0,"#66e087"
1026212581,castellanapura,49,2,0,2,0.407542,0.551509,0.000486,"#ff7007"
1026375488,esperantu,49,1,0,1,0.328719,0.603496,0,"#ff7007"
1026439428,MrsWolf81,0,2,0,2,0.541473,0.63506,0.000486,"#8ecfec"
1026647294,GBCContadores,49,1,0,1,0.365043,0.645136,0,"#ff7007"
1027226198,GlobalOutlookDH,13,19,29,48,0.485027,0.480965,0.02286,"#3bec00"
1029016068,SEIO_ES,22,0,2,2,0.6077,0.524738,0.000486,"#00e8b2"
1029750060,NaidaSaavedra,41,1,0,1,0.246301,0.341752,0,"#697b00"
1029812761,educavirtualorg,3,0,1,1,0.284633,0.56901,0,"#ffb3ff"
1029836492,fit_moreno,1,2,0,2,0.458879,0.581819,0.000486,"#b6cb00"
1030107031,InSEA_Blog,22,0,1,1,0.732899,0.204308,0,"#00e8b2"
1030560420,morateruel,0,1,0,1,0.294749,0.400307,0,"#8ecfec"
1031606828,NoraCBenedict,13,2,12,14,0.481205,0.486935,0.006323,"#3bec00"
1032233696,shashawikiwiki,58,0,1,1,0.508927,0.612508,0,"#005076"
1035131244,HeyThereNana,22,0,1,1,0.384348,0.592159,0,"#00e8b2"
1035442208,Saaruu09,2,0,2,2,0.638168,0.724097,0.000486,"#ffa64e"
1035756062,carmedpat,37,0,1,1,0.609899,0.633885,0,"#006032"
1035799123,jesushige,22,0,1,1,0.404841,0.599073,0,"#00e8b2"
1037302568,ppctcaicyt,49,0,3,3,0.436991,0.550956,0.000973,"#ff7007"
1037662868,ExLibric,42,1,1,2,0.720249,0.49965,0.000486,"#66e087"
1038246068,salernogabi,49,0,3,3,0.395806,0.537619,0.000973,"#ff7007"
1038336836,Ms_Erikson,34,0,1,1,0.413789,0.497186,0,"#ff0d69"
1040435552,JuanleivaUMA,14,0,1,1,0.650614,0.564027,0,"#00eeff"
1041414992,BaldwinVidal,34,0,2,2,0.353878,0.406923,0.000486,"#ff0d69"
1042615830,NiallerPau,37,0,2,2,0.296917,0.472124,0.000486,"#006032"
1043152368,FerAtique,36,1,1,2,0.52227,0.383379,0.000486,"#825403"
1043293388,miltonsier,34,0,3,3,0.539279,0.399886,0.000973,"#ff0d69"
1043874726,LeticiaVergara5,4,0,1,1,0.855641,0.235624,0,"#f4c8cf"
1045447148,glocv,41,0,3,3,0.397467,0.300017,0.000973,"#697b00"
1046013672,monjardin4,2,0,6,6,0.611949,0.500353,0.002432,"#ffa64e"
1046186232,RLaconica,34,0,6,6,0.521135,0.386984,0.002432,"#ff0d69"
1048207008,EuridiceSosa,13,0,2,2,0.457416,0.428163,0.000486,"#3bec00"
1049425986,davidpaz201,2,0,1,1,0.640645,0.647323,0,"#ffa64e"
1050706754,VeraGarcia00,31,0,1,1,0.627279,0.595747,0,"#3e93ff"
1051404330,gurriersread,14,0,1,1,0.600746,0.551912,0,"#00eeff"
1051649960,Fabriciosx,0,0,4,4,0.490487,0.429988,0.001459,"#8ecfec"
1051845583,yvonnezlam,13,1,0,1,0.530476,0.352524,0,"#3bec00"
1051929218,alenagu98,37,0,1,1,0.239547,0.423158,0,"#006032"
1053537865,cipripedia,14,2,1,3,0.544403,0.591476,0.000973,"#00eeff"
1054595136,GBA_8,15,0,9,9,0.517862,0.564087,0.003891,"#008ebb"
1055028001,onavcia,31,0,6,6,0.599268,0.55403,0.002432,"#3e93ff"
1055211620,tatiprezache,21,0,1,1,0.240941,0.202291,0,"#c6cc85"
1056191864,vhulden,34,0,2,2,0.505759,0.407328,0.000486,"#ff0d69"
1056717649,OpenRefine,34,5,3,8,0.454005,0.504425,0.003405,"#ff0d69"
1057923606,Vicent_Spain,31,0,10,10,0.556355,0.51401,0.004377,"#3e93ff"
1058519785,epachecoz11,14,0,2,2,0.566329,0.510456,0.000486,"#00eeff"
1058824598,FMEREB,42,0,1,1,0.76712,0.536305,0,"#66e087"
1059125119,Jeares25,34,0,4,4,0.473506,0.520328,0.001459,"#ff0d69"
1059501980,catmuno,34,3,3,6,0.501619,0.438017,0.002432,"#ff0d69"
1060125744,Pablo_F24,3,0,1,1,0.456032,0.650506,0,"#ffb3ff"
1060609723,RougeMoni,49,1,0,1,0.373558,0.651231,0,"#ff7007"
1060827985,FlipaConsultora,36,1,0,1,0.268048,0.310244,0,"#825403"
1061250102,angcastineira,8,5,0,5,0.652103,0.357103,0.001946,"#00ed5d"
1061334733,fsierracb,0,0,1,1,0.424127,0.391405,0,"#8ecfec"
1061340487,CulturaMural,13,3,2,5,0.418313,0.444695,0.001946,"#3bec00"
1063107253,fcallejah,14,0,6,6,0.557613,0.524051,0.002432,"#00eeff"
1063443012,emmanuelrog,36,6,0,6,0.574434,0.429217,0.002432,"#825403"
1064155194,fcd_ugr,31,1,0,1,0.695865,0.540147,0,"#3e93ff"
1065076362,noegongar,7,0,1,1,0.38055,0.209005,0,"#ffb800"
1066556678,1000genes,30,2,0,2,0.5283,0.492454,0.000486,"#ff77ff"
1067149758,CitlaliRDaz,41,0,4,4,0.402844,0.425615,0.001459,"#697b00"
1067295354,LuciaAchilles,37,0,1,1,0.6566,0.310829,0,"#006032"
1067580330,kgeographer,31,21,0,21,0.551031,0.496416,0.009728,"#3e93ff"
1068731628,AliciaEsf,7,0,1,1,0.625584,0.370443,0,"#ffb800"
1070166612,AnnaOFoka,49,0,3,3,0.43897,0.515368,0.000973,"#ff7007"
1070672900,HISTORIAIMAGEN,19,1,0,1,0.622041,0.788436,0,"#00d3ff"
1070798593,coddii_org,22,8,1,9,0.621573,0.509314,0.003891,"#00e8b2"
1071664034,conapfam,49,1,0,1,0.386178,0.618017,0,"#ff7007"
1071667177,tucomidasana,14,0,2,2,0.445106,0.47907,0.000486,"#00eeff"
1071738924,GzRobertoj,22,14,15,29,0.561392,0.572422,0.013619,"#00e8b2"
1071816314,eldiariotec,31,1,0,1,0.57766,0.453172,0,"#3e93ff"
1071925273,steelyeyedman,13,2,4,6,0.453273,0.52278,0.002432,"#3bec00"
1071992070,AnarquismoHoy,19,1,0,1,0.664278,0.765036,0,"#00d3ff"
1072611961,ffddmartin,14,1,1,2,0.493231,0.452276,0.000486,"#00eeff"
1073560759,UNI_DCOM,37,1,0,1,0.548711,0.361186,0,"#006032"
1073616709,KINOMARCOS,30,0,2,2,0.638187,0.585209,0.000486,"#ff77ff"
1073622740,COITCV,49,1,0,1,0.363039,0.663825,0,"#ff7007"
1073891402,PipoKatari,22,0,1,1,0.553105,0.812126,0,"#00e8b2"
1074689005,MariaMansu,15,0,1,1,0.55668,0.738598,0,"#008ebb"
1075082052,ForunculodeMarx,14,1,0,1,0.314139,0.430073,0,"#00eeff"
1075106924,RNBPColombia,38,3,8,11,0.563768,0.434455,0.004864,"#662859"
1075948644,jlunaJacinta,1,0,3,3,0.609206,0.517595,0.000973,"#b6cb00"
1076441989,JosepMVilalta,8,19,2,21,0.61059,0.382463,0.009728,"#00ed5d"
1076849982,Sobre_Geografia,14,0,2,2,0.568469,0.551407,0.000486,"#00eeff"
1077063368,se_saga,41,0,1,1,0.336931,0.375317,0,"#697b00"
1077412010,AmigosBrigadas,19,3,0,3,0.646206,0.747096,0.000973,"#00d3ff"
1077831234,SoniaGarciaAbog,49,1,0,1,0.281303,0.662051,0,"#ff7007"
1077832602,_juanjoseM,12,0,2,2,0.795519,0.721948,0.000486,"#00a04a"
1079035130,IBMT_SCW,19,3,0,3,0.63748,0.744568,0.000973,"#00d3ff"
1079628156,liubacid,37,1,1,2,0.681486,0.426635,0.000486,"#006032"
1080065808,Educopia,42,1,0,1,0.615508,0.404813,0,"#66e087"
1080273391,derinnelif,36,0,1,1,0.450176,0.280316,0,"#825403"
1080668947,LesleyBartlett_,34,0,2,2,0.34811,0.425966,0.000486,"#ff0d69"
1083109112,criticmarkup,30,4,0,4,0.492533,0.518853,0.001459,"#ff77ff"
1083667746,DebsEThorpe,30,1,0,1,0.578094,0.545168,0,"#ff77ff"
1083778988,fatimaglezgomez,15,0,1,1,0.619281,0.631884,0,"#008ebb"
1084939458,larroschi,55,1,0,1,0.763103,0.644732,0,"#cb3f32"
1084969592,_IsraelR_,13,19,62,81,0.480969,0.47805,0.038911,"#3bec00"
1086325934,UHertshistory,34,4,4,8,0.478897,0.423313,0.003405,"#ff0d69"
1086589789,MaulAndrea,49,0,1,1,0.367909,0.580326,0,"#ff7007"
1088868666,rgomezusal,58,19,8,27,0.499588,0.59026,0.012646,"#005076"
1089014474,Bierzotv,49,1,0,1,0.333009,0.668435,0,"#ff7007"
1089752149,Oretania,15,2,0,2,0.618547,0.625381,0.000486,"#008ebb"
1089891812,antaresuva,30,0,1,1,0.503011,0.649943,0,"#ff77ff"
1090262202,solo__pedro,21,0,1,1,0.479365,0.95675,0,"#c6cc85"
1090376852,pfrieder,49,1,0,1,0.336575,0.602221,0,"#ff7007"
1090400820,magdabrito96,43,1,0,1,0.609821,0.749299,0,"#fcae7e"
1091699810,bttnhg,1,0,1,1,0.434265,0.716384,0,"#b6cb00"
1092881402,JohnRivera8807,38,0,1,1,0.599319,0.35194,0,"#662859"
1092959706,zeun981,30,0,1,1,0.583453,0.738555,0,"#ff77ff"
1093116534,UACJmx,1,2,0,2,0.386708,0.531994,0.000486,"#b6cb00"
1093408555,GuinevereSnows,36,0,2,2,0.510198,0.336655,0.000486,"#825403"
1093647073,GobAbiertoCol,22,0,1,1,0.582577,0.616284,0,"#00e8b2"
1094238553,iPhonismo,49,1,0,1,0.31537,0.662159,0,"#ff7007"
1095406760,librosensayo,30,0,1,1,0.652193,0.677477,0,"#ff77ff"
1095448591,Tomas_Fontana_S,0,0,2,2,0.440213,0.385917,0.000486,"#8ecfec"
1095670098,openlibhums,49,3,5,8,0.462352,0.506425,0.003405,"#ff7007"
1096049174,LeonPTC,3,1,0,1,0.677231,0.291865,0,"#ffb3ff"
1096058179,DHtrends,30,1,0,1,0.701912,0.652041,0,"#ff77ff"
1097793320,UCLAmericas,36,1,0,1,0.493973,0.307019,0,"#825403"
1098156900,JEBonnin,37,1,2,3,0.258276,0.499124,0.000973,"#006032"
1098193076,MdscaUma,14,11,13,24,0.576794,0.528384,0.011187,"#00eeff"
1098578059,csyhUASLP,34,3,3,6,0.466806,0.426667,0.002432,"#ff0d69"
1098721280,amaliovarela,40,0,1,1,0.578218,0.018857,0,"#ff12a3"
1099333196,leo_chr,3,0,1,1,0.500046,0.775282,0,"#ffb3ff"
1100976536,BelloIraxis,2,0,1,1,0.652351,0.647953,0,"#ffa64e"
1101069571,FErMa33,49,0,2,2,0.511029,0.437419,0.000486,"#ff7007"
1102180742,RHalDia,49,1,0,1,0.349833,0.659993,0,"#ff7007"
1103776878,arenascabral,38,0,1,1,0.703692,0.582241,0,"#662859"
1104358903,LidiaMeras,40,0,1,1,0.628803,0.009909,0,"#ff12a3"
1104872551,finnonna,30,0,1,1,0.293892,0.55343,0,"#ff77ff"
1105009699,Negrodemakandal,34,0,1,1,0.535992,0.334376,0,"#ff0d69"
1107405570,rbaenamolina,1,0,4,4,0.621046,0.49807,0.001459,"#b6cb00"
1107480506,agu201819,1,0,1,1,0.421752,0.624351,0,"#b6cb00"
1108206228,noticiaspiura30,49,1,0,1,0.36972,0.612981,0,"#ff7007"
1108953578,Destinouma,14,2,0,2,0.576114,0.524886,0.000486,"#00eeff"
1109094056,2010_jorgei,49,1,0,1,0.353052,0.677804,0,"#ff7007"
1109483280,Verocballero,49,1,0,1,0.389495,0.647498,0,"#ff7007"
1109942197,LittleHuffie,37,0,2,2,0.246086,0.498476,0.000486,"#006032"
1110950724,cepoat,37,1,0,1,0.611782,0.343599,0,"#006032"
1111250804,Anamardevigo,31,0,2,2,0.59267,0.507936,0.000486,"#3e93ff"
1111574484,NCTrad_it,1,0,2,2,0.444847,0.702634,0.000486,"#b6cb00"
1111879572,soledad_qv,21,0,1,1,0.319081,0.447497,0,"#c6cc85"
1112453689,JacalGuadarrama,13,0,1,1,0.356358,0.4931,0,"#3bec00"
1112763072,CivilisDDHH,49,1,0,1,0.421183,0.650476,0,"#ff7007"
1113809412,SELITENAT,30,0,1,1,0.545862,0.670673,0,"#ff77ff"
1114067306,spermifex,37,2,0,2,0.569548,0.36702,0.000486,"#006032"
1114668229,ares_diez,2,0,3,3,0.68408,0.452419,0.000973,"#ffa64e"
1114698901,CulturaClasicaC,49,1,0,1,0.304009,0.681708,0,"#ff7007"
1114735688,LincolnBrigade,19,1,0,1,0.61239,0.774873,0,"#00d3ff"
1115049577,LingRomUVa,30,3,4,7,0.45618,0.515471,0.002918,"#ff77ff"
1116505279,CnatalPicasso,14,1,1,2,0.570019,0.490747,0.000486,"#00eeff"
1116803510,ardelasheras,0,1,0,1,0.691499,0.681688,0,"#8ecfec"
1117505534,casadevelazquez,35,21,4,25,0.568454,0.493384,0.011673,"#00faff"
1117790442,patrick_sahle,49,4,0,4,0.442663,0.556423,0.001459,"#ff7007"
1119024811,NotiFinancieras,49,1,0,1,0.289825,0.658078,0,"#ff7007"
1119269594,c_llamas_saiz,37,0,16,16,0.546677,0.524048,0.007296,"#006032"
1119370070,BegoaRegueiro,30,3,0,3,0.603364,0.609048,0.000973,"#ff77ff"
1119502988,BL_Labs,30,0,3,3,0.509302,0.582989,0.000973,"#ff77ff"
1119579630,SamMasVil,47,0,1,1,0.600737,0.19355,0,"#a091c4"
1119836179,jcgodoy9,49,0,1,1,0.912403,0.26443,0,"#ff7007"
1119997512,juanviblazquez,31,0,1,1,0.380682,0.540663,0,"#3e93ff"
1120165153,abolgaresc,33,0,1,1,0.242434,0.619155,0,"#ff8c00"
1120371596,CecytemChimal_2,17,0,1,1,0.932635,0.378975,0,"#ff9cc7"
1120392085,edithwritter,0,0,1,1,0.270937,0.492919,0,"#8ecfec"
1122541236,PosgradPolitica,7,0,1,1,0.434846,0.044069,0,"#ffb800"
1122856603,PosgradosIngUP,22,1,2,3,0.81058,0.304925,0.000973,"#00e8b2"
1123361244,yesiamsofu,37,1,1,2,0.591595,0.377306,0.000486,"#006032"
1123692120,VFurini_,36,0,2,2,0.492353,0.302925,0.000486,"#825403"
1125379147,Ibexnoticias,49,1,0,1,0.357625,0.625101,0,"#ff7007"
1125535208,BibDepery,30,0,1,1,0.566503,0.619887,0,"#ff77ff"
1125712118,PFAGROLUZ,42,0,1,1,0.808477,0.449231,0,"#66e087"
1125796202,ale_ulla,14,90,44,134,0.478596,0.518594,0.064689,"#00eeff"
1125923647,SociologiaDiver,36,1,2,3,0.370651,0.49645,0.000973,"#825403"
1126172934,AABELGRIJALVA,13,0,1,1,0.411019,0.414831,0,"#3bec00"
1128487320,MarcosSGonsalez,34,0,2,2,0.360939,0.400578,0.000486,"#ff0d69"
1129593656,acinjupol,35,0,1,1,0.726152,0.410242,0,"#00faff"
1129931252,erikonomista,7,0,2,2,0.475173,0.302631,0.000486,"#ffb800"
1130907210,EntornoG,49,1,0,1,0.320931,0.639346,0,"#ff7007"
1131275857,CCP_org,34,0,4,4,0.390229,0.436048,0.001459,"#ff0d69"
1131460195,UNIRalumni,14,3,3,6,0.430974,0.575458,0.002432,"#00eeff"
1131673010,Don_Folio,49,1,0,1,0.349582,0.655408,0,"#ff7007"
1131679592,agorathauma,13,1,2,3,0.49547,0.4305,0.000973,"#3bec00"
1131690439,Lenguando,30,0,1,1,0.446071,0.697639,0,"#ff77ff"
1131822565,casandra64,22,0,2,2,0.578554,0.595707,0.000486,"#00e8b2"
1133609750,espeotero63,14,0,1,1,0.652425,0.556555,0,"#00eeff"
1133811018,ItziarGD,34,0,3,3,0.469843,0.460313,0.000973,"#ff0d69"
1135342201,nosolosig,22,6,3,9,0.516494,0.589925,0.003891,"#00e8b2"
1135538244,TattyVivas,49,0,2,2,0.449668,0.580325,0.000486,"#ff7007"
1135799221,PosgradoFCAUAQ,13,1,0,1,0.363706,0.483194,0,"#3bec00"
1136191819,PalomaDAND,0,0,2,2,0.578021,0.568612,0.000486,"#8ecfec"
1136454619,patrimonialista,14,0,2,2,0.696523,0.544391,0.000486,"#00eeff"
1136475584,lbayoj,2,0,2,2,0.638766,0.663783,0.000486,"#ffa64e"
1136522773,DominiqueVanpee,14,0,1,1,0.635095,0.654449,0,"#00eeff"
1136906280,jorge_lanchas,1,0,1,1,0.430531,0.643891,0,"#b6cb00"
1139113136,univpaulvalery,9,11,4,15,0.681324,0.637183,0.006809,"#008f7b"
1139234113,NoeliaCChozas,15,0,2,2,0.592287,0.69934,0.000486,"#008ebb"
1139244198,marcialpons,22,5,6,11,0.527953,0.583182,0.004864,"#00e8b2"
1139386452,CnecEs,37,1,1,2,0.484876,0.692489,0.000486,"#006032"
1139547961,FFilologiaUS,1,61,29,90,0.474251,0.577883,0.043288,"#b6cb00"
1139983052,SaSoeurJuliette,30,5,13,18,0.496905,0.524404,0.008268,"#ff77ff"
1140887592,lpnunez,22,5,17,22,0.51029,0.527432,0.010214,"#00e8b2"
1141795676,NgelUichilovos,13,0,2,2,0.45582,0.322605,0.000486,"#3bec00"
1142771064,hrfabarac,55,0,2,2,0.614617,0.522577,0.000486,"#cb3f32"
1142871446,AneliseHShrout,34,2,6,8,0.419299,0.460007,0.003405,"#ff0d69"
1143600804,danisllo,14,0,1,1,0.307149,0.586744,0,"#00eeff"
1146072661,perdomoinma,31,1,0,1,0.729636,0.534916,0,"#3e93ff"
1146734520,DayoScript,38,0,2,2,0.693712,0.58507,0.000486,"#662859"
1147073311,amado_mila,38,0,4,4,0.572491,0.413201,0.001459,"#662859"
1148689843,quobit,22,1,0,1,0.32644,0.581859,0,"#00e8b2"
1149439183,CNqueretaro,13,0,1,1,0.403749,0.369411,0,"#3bec00"
1150228826,SantiagoRS04,1,0,1,1,0.72025,0.454977,0,"#b6cb00"
1150636140,jpmoragu,1,2,7,9,0.465561,0.571797,0.003891,"#b6cb00"
1150886688,saymonroe,49,0,1,1,0.542683,0.433706,0,"#ff7007"
1151069941,IRHT_CNRS,14,5,0,5,0.540488,0.521632,0.001946,"#00eeff"
1151994307,pilarcclavarana,31,1,0,1,0.76234,0.538891,0,"#3e93ff"
1152031118,CALED12,3,5,2,7,0.486049,0.544514,0.002918,"#ffb3ff"
1152294570,fdeflaqueza,40,0,2,2,0.088241,0.401981,0.000486,"#ff12a3"
1152452143,Antonio_Saborit,13,0,3,3,0.464869,0.468938,0.000973,"#3bec00"
1153622263,Huma_Num,49,19,6,25,0.48245,0.570044,0.011673,"#ff7007"
1154342173,jmsanchog,31,2,0,2,0.611205,0.493921,0.000486,"#3e93ff"
1154643114,nuevasideas,8,1,0,1,0.583992,0.352107,0,"#00ed5d"
1154717011,TM_Kres,38,0,1,1,0.29603,0.169974,0,"#662859"
1154811198,PBJaskot,30,0,2,2,0.536867,0.528747,0.000486,"#ff77ff"
1154895314,omarjavierg,9,1,0,1,0.737007,0.723826,0,"#008f7b"
1154916386,nimlothdecuba,49,5,12,17,0.409843,0.450425,0.007782,"#ff7007"
1155153248,buriker,22,0,1,1,0.570996,0.64094,0,"#00e8b2"
1155214518,antro_netgrafia,38,1,1,2,0.453563,0.369689,0.000486,"#662859"
1155549607,JuanQuintero97,37,0,1,1,0.583328,0.326325,0,"#006032"
1155856634,zapataescribe,38,0,1,1,0.553497,0.40369,0,"#662859"
1156144776,monse_sedano,7,2,0,2,0.436799,0.37384,0.000486,"#ffb800"
1156518446,amsociologia,3,0,1,1,0.575366,0.714414,0,"#ffb3ff"
1157077002,Historia_Social,19,2,0,2,0.617554,0.770492,0.000486,"#00d3ff"
1157357792,viacolvento10,36,0,1,1,0.419663,0.575982,0,"#825403"
1157447790,BecasyPracticas,1,1,0,1,0.395827,0.540847,0,"#b6cb00"
1157811056,FedericoVivanco,14,0,1,1,0.29139,0.438664,0,"#00eeff"
1157818171,FerSpinozaM,38,2,1,3,0.544542,0.410167,0.000973,"#662859"
1159603448,eLMformacion,49,1,0,1,0.388006,0.630529,0,"#ff7007"
1159719980,isa_salvado,36,0,1,1,0.322451,0.359978,0,"#825403"
1160112116,JoanaGarSalce,0,0,1,1,0.351882,0.585546,0,"#8ecfec"
1161164514,Fsierra5Fsierra,34,0,2,2,0.504014,0.403178,0.000486,"#ff0d69"
1163854663,NelizabethSaher,13,0,2,2,0.433344,0.45667,0.000486,"#3bec00"
1164234498,nino_marysol,37,1,0,1,0.696293,0.301531,0,"#006032"
1164399300,AdelaideAS,30,0,1,1,0.507715,0.623846,0,"#ff77ff"
1164847178,arqmarcovera,37,0,1,1,0.637662,0.210062,0,"#006032"
1165471202,Mencarisa_,14,0,2,2,0.688138,0.546514,0.000486,"#00eeff"
1165843928,noacooperaccion,22,0,1,1,0.691397,0.528562,0,"#00e8b2"
1166683087,Asociacion_AHN,22,0,1,1,0.593847,0.602904,0,"#00e8b2"
1167153007,mundos51,7,0,1,1,0.390341,0.720374,0,"#ffb800"
1168283011,Gabigparias,31,0,1,1,0.657373,0.545436,0,"#3e93ff"
1168867412,rjeronimof,2,0,1,1,0.761529,0.532146,0,"#ffa64e"
1169161578,EUROAFRO2013,49,1,0,1,0.340224,0.661565,0,"#ff7007"
1169488278,TafallaMarta,14,0,1,1,0.652288,0.580548,0,"#00eeff"
1169539512,edullobil,49,3,3,6,0.520942,0.646344,0.002432,"#ff7007"
1169835889,Beizana,15,0,5,5,0.495925,0.669769,0.001946,"#008ebb"
1170196062,TecnosferaET,38,2,0,2,0.501626,0.556497,0.000486,"#662859"
1170364291,IMRyTv_Morelos,13,5,2,7,0.446557,0.399839,0.002918,"#3bec00"
1170404948,ADHOrg,36,209,54,263,0.466419,0.487955,0.127432,"#825403"
1171371325,la_salut,14,1,0,1,0.309643,0.698471,0,"#00eeff"
1171393561,Absis,49,1,0,1,0.356906,0.666876,0,"#ff7007"
1171786716,KEEPSOLUTIONS,36,2,0,2,0.552848,0.428097,0.000486,"#825403"
1171801832,FComCSusj,30,0,2,2,0.758555,0.66318,0.000486,"#ff77ff"
1172263382,GingembreGil,34,0,2,2,0.551397,0.391635,0.000486,"#ff0d69"
1172601608,OrtollServando,34,0,1,1,0.488172,0.370355,0,"#ff0d69"
1172871680,bibliotequesUAB,14,6,0,6,0.583748,0.546961,0.002432,"#00eeff"
1175382716,HagaselaluzRE,22,3,5,8,0.602132,0.879271,0.003405,"#00e8b2"
1176099517,SEEC_nacional,58,4,8,12,0.662915,0.514769,0.00535,"#005076"
1180553346,mariquillalpino,15,0,2,2,0.562434,0.647107,0.000486,"#008ebb"
1183282267,nananaKneeeees,34,0,1,1,0.365475,0.374526,0,"#ff0d69"
1183526263,fjcervera,1,0,2,2,0.664092,0.441124,0.000486,"#b6cb00"
1186188498,JuanarioMedina,38,0,2,2,0.617382,0.385832,0.000486,"#662859"
1186366603,Boston_DH,36,1,0,1,0.327006,0.463277,0,"#825403"
1187479046,dgfalejandro,29,0,1,1,0.351793,0.161645,0,"#1fab00"
1190315210,GPSalmeron,49,5,2,7,0.504732,0.577498,0.002918,"#ff7007"
1191171493,ESIMEZMEC,17,0,1,1,0.616621,0.273614,0,"#ff9cc7"
1192052760,ffreff,49,1,10,11,0.445257,0.430924,0.004864,"#ff7007"
1192544936,roslufe,30,1,0,1,0.583894,0.701506,0,"#ff77ff"
1192958954,HelderJMendes,36,2,3,5,0.561866,0.449277,0.001946,"#825403"
1193209944,Tucucucom,49,1,0,1,0.408421,0.650545,0,"#ff7007"
1193733325,LMRodriguez,4,0,1,1,0.3608,0.443462,0,"#f4c8cf"
1195855915,Federal1949,49,1,0,1,0.306934,0.621835,0,"#ff7007"
1198269571,Letrasqueescrib,30,13,149,162,0.510925,0.542555,0.078307,"#ff77ff"
1198790294,alopezh2,13,0,5,5,0.534576,0.512425,0.001946,"#3bec00"
1199192406,RuldezY,7,0,1,1,0.517319,0.272137,0,"#ffb800"
1199296568,marinabsas,49,0,2,2,0.382999,0.554175,0.000486,"#ff7007"
1200822570,RamadaPrieto,38,1,0,1,0.625317,0.407679,0,"#662859"
1201628767,Lilzahira,1,0,3,3,0.465544,0.589544,0.000973,"#b6cb00"
1201994533,SaberUniv,49,1,0,1,0.373586,0.648178,0,"#ff7007"
1202097403,na_gdelangel,49,1,0,1,0.391905,0.668796,0,"#ff7007"
1203301975,largocaballerof,19,1,13,14,0.627981,0.699832,0.006323,"#00d3ff"
1203827234,LletresUAB,14,12,4,16,0.532626,0.523928,0.007296,"#00eeff"
1204168069,angel_ort09,19,1,0,1,0.64956,0.78491,0,"#00d3ff"
1204325684,elllaru,30,0,1,1,0.597265,0.607961,0,"#ff77ff"
1205470920,SeminarioHD,13,54,21,75,0.491801,0.478881,0.035992,"#3bec00"
1205767622,leirefri,37,0,2,2,0.587676,0.541645,0.000486,"#006032"
1205771539,FernandezFabyy,37,0,1,1,0.282453,0.368731,0,"#006032"
1206082356,albala5,31,0,1,1,0.672625,0.544422,0,"#3e93ff"
1207667768,JaimeSotoMuoz1,49,0,3,3,0.403447,0.505953,0.000973,"#ff7007"
1208265230,MercedesPache68,15,0,3,3,0.495537,0.566506,0.000973,"#008ebb"
1208771636,UiB_HF,30,1,0,1,0.484376,0.650169,0,"#ff77ff"
1210053679,JLDiazof,13,0,1,1,0.442137,0.354887,0,"#3bec00"
1210473931,nycdh,36,5,0,5,0.481558,0.402281,0.001946,"#825403"
1212488840,Mmlmdc,42,0,1,1,0.708052,0.44778,0,"#66e087"
1212993240,FILCuba,49,3,0,3,0.416679,0.392419,0.000973,"#ff7007"
1213507832,lucianaleandrol,36,0,1,1,0.504465,0.213806,0,"#825403"
1216071709,colombia_hist,37,0,1,1,0.640989,0.382906,0,"#006032"
1216124478,rubojeda,30,0,1,1,0.288088,0.559021,0,"#ff77ff"
1216347614,DiazDomingod,22,0,2,2,0.570018,0.61736,0.000486,"#00e8b2"
1216398895,VeroniqueTT1,30,0,1,1,0.495799,0.631747,0,"#ff77ff"
1216522992,HolaLaLola,15,0,2,2,0.677462,0.548888,0.000486,"#008ebb"
1217056856,Hypatia_Goethe,13,0,2,2,0.492764,0.41985,0.000486,"#3bec00"
1217118984,leofn3,36,55,97,152,0.514287,0.39829,0.073444,"#825403"
1217131993,MissJuliaOrwell,13,0,1,1,0.377132,0.35543,0,"#3bec00"
1217279772,osantossopena,49,0,1,1,0.455293,0.68125,0,"#ff7007"
1217472642,La_Tacita,49,1,1,2,0.420066,0.541951,0.000486,"#ff7007"
1217994668,lomejordemadrid,58,0,3,3,0.564367,0.418079,0.000973,"#005076"
1218073800,policiaforal_na,1,1,0,1,0.730535,0.4502,0,"#b6cb00"
1218596107,maria_yira,14,0,1,1,0.405271,0.531756,0,"#00eeff"
1218799892,65_rodero,14,0,2,2,0.449836,0.477338,0.000486,"#00eeff"
1219091653,ONUBIBUV,14,0,1,1,0.568142,0.454941,0,"#00eeff"
1219254234,etinEspartaego,30,0,1,1,0.623638,0.474215,0,"#ff77ff"
1219888003,resdatall,36,3,0,3,0.442042,0.541938,0.000973,"#825403"
1219912194,antumeneses,49,0,7,7,0.482891,0.565872,0.002918,"#ff7007"
1220485248,FlorezTorresCA,38,0,1,1,0.622087,0.362018,0,"#662859"
1222308966,CLARINERIC,30,27,0,27,0.489619,0.515257,0.012646,"#ff77ff"
1222401072,latidosdelrock,19,2,0,2,0.647117,0.751657,0.000486,"#00d3ff"
1222588086,FHCE_Udelar,55,56,13,69,0.636938,0.624585,0.033074,"#cb3f32"
1222695997,marc1gar,49,1,0,1,0.389624,0.687225,0,"#ff7007"
1223558910,CyberAbogado,38,0,1,1,0.653787,0.410951,0,"#662859"
1223625733,pedropoorras,7,0,1,1,0.403935,0.326848,0,"#ffb800"
1224664032,IUEMULL,22,3,0,3,0.74702,0.565168,0.000973,"#00e8b2"
1225760538,Posgrado_UNQ,49,1,0,1,0.388948,0.634533,0,"#ff7007"
1225838904,womenteck,31,0,1,1,0.59857,0.472009,0,"#3e93ff"
1226832308,Daniela96Meza,21,0,1,1,0.209995,0.221131,0,"#c6cc85"
1227185100,iatext,30,34,22,56,0.544036,0.557702,0.026751,"#ff77ff"
1227393204,gananzia,49,1,0,1,0.352108,0.646061,0,"#ff7007"
1227872533,DerechoCEU,31,0,1,1,0.712839,0.27841,0,"#3e93ff"
1227942865,ProsumidorSoc,31,14,41,55,0.551778,0.526183,0.026265,"#3e93ff"
1228997113,tundetecla,13,0,1,1,0.467746,0.393913,0,"#3bec00"
1229504526,jen_senshi,3,0,1,1,0.674467,0.716526,0,"#ffb3ff"
1229540822,espanolURV,1,1,3,4,0.431188,0.669783,0.001459,"#b6cb00"
1229689958,MArchivstica,58,3,6,9,0.543563,0.476052,0.003891,"#005076"
1230198558,consultor_ar,49,1,0,1,0.381028,0.67653,0,"#ff7007"
1230868171,edgarmorinparis,9,2,0,2,0.616625,0.651381,0.000486,"#008f7b"
1234479488,loverofthesigh,33,0,2,2,0.217383,0.614254,0.000486,"#ff8c00"
1234779528,IAML_AIBM,36,0,1,1,0.334685,0.46964,0,"#825403"
1237834519,albeertooac,7,0,2,2,0.431316,0.351829,0.000486,"#ffb800"
1238377296,CondeDeGondomar,37,0,1,1,0.6145,0.630574,0,"#006032"
1239448868,Maria_Ledo82,19,0,1,1,0.64571,0.641496,0,"#00d3ff"
1239855234,JoanMarcRamos,31,0,1,1,0.461268,0.588686,0,"#3e93ff"
1239905988,ReddinConslts,49,1,0,1,0.399961,0.643984,0,"#ff7007"
1240017955,BadrinasLuis,49,3,0,3,0.417083,0.599278,0.000973,"#ff7007"
1240243430,PamelaLozan,30,2,0,2,0.589422,0.624857,0.000486,"#ff77ff"
1240400462,Judith_MVG,49,1,0,1,0.299675,0.640596,0,"#ff7007"
1240858034,alba_ambros,31,14,11,25,0.507199,0.542238,0.011673,"#3e93ff"
1241736810,BlogNegras,36,0,1,1,0.529795,0.213371,0,"#825403"
1242081320,holatalleru,38,0,1,1,0.636535,0.392128,0,"#662859"
1242342626,artecompacto,42,0,4,4,0.701076,0.453252,0.001459,"#66e087"
1242833358,mardelasca,30,0,1,1,0.481269,0.635282,0,"#ff77ff"
1242915834,sonia_gz,3,0,1,1,0.314448,0.602678,0,"#ffb3ff"
1243559353,univdeevora,36,3,0,3,0.538871,0.403886,0.000973,"#825403"
1243783518,belikesoftware,49,4,0,4,0.468298,0.535758,0.001459,"#ff7007"
1244028576,mmayayo65,19,0,1,1,0.661382,0.770485,0,"#00d3ff"
1244112038,estelasolis14,49,2,2,4,0.447491,0.580182,0.001459,"#ff7007"
1244126928,MaryoritArce,38,0,2,2,0.645012,0.399676,0.000486,"#662859"
1244399556,_nommon,14,0,1,1,0.647425,0.540311,0,"#00eeff"
1244657408,CCguerola,49,1,0,1,0.340054,0.676118,0,"#ff7007"
1244822947,ico_tovar73,17,0,1,1,0.928956,0.356152,0,"#ff9cc7"
1244980730,fjcacho,21,0,1,1,0.246055,0.199854,0,"#c6cc85"
1245079220,arsanz86,49,1,0,1,0.394119,0.632458,0,"#ff7007"
1245532302,agirrecenter,18,0,2,2,0.741225,0.607791,0.000486,"#5456a6"
1246537171,AnnieHuete_,38,0,2,2,0.32275,0.54864,0.000486,"#662859"
1246663254,gatokyejero,21,0,1,1,0.17444,0.241745,0,"#c6cc85"
1247619824,DamonCrockett,36,0,5,5,0.468929,0.504377,0.001946,"#825403"
1248366182,paogunti,31,0,1,1,0.660049,0.543676,0,"#3e93ff"
1248577753,jpinod02,14,33,71,104,0.546435,0.500935,0.050097,"#00eeff"
1248740485,ruestern,37,0,2,2,0.545236,0.528686,0.000486,"#006032"
1249074060,Montistyle,30,0,6,6,0.544742,0.524146,0.002432,"#ff77ff"
1249350655,Jcalzadafunes,22,0,2,2,0.549785,0.720392,0.000486,"#00e8b2"
1249384843,CardusL,14,0,1,1,0.607835,0.553803,0,"#00eeff"
1249634983,josastica,13,0,3,3,0.409407,0.394735,0.000973,"#3bec00"
1249672206,aalmarcegui,14,0,3,3,0.550776,0.521621,0.000973,"#00eeff"
1250382164,Luzmila_Lan,42,0,1,1,0.782504,0.366612,0,"#66e087"
1251332575,ZENODO_ORG,49,1,0,1,0.388903,0.522939,0,"#ff7007"
1251549229,javierjg333,14,53,39,92,0.480203,0.527673,0.044261,"#00eeff"
1252613112,SantoJob8,2,0,2,2,0.669318,0.660379,0.000486,"#ffa64e"
1254437756,eadanm,37,3,16,19,0.629288,0.348249,0.008755,"#006032"
1255398956,CarmenChifri,22,0,1,1,0.657875,0.504013,0,"#00e8b2"
1256884994,zinniaqc,49,3,2,5,0.237055,0.662314,0.001946,"#ff7007"
1257097610,herranz61,49,1,0,1,0.381968,0.650186,0,"#ff7007"
1257495614,fina_jgall,37,0,2,2,0.523322,0.643546,0.000486,"#006032"
1257632484,ifrit218,36,0,2,2,0.482311,0.192524,0.000486,"#825403"
1257715260,descemer2008,22,0,1,1,0.613825,0.62329,0,"#00e8b2"
1258924046,camaro_ro,22,0,2,2,0.735121,0.696987,0.000486,"#00e8b2"
1259082793,SOTTnetES,49,1,0,1,0.33272,0.655641,0,"#ff7007"
1259306508,AJoffres,49,3,16,19,0.477733,0.525992,0.008755,"#ff7007"
1259395213,HumanitatsUPF,22,4,3,7,0.5802,0.592584,0.002918,"#00e8b2"
1260270895,ImaniStreets,38,0,1,1,0.627043,0.359449,0,"#662859"
1260485684,cccastrog,34,0,1,1,0.328039,0.275875,0,"#ff0d69"
1260873752,AdnChvez,13,0,1,1,0.47592,0.344073,0,"#3bec00"
1261100976,yacofi76,38,0,1,1,0.672094,0.35174,0,"#662859"
1261672706,Inaemorienta,22,2,1,3,0.63283,0.435227,0.000973,"#00e8b2"
1262668158,kike22trk,38,0,1,1,0.077825,0.435654,0,"#662859"
1262812754,SpainInTheUSA,30,0,1,1,0.579278,0.662548,0,"#ff77ff"
1264361426,enisa,37,0,2,2,0.751237,0.509194,0.000486,"#006032"
1264619310,MariaValverde33,49,1,0,1,0.309704,0.643507,0,"#ff7007"
1264784004,Unsereno,30,1,0,1,0.709332,0.664115,0,"#ff77ff"
1265329434,NeilFrau,22,1,0,1,0.301023,0.725694,0,"#00e8b2"
1265340176,FacuArteULA,42,1,2,3,0.970881,0.404585,0.000973,"#66e087"
1265578519,sobrelamarchafm,42,1,2,3,0.995918,0.371447,0.000973,"#66e087"
1265727487,Interpreter_Mag,34,1,0,1,0.690949,0.37174,0,"#ff0d69"
1266612385,agbenito,36,5,3,8,0.729171,0.482353,0.003405,"#825403"
1266896785,PeriodismoULL,14,6,1,7,0.572743,0.645451,0.002918,"#00eeff"
1267438052,XavierMaldona15,34,0,1,1,0.339755,0.365101,0,"#ff0d69"
1267840423,Spanish_Exile,19,1,0,1,0.685342,0.789781,0,"#00d3ff"
1268182824,BtzMedina,19,0,1,1,0.642981,0.627118,0,"#00d3ff"
1268340104,ichi_ddm,0,0,1,1,0.404047,0.608694,0,"#8ecfec"
1269608983,MarysaEsteban,30,0,1,1,0.590387,0.679185,0,"#ff77ff"
1269704593,mariadusman,2,0,1,1,0.749711,0.528648,0,"#ffa64e"
1270025862,DataScientistsF,22,1,0,1,0.400306,0.470891,0,"#00e8b2"
1270169191,ana_sanoja,30,0,1,1,0.45902,0.594661,0,"#ff77ff"
1270875044,LeoOndulado21,34,0,1,1,0.554455,0.343321,0,"#ff0d69"
1271766630,AgiliceDigital,14,2,0,2,0.542456,0.59786,0.000486,"#00eeff"
1271920561,eba1402,17,0,1,1,0.838744,0.245202,0,"#ff9cc7"
1271939150,ViajarconelArte,30,0,1,1,0.523607,0.635646,0,"#ff77ff"
1271991211,protocolovista,58,0,2,2,0.591225,0.302717,0.000486,"#005076"
1272028578,AajAdolfo,40,0,1,1,0.589182,0.040123,0,"#ff12a3"
1272254682,cheffbeluga,30,0,1,1,0.603852,0.567684,0,"#ff77ff"
1272573150,ImpressoesRbds,36,17,0,17,0.507505,0.320864,0.007782,"#825403"
1273223682,PabloAmerico1,49,1,0,1,0.279395,0.545066,0,"#ff7007"
1274988512,Thefirstwoman__,30,0,1,1,0.51796,0.65689,0,"#ff77ff"
1275163994,f_torralba,8,2,0,2,0.679945,0.266536,0.000486,"#00ed5d"
1276442498,ulisess_salinas,13,0,2,2,0.433076,0.477825,0.000486,"#3bec00"
1277200513,nvallejog,9,9,18,27,0.668753,0.69068,0.012646,"#008f7b"
1277809026,MayraADiaz1,30,0,1,1,0.731244,0.654928,0,"#ff77ff"
1277917514,nancyaraly,34,0,1,1,0.555278,0.347532,0,"#ff0d69"
1278128527,recheverria15,3,2,2,4,0.453421,0.5426,0.001459,"#ffb3ff"
1278418008,JM_Morata,58,4,0,4,0.551279,0.570891,0.001459,"#005076"
1278498402,taisando,36,1,0,1,0.495918,0.231865,0,"#825403"
1278630271,YosoyelAfo,38,1,6,7,0.406291,0.401563,0.002918,"#662859"
1278913668,marmegal80,22,0,2,2,0.581237,0.681704,0.000486,"#00e8b2"
1279294836,ocampo_feli,14,0,1,1,0.639733,0.595587,0,"#00eeff"
1280688566,ccdpoa,36,0,1,1,0.493279,0.208999,0,"#825403"
1280732876,EstrellaGualda,49,0,1,1,0.582789,0.40236,0,"#ff7007"
1281324500,IBERBIBLIOTECA,14,1,1,2,0.620044,0.573428,0.000486,"#00eeff"
1281673860,MakerConvent,30,1,0,1,0.600174,0.436036,0,"#ff77ff"
1282969902,TEEMConference,14,6,4,10,0.518018,0.507288,0.004377,"#00eeff"
1283589494,UOCinfocom,14,0,4,4,0.545391,0.556122,0.001459,"#00eeff"
1283866897,MosaicoIdiomas,1,0,1,1,0.436864,0.643333,0,"#b6cb00"
1284259976,GehcMapa,30,0,1,1,0.602675,0.665092,0,"#ff77ff"
1284392876,sabine_seifert,49,0,1,1,0.342881,0.475495,0,"#ff7007"
1284695773,zahiebib,30,0,2,2,0.572438,0.590823,0.000486,"#ff77ff"
1285150255,thaliaro24,49,1,0,1,0.405373,0.668738,0,"#ff7007"
1285906740,AccesoUNC,49,0,2,2,0.406297,0.512497,0.000486,"#ff7007"
1286532732,TROVADORDIGITAL,38,1,3,4,0.696092,0.534427,0.001459,"#662859"
1286665722,PsgMx,30,0,4,4,0.538065,0.572461,0.001459,"#ff77ff"
1286800148,AlvaroCuellarDH,14,39,19,58,0.494397,0.563551,0.027724,"#00eeff"
1287242322,elcosterotv,49,0,1,1,0.433987,0.723021,0,"#ff7007"
1287837500,junjunnior,49,1,0,1,0.367213,0.645899,0,"#ff7007"
1288551986,CarmenEspejoC,14,1,17,18,0.553631,0.530344,0.008268,"#00eeff"
1288595294,cijeivissa,30,0,1,1,0.535895,0.642984,0,"#ff77ff"
1289664666,elgalolopez,49,0,3,3,0.431573,0.510479,0.000973,"#ff7007"
1289880120,alarreag,30,0,1,1,0.52139,0.624553,0,"#ff77ff"
1290021650,SegF100cias,7,0,1,1,0.515016,0.182292,0,"#ffb800"
1292460518,AlfilAbogados,1,0,1,1,0.356597,0.553346,0,"#b6cb00"
1292842885,xipariaxiparia,49,1,0,1,0.518431,0.27792,0,"#ff7007"
1294281439,LitERaFRicAs,14,0,1,1,0.298242,0.430785,0,"#00eeff"
1294699706,FrederiqHenry,36,0,1,1,0.551881,0.308509,0,"#825403"
1294839055,bibourense,0,0,1,1,0.328201,0.697211,0,"#8ecfec"
1298715679,Bibtntcsic,22,72,77,149,0.526026,0.542812,0.071984,"#00e8b2"
1299337105,profaMagaly,14,0,2,2,0.581396,0.599548,0.000486,"#00eeff"
1299811422,amarnal,22,0,2,2,0.564704,0.642745,0.000486,"#00e8b2"
1300033016,pepicapdevila,14,0,6,6,0.545127,0.513055,0.002432,"#00eeff"
1302058110,MiBarrioYungay,21,0,2,2,0.243251,0.233656,0.000486,"#c6cc85"
1304817019,TXICC,14,0,1,1,0.697423,0.425775,0,"#00eeff"
1305472543,udelar,55,1,0,1,0.6984,0.668732,0,"#cb3f32"
1305495408,scabrerahanna,34,0,9,9,0.460499,0.470676,0.003891,"#ff0d69"
1305710082,ecarpri,49,1,0,1,0.358712,0.652907,0,"#ff7007"
1306789693,gta_digital,14,1,0,1,0.615425,0.468575,0,"#00eeff"
1308279840,Francy3092,34,0,1,1,0.535878,0.340995,0,"#ff0d69"
1308969534,dtracy2,13,0,4,4,0.456677,0.456383,0.001459,"#3bec00"
1310182500,Albertop557,49,1,0,1,0.360269,0.684486,0,"#ff7007"
1310687167,Euge_LR,49,0,2,2,0.374891,0.603108,0.000486,"#ff7007"
1311127080,dcaceresjimenez,21,0,1,1,0.491449,0.954669,0,"#c6cc85"
1311555031,jfnavarrosj,2,0,2,2,0.663043,0.65432,0.000486,"#ffa64e"
1311555470,AitorSolar,1,0,2,2,0.511089,0.699582,0.000486,"#b6cb00"
1311870121,ddrartgallery,55,0,1,1,0.672122,0.55704,0,"#cb3f32"
1313491190,embrionhumano,49,1,0,1,0.331233,0.611853,0,"#ff7007"
1314364669,simone_fari,31,0,4,4,0.58892,0.516952,0.001459,"#3e93ff"
1314459104,RafaMayoGarcia,49,0,4,4,0.433845,0.510754,0.001459,"#ff7007"
1314787699,semrise,14,0,1,1,0.668967,0.409452,0,"#00eeff"
1314810318,FerMirandaG,22,1,0,1,0.670201,0.622652,0,"#00e8b2"
1316404598,iambrandao,49,0,4,4,0.43375,0.514075,0.001459,"#ff7007"
1316630564,renithmunoz,38,0,1,1,0.652514,0.389519,0,"#662859"
1317006746,navarroanama,31,0,2,2,0.590118,0.498686,0.000486,"#3e93ff"
1317057546,PromoCursos,7,0,1,1,0.431653,0.046304,0,"#ffb800"
1317142405,arqueologiabcn,30,0,1,1,0.495625,0.623225,0,"#ff77ff"
1317208364,eymar_rodrguez,42,0,1,1,0.896159,0.433518,0,"#66e087"
1318159158,Vocalinet,49,1,0,1,0.389669,0.626891,0,"#ff7007"
1318784605,AMartinezSTJ,30,0,1,1,0.486238,0.650074,0,"#ff77ff"
1319164070,CCuruguay,55,19,7,26,0.590866,0.610249,0.01216,"#cb3f32"
1319230088,clarasil44,30,2,3,5,0.501577,0.63776,0.001946,"#ff77ff"
1319302765,FMadrigalH,49,1,0,1,0.391575,0.646522,0,"#ff7007"
1319440692,91LauraMichelle,7,0,1,1,0.353041,0.45276,0,"#ffb800"
1319682974,RuthMostern,36,1,0,1,0.561572,0.386876,0,"#825403"
1320094220,MJessMartnezVi,13,0,1,1,0.422706,0.499104,0,"#3bec00"
1321460436,FrioTemplado,38,1,1,2,0.417752,0.231503,0.000486,"#662859"
1321865468,fundacion1mayo,19,7,0,7,0.632488,0.728653,0.002918,"#00d3ff"
1322186852,mfranco_uah,22,0,1,1,0.612121,0.596599,0,"#00e8b2"
1322280522,espacioRH,31,1,4,5,0.59711,0.549177,0.001946,"#3e93ff"
1322976715,eduard_arriaga,13,11,24,35,0.488803,0.466217,0.016537,"#3bec00"
1323049752,Dip_Cardoza,7,1,0,1,0.794383,0.619102,0,"#ffb800"
1323133321,LeoCalvoFlores,49,1,0,1,0.336072,0.670453,0,"#ff7007"
1323620090,pommeorama,42,0,1,1,0.625187,0.671164,0,"#66e087"
1324383199,PremiosCLAP,22,3,2,5,0.53954,0.612064,0.001946,"#00e8b2"
1325047944,SUIEVUNAM,7,0,1,1,0.416447,0.202026,0,"#ffb800"
1325449124,ErnestoConta,49,0,4,4,0.445458,0.560103,0.001459,"#ff7007"
1325514038,idaesoficial,37,32,1,33,0.336832,0.479494,0.015564,"#006032"
1326508478,CorpusSocialSci,55,1,0,1,0.704623,0.526405,0,"#cb3f32"
1326666235,EvaNestares,14,0,3,3,0.453691,0.534328,0.000973,"#00eeff"
1326770444,ClausenZ,7,0,4,4,0.442821,0.408502,0.001459,"#ffb800"
1327337976,beatyesth,13,0,3,3,0.49111,0.445829,0.000973,"#3bec00"
1327667136,falconylagunes,10,1,1,2,0.664415,0.815194,0.000486,"#52d7c0"
1328113728,CAReyesG,21,0,2,2,0.218867,0.267717,0.000486,"#c6cc85"
1328668093,SiasAsociacion,22,1,0,1,0.49367,0.665086,0,"#00e8b2"
1329025946,humanizacorp,49,1,0,1,0.37464,0.621709,0,"#ff7007"
1329422666,jupiteriana2020,38,0,1,1,0.580319,0.353043,0,"#662859"
1329487320,czeltsman,34,0,1,1,0.530082,0.346972,0,"#ff0d69"
1330190612,FelipeGlezSEO,49,1,0,1,0.322487,0.682991,0,"#ff7007"
1331233394,MartinezLab,14,1,14,15,0.543098,0.520016,0.006809,"#00eeff"
1332056269,copicentrogra,31,0,1,1,0.66835,0.54089,0,"#3e93ff"
1333762861,missbaixue,13,0,1,1,0.403578,0.483989,0,"#3bec00"
1334228636,Dpujado77,0,0,2,2,0.574355,0.541041,0.000486,"#8ecfec"
1334812783,miquelpuigrapos,8,1,0,1,0.70071,0.252823,0,"#00ed5d"
1335228152,_Proyecta_,21,0,2,2,0.22346,0.262859,0.000486,"#c6cc85"
1336170068,_usj_,30,1,1,2,0.766528,0.658515,0.000486,"#ff77ff"
1336302619,AriasuGluitz,14,0,2,2,0.622367,0.624886,0.000486,"#00eeff"
1337406691,anhvenezuela,42,0,1,1,0.775536,0.538272,0,"#66e087"
1337800226,lgentoatahona,30,1,4,5,0.562115,0.527994,0.001946,"#ff77ff"
1337840749,Cathdavies52,58,0,1,1,0.568395,0.715093,0,"#005076"
1338243680,ursulacamba,37,12,0,12,0.476603,0.290438,0.00535,"#006032"
1338795841,ArqueoTrip,13,1,0,1,0.344952,0.436188,0,"#3bec00"
1339760053,Algonfdez,40,0,1,1,0.599889,0.035723,0,"#ff12a3"
1340547300,APalacio_s,21,0,1,1,0.320231,0.45625,0,"#c6cc85"
1340721872,DeMareDani,49,4,17,21,0.481453,0.535886,0.009728,"#ff7007"
1341462944,paoloigna1,14,0,6,6,0.618534,0.518648,0.002432,"#00eeff"
1341685472,roman_klinger,34,1,1,2,0.420472,0.47598,0.000486,"#ff0d69"
1341697015,bibrepublica,30,4,2,6,0.477088,0.705665,0.002432,"#ff77ff"
1341757860,CritRikk,36,0,1,1,0.380811,0.47333,0,"#825403"
1342503163,davidveisaga,3,0,2,2,0.424268,0.573835,0.000486,"#ffb3ff"
1342906472,LEONBENAVENTE,31,1,0,1,0.646121,0.515656,0,"#3e93ff"
1343687702,tifice_purrr3ly,22,0,1,1,0.406556,0.603119,0,"#00e8b2"
1343788526,Future4Work,49,1,0,1,0.313965,0.693154,0,"#ff7007"
1344361478,karenymey,30,0,2,2,0.591931,0.640006,0.000486,"#ff77ff"
1344637898,Jose_LunaH,38,0,1,1,0.664874,0.34566,0,"#662859"
1344741816,isabelperis23,55,0,1,1,0.653983,0.675015,0,"#cb3f32"
1344804456,ecmsilva,38,0,4,4,0.518287,0.453944,0.001459,"#662859"
1345005890,antoniobb1953,19,0,2,2,0.61746,0.664277,0.000486,"#00d3ff"
1345328142,GemaWebsoc,30,1,28,29,0.534454,0.523149,0.013619,"#ff77ff"
1346120772,godoy_saul,49,1,0,1,0.424098,0.663974,0,"#ff7007"
1346497370,ESTUNED,30,0,1,1,0.587564,0.666476,0,"#ff77ff"
1346503532,EnginyeriaUAB,14,5,3,8,0.542094,0.505105,0.003405,"#00eeff"
1347323096,cpfsesc,36,1,0,1,0.531681,0.210887,0,"#825403"
1347399595,Jumar51,49,1,0,1,0.334336,0.605694,0,"#ff7007"
1347795078,PesanboPsanchis,3,0,1,1,0.78321,0.561599,0,"#ffb3ff"
1347820488,PeggyRadio,34,0,2,2,0.378025,0.451214,0.000486,"#ff0d69"
1348144034,TamezAD,41,1,2,3,0.38247,0.436667,0.000973,"#697b00"
1348481329,cgruiz1,1,0,4,4,0.468528,0.591766,0.001459,"#b6cb00"
1348828734,cojoidea,14,1,8,9,0.527162,0.513865,0.003891,"#00eeff"
1349374094,LIZARRAGASTELLA,22,0,1,1,0.608393,0.606515,0,"#00e8b2"
1351396117,RAFAELLEALSALAZ,19,0,2,2,0.667841,0.75156,0.000486,"#00d3ff"
1353159614,lesliesleiq,42,0,2,2,0.68335,0.471649,0.000486,"#66e087"
1354233440,co_geografiacyl,22,0,1,1,0.666029,0.411463,0,"#00e8b2"
1354502714,ARoldanLpz,22,0,1,1,0.65482,0.477845,0,"#00e8b2"
1354583904,madipeciosa,49,1,0,1,0.401751,0.70252,0,"#ff7007"
1354730179,zaxerasolutions,49,1,0,1,0.354896,0.613298,0,"#ff7007"
1355203866,true_mxp,13,0,5,5,0.470704,0.515809,0.001946,"#3bec00"
1355363725,Reciaria,49,3,85,88,0.47274,0.555849,0.042315,"#ff7007"
1355673944,julianaFYL,34,0,1,1,0.552651,0.415704,0,"#ff0d69"
1355958830,indigenistas,7,1,0,1,0.455553,0.146178,0,"#ffb800"
1356031014,210StacyY,34,0,2,2,0.350971,0.421542,0.000486,"#ff0d69"
1356382472,aragar2013,58,0,5,5,0.510355,0.597265,0.001946,"#005076"
1356953850,FrontHistoria,13,0,1,1,0.540957,0.46394,0,"#3bec00"
1357937124,spbifmo_en,14,1,1,2,0.593682,0.390851,0.000486,"#00eeff"
1357953271,DFEspanyola,14,3,9,12,0.498111,0.562044,0.00535,"#00eeff"
1358892625,IvandariasA,3,0,3,3,0.558831,0.69319,0.000973,"#ffb3ff"
1359538453,knavarrotx4evr,34,0,2,2,0.36421,0.409063,0.000486,"#ff0d69"
1359982830,fundacioflama,37,0,3,3,0.633115,0.489079,0.000973,"#006032"
1360004185,ParluciagaC,21,0,2,2,0.249543,0.217552,0.000486,"#c6cc85"
1360086968,jaime_bonet,38,0,1,1,0.66473,0.465748,0,"#662859"
1362152348,FERNEYBENAVIDE2,3,0,1,1,0.487553,0.749448,0,"#ffb3ff"
1363363872,griselafe,49,1,0,1,0.395157,0.672035,0,"#ff7007"
1364004426,rochamarias,7,0,3,3,0.464189,0.403261,0.000973,"#ffb800"
1364326988,rociojana,21,0,1,1,0.310722,0.43374,0,"#c6cc85"
1364420106,PhilologistGRC,36,0,1,1,0.476931,0.277871,0,"#825403"
1364462066,icam_es,19,3,0,3,0.613662,0.762007,0.000973,"#00d3ff"
1364729269,trinitero,1,0,2,2,0.652676,0.460808,0.000486,"#b6cb00"
1364802517,CERL_org,30,3,0,3,0.448182,0.620429,0.000973,"#ff77ff"
1365016345,dirpoblaciones,38,1,2,3,0.599523,0.386366,0.000973,"#662859"
1367254712,GonroMelen,36,0,1,1,0.550696,0.358663,0,"#825403"
1367325420,fidosigueaqui,22,0,7,7,0.544512,0.486979,0.002918,"#00e8b2"
1370377399,zonabogotadc,38,0,1,1,0.603792,0.360368,0,"#662859"
1370451145,ArielKuri,7,0,2,2,0.432262,0.319951,0.000486,"#ffb800"
1370549642,FaresJadue,21,0,1,1,0.204622,0.19823,0,"#c6cc85"
1371593546,AJIHLE1,1,2,11,13,0.494407,0.576156,0.005837,"#b6cb00"
1371830424,RafaelH46,30,0,1,1,0.549615,0.646543,0,"#ff77ff"
1372230546,CatedraTermes,22,0,2,2,0.634931,0.556065,0.000486,"#00e8b2"
1373313115,gennichurches,49,1,0,1,0.29916,0.624253,0,"#ff7007"
1373616212,Semshgo,17,0,1,1,0.907537,0.381353,0,"#ff9cc7"
1373704710,tianalejfg,41,0,1,1,0.323796,0.382474,0,"#697b00"
1374693066,omsihcam_,49,0,1,1,0.280145,0.599474,0,"#ff7007"
1375420808,CRYOFFEARSIMON,38,0,1,1,0.794343,0.641026,0,"#662859"
1376571565,nimbooks_es,0,1,0,1,0.461254,0.344213,0,"#8ecfec"
1376728963,SerranMara,30,0,2,2,0.626565,0.530036,0.000486,"#ff77ff"
1377767730,CerstinMahlow,53,0,3,3,0.465937,0.554291,0.000973,"#008bdd"
1377802946,EULOVEJA,0,0,2,2,0.397354,0.549688,0.000486,"#8ecfec"
1378967467,CamDigHum,13,9,5,14,0.492155,0.501172,0.006323,"#3bec00"
1379048250,FormaInnovaUPO,58,0,2,2,0.401294,0.619915,0.000486,"#005076"
1379068902,euTUlankide,18,2,0,2,0.735228,0.643889,0.000486,"#5456a6"
1379540017,alimiguelez,36,0,3,3,0.522375,0.418672,0.000973,"#825403"
1380410280,Gjnp52N,49,1,0,1,0.371144,0.605589,0,"#ff7007"
1381759784,AntRiqGom,22,0,3,3,0.499815,0.637119,0.000973,"#00e8b2"
1381786129,AEDOM_IAML,34,5,6,11,0.338801,0.585345,0.004864,"#ff0d69"
1382216684,juliocvizcarra,31,0,4,4,0.517458,0.556407,0.001459,"#3e93ff"
1382327035,Andresk0224,13,2,3,5,0.560169,0.524399,0.001946,"#3bec00"
1382448254,rtorres_javier,15,0,10,10,0.568735,0.616069,0.004377,"#008ebb"
1382478956,STecnicaCoah,17,0,1,1,0.730109,0.806311,0,"#ff9cc7"
1382668376,adrianaaaa14_,15,0,1,1,0.653494,0.710873,0,"#008ebb"
1383030151,mariaasoliveira,2,0,2,2,0.664083,0.658258,0.000486,"#ffa64e"
1383189894,SalayaRaul,41,0,2,2,0.346781,0.39377,0.000486,"#697b00"
1383297936,MEVidalSerodio,22,0,1,1,0.598521,0.623072,0,"#00e8b2"
1383812112,LaMaraDice,3,1,0,1,0.619156,0.576259,0,"#ffb3ff"
1384509930,fernndez_lidia,1,0,1,1,0.344102,0.745748,0,"#b6cb00"
1385387569,LSalmeron_UV,15,1,0,1,0.500342,0.741034,0,"#008ebb"
1386426673,antonioortizma2,19,6,6,12,0.639273,0.756873,0.00535,"#00d3ff"
1387915232,Elijah_Meeks,31,19,0,19,0.558089,0.498497,0.008755,"#3e93ff"
1387925532,EddyIU,19,1,0,1,0.618557,0.790628,0,"#00d3ff"
1387941218,Juan_A_Lleo,22,0,2,2,0.56635,0.627242,0.000486,"#00e8b2"
1388707386,fsifuentes16,34,0,3,3,0.392061,0.433323,0.000973,"#ff0d69"
1390008950,Europeana,31,3,0,3,0.613508,0.545312,0.000973,"#3e93ff"
1390140696,DevinFitzger,34,0,1,1,0.543435,0.337489,0,"#ff0d69"
1390801316,scms___,13,0,1,1,0.641365,0.988849,0,"#3bec00"
1392241081,flopezUNED,30,0,3,3,0.548419,0.610999,0.000973,"#ff77ff"
1392498926,AlhzMel,41,0,1,1,0.332765,0.380556,0,"#697b00"
1392580705,araya_gatica,21,0,1,1,0.221247,0.236381,0,"#c6cc85"
1393041685,pzalamea,34,50,21,71,0.562267,0.397705,0.034047,"#ff0d69"
1393438046,Filosofafando,7,0,2,2,0.417346,0.361144,0.000486,"#ffb800"
1393618710,Piadosaquerida,7,0,2,2,0.389015,0.357132,0.000486,"#ffb800"
1393742856,korimaru0206,49,1,0,1,0.289785,0.631333,0,"#ff7007"
1393781958,KafSofit,13,0,4,4,0.41911,0.444895,0.001459,"#3bec00"
1395981188,Donachepe,3,0,1,1,0.452001,0.740921,0,"#ffb3ff"
1396028191,siulaitipse,38,0,1,1,0.419634,0.763802,0,"#662859"
1396616353,PortalClasico,22,2,0,2,0.491521,0.616414,0.000486,"#00e8b2"
1396633124,iesmachado,19,1,0,1,0.631101,0.77801,0,"#00d3ff"
1397105329,CMEditores,22,1,0,1,0.596636,0.603655,0,"#00e8b2"
1397324270,DLucioArias,37,0,1,1,0.568532,0.352074,0,"#006032"
1398173120,jufransal,0,0,2,2,0.603207,0.541951,0.000486,"#8ecfec"
1398194418,OceanoColombia,38,4,0,4,0.639009,0.22013,0.001459,"#662859"
1398346524,AbiTey,7,0,1,1,0.367269,0.356687,0,"#ffb800"
1400266070,__Arasti,30,0,1,1,0.561671,0.729246,0,"#ff77ff"
1400301217,rubentebes,7,0,1,1,0.713474,0.492702,0,"#ffb800"
1401796034,RNavigli,36,2,0,2,0.500475,0.361341,0.000486,"#825403"
1402733238,cbtis200,17,0,1,1,0.937341,0.374212,0,"#ff9cc7"
1403186119,CCISIC,31,0,10,10,0.553323,0.518107,0.004377,"#3e93ff"
1404397248,RadioLinaresSER,1,0,1,1,0.553611,0.702096,0,"#b6cb00"
1404402636,Rosa_M_Herrera,30,0,1,1,0.723618,0.641865,0,"#ff77ff"
1404531452,jorgecarrion21,7,17,2,19,0.706157,0.600922,0.008755,"#ffb800"
1405262366,HistoriaMujeres,19,5,0,5,0.626181,0.736101,0.001946,"#00d3ff"
1407376640,UCAM_Investiga,22,11,2,13,0.548101,0.491913,0.005837,"#00e8b2"
1407956173,jerarte77,14,0,2,2,0.584497,0.482671,0.000486,"#00eeff"
1408212966,CSM_Canarias,22,1,0,1,0.524501,0.67319,0,"#00e8b2"
1408414056,Adralezzz,38,0,1,1,0.092649,0.43117,0,"#662859"
1409137722,EDIE_75844,22,0,1,1,0.575393,0.838225,0,"#00e8b2"
1409619716,EDITORIALUS,1,5,1,6,0.448341,0.639437,0.002432,"#b6cb00"
1409680645,LibreriaAntes,37,0,2,2,0.635489,0.401903,0.000486,"#006032"
1410036919,CEI_E3,22,4,1,5,0.634874,0.487231,0.001946,"#00e8b2"
1410780090,Impulsora_SM,49,1,0,1,0.356997,0.661622,0,"#ff7007"
1411409894,AmLegan,30,0,3,3,0.554674,0.569813,0.000973,"#ff77ff"
1412481931,Robservando,2,0,1,1,0.400062,0.553143,0,"#ffa64e"
1413139855,franjagoga,16,0,2,2,0.93714,0.68036,0.000486,"#c42c63"
1413577800,GuillenMelilla,16,0,3,3,0.933212,0.654145,0.000973,"#c42c63"
1413886358,onGranadaTC,31,0,4,4,0.618034,0.540575,0.001459,"#3e93ff"
1414047918,luluonti,47,0,1,1,0.600361,0.186514,0,"#a091c4"
1415952834,MeaningCloud,0,1,0,1,0.419959,0.607351,0,"#8ecfec"
1416234308,Mr_Auk,13,0,1,1,0.512787,0.311087,0,"#3bec00"
1416545322,mpa2013,30,0,1,1,0.488293,0.621753,0,"#ff77ff"
1416737262,soccerbrarian,36,0,9,9,0.3696,0.425386,0.003891,"#825403"
1417666956,humdigital,30,69,187,256,0.511798,0.535794,0.124027,"#ff77ff"
1417891736,RocioDiazBravo,49,2,4,6,0.476641,0.547238,0.002432,"#ff7007"
1418796804,LuisCaraballoV,42,1,0,1,0.830729,0.460969,0,"#66e087"
1418803238,jose_bca,14,0,1,1,0.658449,0.561997,0,"#00eeff"
1418968513,PjaimesV,49,1,0,1,0.417869,0.668398,0,"#ff7007"
1421172834,UWuttke,49,0,4,4,0.432067,0.497641,0.001459,"#ff7007"
1421382732,BelisiG,30,0,1,1,0.522936,0.631276,0,"#ff77ff"
1421828646,hilariojbg,31,0,3,3,0.615599,0.558586,0.000973,"#3e93ff"
1422872528,LaSextaBrava,2,0,1,1,0.762969,0.528533,0,"#ffa64e"
1423761577,EmbajadoraPaz,22,0,1,1,0.381203,0.507966,0,"#00e8b2"
1424038681,redcts,22,2,0,2,0.524813,0.270222,0.000486,"#00e8b2"
1424493979,LuisLuiskiss1,13,0,1,1,0.387072,0.322125,0,"#3bec00"
1425598472,BiblioUNEDTalav,30,1,4,5,0.501463,0.538099,0.001946,"#ff77ff"
1425716838,RocRodriguez75,30,0,1,1,0.566225,0.667039,0,"#ff77ff"
1425730074,usalcampuspilar,37,0,5,5,0.418507,0.561042,0.001946,"#006032"
1426191079,Agora_Research,30,0,1,1,0.509651,0.623572,0,"#ff77ff"
1427070265,AleJuarezA,7,0,5,5,0.448514,0.403016,0.001946,"#ffb800"
1427460212,ANECAinfo,31,5,0,5,0.665917,0.564185,0.001946,"#3e93ff"
1427768232,linea_docentes,49,2,0,2,0.414763,0.572244,0.000486,"#ff7007"
1428230142,proyectoitaca,49,1,0,1,0.329829,0.6935,0,"#ff7007"
1428236071,agfre90,38,0,1,1,0.358518,0.248703,0,"#662859"
1428859495,carolinaveotero,2,0,3,3,0.652981,0.597147,0.000973,"#ffa64e"
1430182141,MaruperezgM,35,0,1,1,0.413023,0.613979,0,"#00faff"
1430354491,angelsreinoso,31,0,1,1,0.739912,0.927702,0,"#3e93ff"
1430632962,historiaceu,2,7,4,11,0.526139,0.550451,0.004864,"#ffa64e"
1430883972,disidentegarcia,38,0,1,1,0.287456,0.196282,0,"#662859"
1431800994,gonzlaur,41,5,7,12,0.47552,0.449536,0.00535,"#697b00"
1432284882,Jesolnun,1,1,0,1,0.483232,0.787096,0,"#b6cb00"
1432795423,Laura_arreaza,38,0,5,5,0.525002,0.437366,0.001946,"#662859"
1433728548,amesonmiguel,30,0,1,1,0.575234,0.674133,0,"#ff77ff"
1434309554,jjimeneza1972,21,0,1,1,0.310731,0.456036,0,"#c6cc85"
1434359630,gimenadelr,49,568,345,913,0.462297,0.517137,0.44358,"#ff7007"
1434546084,InfoDili,34,0,1,1,0.479759,0.358485,0,"#ff0d69"
1435358221,DominiqueVinck,53,8,0,8,0.51992,0.646065,0.003405,"#008bdd"
1435577209,LCGIDVL,13,0,1,1,0.475626,0.340961,0,"#3bec00"
1436589000,BibliotecAntofa,21,0,2,2,0.279473,0.22798,0.000486,"#c6cc85"
1437183534,MayoVGil,13,0,2,2,0.417293,0.443717,0.000486,"#3bec00"
1438478256,icaroviedo,22,0,1,1,0.659566,0.601057,0,"#00e8b2"
1438840616,ConSusan1,49,0,1,1,0.434452,0.62897,0,"#ff7007"
1438951957,AgustinaVinagre,14,0,2,2,0.489865,0.529588,0.000486,"#00eeff"
1439066377,Constanzaveron,49,2,0,2,0.374684,0.520308,0.000486,"#ff7007"
1441370094,susdeloiza,8,0,1,1,0.263988,0.260565,0,"#00ed5d"
1442258528,Claire_Taylor_M,38,1,3,4,0.441136,0.378402,0.001459,"#662859"
1443790717,INNOVASalamanca,30,5,4,9,0.506454,0.576919,0.003891,"#ff77ff"
1444277852,K_FabiolaSG,52,0,2,2,0.927614,0.781737,0.000486,"#b56eed"
1446304399,PousTeresa,15,0,1,1,0.667566,0.435041,0,"#008ebb"
1446765895,CollazosWILSON,37,0,2,2,0.68098,0.505751,0.000486,"#006032"
1447039369,juanjose_prieto,17,0,1,1,0.898456,0.367316,0,"#ff9cc7"
1447116511,durmancro,49,1,0,1,0.343019,0.617756,0,"#ff7007"
1447158782,mariana_rivas03,13,1,0,1,0.358859,0.314508,0,"#3bec00"
1447207944,museodeltrajeba,50,4,1,5,0.559659,0.066906,0.001946,"#ff76c3"
1447824714,_HAHG,21,0,1,1,0.221652,0.220105,0,"#c6cc85"
1448529001,bilbaometropoli,49,1,1,2,0.336584,0.699428,0.000486,"#ff7007"
1449179862,mariagabal,2,0,1,1,0.405489,0.547538,0,"#ffa64e"
1449354402,mtorayam,38,0,5,5,0.54189,0.510088,0.001946,"#662859"
1449389725,eatm_escola,8,1,3,4,0.669725,0.356362,0.001459,"#00ed5d"
1449420901,ClauPimienta01,49,1,0,1,0.401732,0.65651,0,"#ff7007"
1449508092,_gabynm,17,0,1,1,0.924863,0.369531,0,"#ff9cc7"
1449563072,Ceeict,49,2,0,2,0.44457,0.635176,0.000486,"#ff7007"
1450156164,FUNDAPROCECA,49,0,1,1,0.914575,0.231601,0,"#ff7007"
1451522498,Silvinacasab,49,8,3,11,0.694372,0.728488,0.004864,"#ff7007"
1451814246,juanmadiga,13,0,1,1,0.484646,0.397395,0,"#3bec00"
1451950994,informaticaupm,22,2,0,2,0.567791,0.664583,0.000486,"#00e8b2"
1452617112,PreziEspanol,3,0,3,3,0.46226,0.563387,0.000973,"#ffb3ff"
1452643532,mariatocco1949,1,0,2,2,0.468913,0.62619,0.000486,"#b6cb00"
1453560872,ALMUGOGAR,30,0,1,1,0.582542,0.574091,0,"#ff77ff"
1454215178,PerformantSoft,34,0,2,2,0.349539,0.401681,0.000486,"#ff0d69"
1454695896,mariposafyf,3,0,1,1,0.459289,0.767765,0,"#ffb3ff"
1455797641,Eduardo_Estrad,7,0,1,1,0.372242,0.364663,0,"#ffb800"
1457224374,LaUnionAM,37,2,0,2,0.227209,0.528993,0.000486,"#006032"
1457386861,ReddocentesIB,31,1,0,1,0.718518,0.402447,0,"#3e93ff"
1458249594,ines8117,31,0,1,1,0.670096,0.532379,0,"#3e93ff"
1459359793,FurorBacTeatro,1,0,1,1,0.438069,0.59673,0,"#b6cb00"
1459915429,xsrayo,34,0,1,1,0.543032,0.388901,0,"#ff0d69"
1460106924,Divulguemos,49,1,0,1,0.331482,0.67318,0,"#ff7007"
1460132838,tadeuscalinca,30,1,0,1,0.58269,0.64673,0,"#ff77ff"
1461763134,cristina_azorin,14,6,15,21,0.59267,0.531831,0.009728,"#00eeff"
1462609603,RojasCastroA,34,116,0,116,0.489766,0.500667,0.055934,"#ff0d69"
1462861249,FREDDYMALDONA10,3,0,1,1,0.48208,0.775355,0,"#ffb3ff"
1463170988,ccii_pucp,49,11,7,18,0.473318,0.505575,0.008268,"#ff7007"
1463347147,paoferreiray,49,0,4,4,0.367621,0.460681,0.001459,"#ff7007"
1464275659,clau__mb,49,1,0,1,0.333677,0.616202,0,"#ff7007"
1465046582,xabycastro,38,0,1,1,0.73883,0.456408,0,"#662859"
1465068445,Sociologia_UMA,22,0,1,1,0.561061,0.310925,0,"#00e8b2"
1465395494,albertobaezav,40,0,1,1,0.629015,0.03178,0,"#ff12a3"
1465608511,SanzBrb,34,0,4,4,0.495716,0.427066,0.001459,"#ff0d69"
1465812450,osfermor,40,0,1,1,0.575041,0.030724,0,"#ff12a3"
1466727978,imorenomelilla,16,0,2,2,0.948682,0.651091,0.000486,"#c42c63"
1466978593,MuseoAlmeria,2,41,5,46,0.660535,0.626494,0.021887,"#ffa64e"
1467467323,tommilesz,34,0,1,1,0.434788,0.426658,0,"#ff0d69"
1467662120,HistoriayGrafia,13,0,1,1,0.453244,0.305624,0,"#3bec00"
1467763650,metahistoriacom,2,3,4,7,0.583457,0.545493,0.002918,"#ffa64e"
1467859310,jorgerojasjara,21,0,2,2,0.212046,0.233875,0.000486,"#c6cc85"
1468235288,TiberioUned,30,0,5,5,0.540148,0.583148,0.001946,"#ff77ff"
1468237442,GVA_Cefire,31,1,0,1,0.644318,0.482737,0,"#3e93ff"
1468395541,LacuadraU,49,3,0,3,0.449908,0.60341,0.000973,"#ff7007"
1468767757,MacResndiz,34,1,0,1,0.459322,0.211542,0,"#ff0d69"
1470808525,chrisferock,13,0,4,4,0.44352,0.471325,0.001459,"#3bec00"
1470897806,NimbostratusPan,48,0,1,1,0.222778,0.732773,0,"#ff7a78"
1470962196,abejapoblana,7,0,1,1,0.781683,0.309613,0,"#ffb800"
1471377475,melirocy,21,0,2,2,0.257037,0.220794,0.000486,"#c6cc85"
1471765807,MaddyGhezzi,58,0,3,3,0.477639,0.584794,0.000973,"#005076"
1472003108,UAM_Biblioteca,22,1,0,1,0.484336,0.674179,0,"#00e8b2"
1472321364,ilanadima,30,0,1,1,0.582526,0.663411,0,"#ff77ff"
1472403036,Alan_MJ97,31,0,1,1,0.670683,0.536911,0,"#3e93ff"
1473434310,Amo_elCafe,13,47,30,77,0.474542,0.434669,0.036965,"#3bec00"
1473829794,JoseAlvarezVela,21,0,2,2,0.327599,0.76049,0.000486,"#c6cc85"
1475562434,jurenasoy,30,1,0,1,0.56798,0.760807,0,"#ff77ff"
1475804305,GgarciaGarca,58,0,3,3,0.584752,0.427948,0.000973,"#005076"
1475874894,martabures,55,1,0,1,0.721121,0.543767,0,"#cb3f32"
1477511792,PaloCoyote,37,0,1,1,0.545595,0.76233,0,"#006032"
1478114664,mvillasolmeda,0,0,1,1,0.375624,0.559747,0,"#8ecfec"
1478670253,kroqueti,38,0,1,1,0.604014,0.34537,0,"#662859"
1478697433,Lambda81,42,0,1,1,0.712148,0.460804,0,"#66e087"
1479315451,LourdesCanos,22,0,2,2,0.600209,0.330912,0.000486,"#00e8b2"
1479375313,RadioCirculo,37,0,1,1,0.694348,0.489151,0,"#006032"
1479448800,Francois_Ronan,30,1,2,3,0.484996,0.509203,0.000973,"#ff77ff"
1479949604,marugenial23,49,1,0,1,0.381482,0.682208,0,"#ff7007"
1480392636,ManuelBermudezV,31,1,0,1,0.789088,0.47526,0,"#3e93ff"
1480492747,mebemar,34,0,1,1,0.323364,0.400332,0,"#ff0d69"
1481678084,VivatVivere,30,0,2,2,0.500199,0.59737,0.000486,"#ff77ff"
1482391794,revista_andamio,21,0,2,2,0.226169,0.252581,0.000486,"#c6cc85"
1482525343,Stewart_Brookes,49,0,1,1,0.344798,0.463334,0,"#ff7007"
1482692202,MarcosCueto4,36,0,1,1,0.548397,0.276575,0,"#825403"
1482692473,CBardiot,14,0,2,2,0.55556,0.479848,0.000486,"#00eeff"
1483166647,Thesaurarius,22,87,10,97,0.461305,0.564926,0.046693,"#00e8b2"
1483269714,Bibliotecas_Mx,1,2,0,2,0.381309,0.469922,0.000486,"#b6cb00"
1483424004,marijosemas,1,0,2,2,0.665273,0.454004,0.000486,"#b6cb00"
1483583821,The_Cumberlady,37,1,0,1,0.693414,0.296603,0,"#006032"
1484021312,NoSoyDolores_,3,0,1,1,0.461152,0.771509,0,"#ffb3ff"
1484741923,Susana_Clavero,58,0,1,1,0.56898,0.188666,0,"#005076"
1485086102,RTVENavarra,1,0,1,1,0.668131,0.440872,0,"#b6cb00"
1486128457,musicaunirio,36,0,1,1,0.427112,0.250657,0,"#825403"
1488278989,KoworkTemuco,49,0,3,3,0.382507,0.503139,0.000973,"#ff7007"
1488375698,HDHispanicas,14,458,151,609,0.518728,0.508634,0.29572,"#00eeff"
1488547476,Edmundo1455,49,1,0,1,0.407346,0.630024,0,"#ff7007"
1489399164,chileanscience,21,0,1,1,0.187904,0.401507,0,"#c6cc85"
1490329063,ImgenesH,19,1,0,1,0.674096,0.76339,0,"#00d3ff"
1490907883,carlosrmar,17,0,1,1,0.635055,0.281413,0,"#ff9cc7"
1491197510,sanden_jurgen,30,0,1,1,0.620751,0.477176,0,"#ff77ff"
1491426895,TorstenHiltmann,13,0,1,1,0.406345,0.415937,0,"#3bec00"
1493184920,daltonr8,55,0,4,4,0.676014,0.644209,0.001459,"#cb3f32"
1494108830,MarcelinoAzul,21,0,1,1,0.273028,0.206454,0,"#c6cc85"
1495222837,rubendecu,30,0,4,4,0.530154,0.591811,0.001459,"#ff77ff"
1496158700,_JMagna_,38,0,1,1,0.806566,0.656633,0,"#662859"
1496191374,mcriado10,14,0,2,2,0.672071,0.561727,0.000486,"#00eeff"
1497361842,adelyc_ac,30,0,1,1,0.630724,0.58681,0,"#ff77ff"
1497712388,CuadernodeLuis,14,0,6,6,0.540468,0.656946,0.002432,"#00eeff"
1499416622,laura_tamia,22,0,1,1,0.606328,0.602656,0,"#00e8b2"
1500038552,libroinnovacion,31,0,1,1,0.73809,0.925108,0,"#3e93ff"
1500241778,franfavieri,37,0,2,2,0.361381,0.422532,0.000486,"#006032"
1504167206,SandraMadiedoRu,49,0,1,1,0.278229,0.649986,0,"#ff7007"
1507235348,Mexico_Journal,7,0,3,3,0.500769,0.413496,0.000973,"#ffb800"
1508270750,marjo2018,21,0,1,1,0.208944,0.236074,0,"#c6cc85"
1508746440,TrishHepworth,38,0,3,3,0.422553,0.347669,0.000973,"#662859"
1511334488,psicoudelar,55,14,4,18,0.666688,0.643079,0.008268,"#cb3f32"
1512706177,FeliArniz,22,0,3,3,0.549076,0.58923,0.000973,"#00e8b2"
1513437702,Tracy_Jentzsch,36,1,31,32,0.454839,0.373968,0.015078,"#825403"
1513661708,andy_rutkowski,36,0,2,2,0.406671,0.406147,0.000486,"#825403"
1513789068,UniversidadCEU,18,5,0,5,0.452491,0.719099,0.001946,"#5456a6"
1514067583,anartdecodiva,14,0,1,1,0.458939,0.727996,0,"#00eeff"
1514373452,GmezConsuelo,30,0,1,1,0.569808,0.697219,0,"#ff77ff"
1514921120,anamandujano_,13,1,3,4,0.477528,0.43767,0.001459,"#3bec00"
1515907098,iegUC3M,19,3,0,3,0.632623,0.697246,0.000973,"#00d3ff"
1516768171,jm_aburto,7,0,2,2,0.414116,0.338653,0.000486,"#ffb800"
1516955634,clionauta_ap,38,75,35,110,0.538069,0.502616,0.053016,"#662859"
1517533939,MarioMotivacion,22,0,1,1,0.444472,0.656266,0,"#00e8b2"
1517872224,Maryalexperliz,3,0,1,1,0.452819,0.763566,0,"#ffb3ff"
1519325701,artesciencias,30,0,2,2,0.501609,0.59285,0.000486,"#ff77ff"
1519478858,psanchezblasco,30,0,1,1,0.636642,0.56389,0,"#ff77ff"
1520651402,AzoteCasta,49,1,0,1,0.355241,0.633567,0,"#ff7007"
1522012700,auletes1,30,0,1,1,0.562988,0.695088,0,"#ff77ff"
1523149892,biaklimeck,36,0,1,1,0.536173,0.282687,0,"#825403"
1523270480,lsmntr,22,4,0,4,0.548779,0.563405,0.001459,"#00e8b2"
1523466625,dkozaktw,31,0,3,3,0.547051,0.489362,0.000973,"#3e93ff"
1523826044,JuliMejiaRojas,3,0,1,1,0.462468,0.775706,0,"#ffb3ff"
1524948138,mdjvillarroel,7,0,2,2,0.401057,0.337116,0.000486,"#ffb800"
1525149109,CarmenMamelita,30,0,5,5,0.540494,0.575357,0.001946,"#ff77ff"
1526219378,gtmorals,34,0,8,8,0.397138,0.429779,0.003405,"#ff0d69"
1526791086,pamantuk,13,0,1,1,0.526485,0.232898,0,"#3bec00"
1527367620,PlataformaCTI,8,5,0,5,0.648225,0.314873,0.001946,"#00ed5d"
1527801385,pilarpfalla,40,0,1,1,0.602344,0.021346,0,"#ff12a3"
1528161931,LiliRicardez,13,0,1,1,0.394533,0.37592,0,"#3bec00"
1528425872,Historiarum,37,1,0,1,0.621917,0.330661,0,"#006032"
1529298787,Rosacatl,49,0,1,1,0.435843,0.62839,0,"#ff7007"
1529994234,LAURASolete123,15,8,4,12,0.507613,0.599137,0.00535,"#008ebb"
1530698874,Olga_Giralt,30,0,1,1,0.453849,0.790492,0,"#ff77ff"
1530961784,josesevillarigo,30,0,3,3,0.556927,0.6168,0.000973,"#ff77ff"
1531147478,jmateo01,16,0,2,2,0.930482,0.674006,0.000486,"#c42c63"
1531994304,vyancelibrarian,49,0,2,2,0.432899,0.474216,0.000486,"#ff7007"
1534703461,profenuria,30,0,5,5,0.460911,0.594138,0.001946,"#ff77ff"
1534997670,envynoveritas,13,0,1,1,0.389791,0.389393,0,"#3bec00"
1535540360,edne_balmori,13,0,1,1,0.4078,0.393523,0,"#3bec00"
1535719423,BlackKlausen,13,0,1,1,0.420321,0.452379,0,"#3bec00"
1536346855,EscolaDeDados,36,0,1,1,0.774961,0.607217,0,"#825403"
1536665708,barbalhofernand,36,5,10,15,0.503074,0.378375,0.006809,"#825403"
1537766286,theitoxx,37,1,1,2,0.580899,0.364871,0.000486,"#006032"
1538629344,tronchasandias,38,0,1,1,0.096991,0.432989,0,"#662859"
1538778649,Pilar_melilla,16,0,3,3,0.936507,0.667753,0.000973,"#c42c63"
1539750704,EFcoMaldonado,14,0,2,2,0.593943,0.554893,0.000486,"#00eeff"
1539834488,libraudiovisual,30,0,3,3,0.509748,0.609774,0.000973,"#ff77ff"
1541399594,jagueda1,0,0,5,5,0.559929,0.536977,0.001946,"#8ecfec"
1541672676,Tassos84,13,0,1,1,0.389578,0.405121,0,"#3bec00"
1541710574,icomcuba,31,2,0,2,0.582418,0.471252,0.000486,"#3e93ff"
1541860040,NataliaBerruzzi,55,0,2,2,0.665913,0.638774,0.000486,"#cb3f32"
1541926285,nuriamahillo,37,1,2,3,0.634778,0.477121,0.000973,"#006032"
1542018037,Hellmarq76,13,0,1,1,0.380206,0.329835,0,"#3bec00"
1542388032,MatacanaM,22,0,1,1,0.227173,0.6871,0,"#00e8b2"
1543164858,cyanolimnas,30,0,6,6,0.484949,0.596979,0.002432,"#ff77ff"
1543540196,FerlaLuis,49,3,3,6,0.488004,0.425131,0.002432,"#ff7007"
1544437471,JuanBriseoG3,13,0,1,1,0.470536,0.294977,0,"#3bec00"
1545025939,zeutschelgmbh,34,1,0,1,0.389147,0.471772,0,"#ff0d69"
1545271399,MezBreezeDesign,0,0,1,1,0.515611,0.401691,0,"#8ecfec"
1545314329,BarcelonaLab,22,0,4,4,0.500855,0.544646,0.001459,"#00e8b2"
1545924524,monicafontballe,22,0,1,1,0.599866,0.627371,0,"#00e8b2"
1546196792,BrDena,4,0,1,1,0.864239,0.231357,0,"#f4c8cf"
1546308840,VeremundoC,13,0,5,5,0.381233,0.362846,0.001946,"#3bec00"
1546496100,darbelc,38,0,2,2,0.550304,0.408245,0.000486,"#662859"
1546541138,BC_UNSAM,22,2,4,6,0.471209,0.610082,0.002432,"#00e8b2"
1546557630,ValkyrCOTV,49,1,0,1,0.296804,0.61183,0,"#ff7007"
1547855347,CiteFactor,13,28,0,28,0.485499,0.488828,0.013132,"#3bec00"
1548705696,smunozar,34,0,2,2,0.561963,0.383937,0.000486,"#ff0d69"
1548750122,piketebow,49,3,0,3,0.450495,0.584413,0.000973,"#ff7007"
1548791382,UOCbiblioteca,14,33,26,59,0.557106,0.543538,0.02821,"#00eeff"
1549209552,jacomyma,36,6,0,6,0.482256,0.336435,0.002432,"#825403"
1549219585,PesquisaPUJ,37,1,1,2,0.590478,0.333163,0.000486,"#006032"
1549435944,glletic,13,1,4,5,0.424438,0.469029,0.001946,"#3bec00"
1549476308,ameliamunozb,30,2,21,23,0.51138,0.521095,0.0107,"#ff77ff"
1549674674,ValnidesCosta,38,0,1,1,0.564732,0.411009,0,"#662859"
1549792512,frattigiovanni,14,0,1,1,0.698401,0.573895,0,"#00eeff"
1550686328,celTatis,49,1,5,6,0.503983,0.554834,0.002432,"#ff7007"
1552611648,IsaacLera,34,0,2,2,0.454289,0.412568,0.000486,"#ff0d69"
1552933766,Letrak_EHU,22,1,2,3,0.545784,0.637973,0.000973,"#00e8b2"
1554050953,pvcanelo,49,1,0,1,0.359482,0.686886,0,"#ff7007"
1554836376,fotoshistorica,19,1,0,1,0.616986,0.78195,0,"#00d3ff"
1558659372,floryague,31,0,2,2,0.630939,0.540124,0.000486,"#3e93ff"
1560173660,siam_uma,14,0,2,2,0.618413,0.533323,0.000486,"#00eeff"
1561299020,mrs_grandson,19,0,1,1,0.6813,0.836103,0,"#00d3ff"
1561833368,_shitlusays,36,1,1,2,0.48555,0.332018,0.000486,"#825403"
1562255552,stragafilms,14,0,1,1,0.675124,0.491812,0,"#00eeff"
1563055081,Divulga_UCA,37,2,1,3,0.605901,0.374434,0.000973,"#006032"
1563291032,edirom,31,5,2,7,0.790356,0.430376,0.002918,"#3e93ff"
1564684687,Mariaantoniairm,49,1,0,1,0.289528,0.651984,0,"#ff7007"
1565465358,Proyecto_Bieses,30,53,20,73,0.553169,0.55643,0.035019,"#ff77ff"
1565999226,AdmonUniandes,34,0,1,1,0.558896,0.346486,0,"#ff0d69"
1566185168,UniandesDerecho,34,5,3,8,0.589138,0.364146,0.003405,"#ff0d69"
1567314756,cegecal,21,29,0,29,0.457473,0.891459,0.013619,"#c6cc85"
1569493393,biblioantonia,49,4,1,5,0.494888,0.53154,0.001946,"#ff7007"
1569525392,DeviaYennyPa,34,0,1,1,0.625551,0.317315,0,"#ff0d69"
1569865502,UOdivulga,22,0,2,2,0.628488,0.569413,0.000486,"#00e8b2"
1570295498,xboschc,14,0,2,2,0.57114,0.501071,0.000486,"#00eeff"
1570339038,CLARIAH_NL,13,0,1,1,0.419317,0.421962,0,"#3bec00"
1575397346,Rochi_Saiyajin,30,0,40,40,0.552104,0.530888,0.018969,"#ff77ff"
1576160984,mikko_tolonen,30,0,2,2,0.544436,0.529155,0.000486,"#ff77ff"
1576465740,cer0corrupcion,40,0,1,1,0.62347,0.03796,0,"#ff12a3"
1577131448,EstelleIngrandV,30,0,1,1,0.633925,0.570253,0,"#ff77ff"
1577664379,henrymtg,49,0,1,1,0.363555,0.491819,0,"#ff7007"
1578012758,gomezdugand,34,1,0,1,0.533996,0.382706,0,"#ff0d69"
1578378122,FrancePerou,9,0,1,1,0.69516,0.661192,0,"#008f7b"
1578378974,UbiktDF,7,0,1,1,0.749541,0.35858,0,"#ffb800"
1578442585,artismusa,30,9,31,40,0.523917,0.51735,0.018969,"#ff77ff"
1579046617,UMDRadioSoacha,38,0,1,1,0.614812,0.363915,0,"#662859"
1579922448,BiureRaich,14,0,1,1,0.574702,0.59795,0,"#00eeff"
1580349043,WikiLibrary,13,0,3,3,0.459036,0.471273,0.000973,"#3bec00"
1580534383,PabloSoneira,49,1,0,1,0.352401,0.608832,0,"#ff7007"
1580794916,aegpc,14,0,1,1,0.676973,0.508974,0,"#00eeff"
1581292279,carvajalregidor,34,1,3,4,0.427072,0.449818,0.001459,"#ff0d69"
1581515384,anagorria,49,1,0,1,0.417171,0.532011,0,"#ff7007"
1582226047,LatinoNetAAM,34,0,2,2,0.371856,0.410037,0.000486,"#ff0d69"
1582564051,bibliotecaUAL,38,10,3,13,0.519432,0.638667,0.005837,"#662859"
1583041580,beagarciapla,1,0,2,2,0.645045,0.446148,0.000486,"#b6cb00"
1583213276,UNIR_Colombia,14,0,2,2,0.437982,0.503898,0.000486,"#00eeff"
1583424090,Arturodelp,14,0,3,3,0.57825,0.53212,0.000973,"#00eeff"
1584023875,teresapv6,31,0,2,2,0.580501,0.554445,0.000486,"#3e93ff"
1584180805,Marisolmct,0,0,2,2,0.510935,0.426676,0.000486,"#8ecfec"
1585624296,Lnarsolares,38,0,1,1,0.094025,0.435178,0,"#662859"
1586869063,mariafdezruiz,14,9,2,11,0.368902,0.468259,0.004864,"#00eeff"
1587053922,npenasueiro,14,32,107,139,0.520081,0.519007,0.067121,"#00eeff"
1588093730,IagoMoreno_es,30,1,0,1,0.654934,0.586861,0,"#ff77ff"
1588154118,LetrasUma,14,41,16,57,0.581953,0.514775,0.027237,"#00eeff"
1588926078,Wakeupnowy,40,0,1,1,0.591781,0.053505,0,"#ff12a3"
1589424290,EmbajadaEspPeru,30,0,1,1,0.625732,0.664728,0,"#ff77ff"
1593961730,comunidad_istec,49,6,11,17,0.451597,0.539699,0.007782,"#ff7007"
1594104709,MeguiMaldonado,0,0,2,2,0.449242,0.392848,0.000486,"#8ecfec"
1594520179,libraryleaks,13,1,4,5,0.471798,0.527579,0.001946,"#3bec00"
1595213742,GrupoIWI,49,1,0,1,0.358294,0.680856,0,"#ff7007"
1595504617,VirgilioPonce,43,0,1,1,0.708043,0.551654,0,"#fcae7e"
1595679444,NaturgyFnd,8,2,3,5,0.654041,0.317231,0.001946,"#00ed5d"
1596671887,chidonoticias,34,0,1,1,0.530162,0.344646,0,"#ff0d69"
1596692042,asunsd,31,1,0,1,0.479547,0.643873,0,"#3e93ff"
1596953767,SierraLuisFer,49,0,1,1,0.400875,0.524432,0,"#ff7007"
1598107260,DeutschUCA,30,0,1,1,0.504206,0.624806,0,"#ff77ff"
1598319991,cdcampo1,30,2,2,4,0.745407,0.599927,0.001459,"#ff77ff"
1598324696,DH_FBK,36,1,12,13,0.501861,0.484356,0.005837,"#825403"
1598524914,a2039482903,31,0,1,1,0.670464,0.543068,0,"#3e93ff"
1599021012,cahugugo,38,0,3,3,0.684679,0.422571,0.000973,"#662859"
1599816050,mariapaulinaar,38,0,1,1,0.681093,0.483623,0,"#662859"
1601361668,hebrasdetinta,30,0,1,1,0.617387,0.657543,0,"#ff77ff"
1602355802,jorv1121,49,14,3,17,0.457424,0.614375,0.007782,"#ff7007"
1602378234,KfvConsultant,8,0,1,1,0.250292,0.271501,0,"#00ed5d"
1602784057,USALMOOC,58,0,1,1,0.467088,0.658176,0,"#005076"
1604290537,mmdsza,14,0,1,1,0.582019,0.475837,0,"#00eeff"
1605693206,OttLegalRebels,34,0,1,1,0.41337,0.449282,0,"#ff0d69"
1605751296,Paulisuki,38,0,2,2,0.686209,0.552627,0.000486,"#662859"
1605844278,DeVerWhite,14,0,1,1,0.58219,0.489882,0,"#00eeff"
1605946868,Mariteky,30,2,0,2,0.494281,0.580332,0.000486,"#ff77ff"
1606523646,luzen7,14,0,2,2,0.501982,0.618393,0.000486,"#00eeff"
1606587162,MarioChong_UP,0,0,1,1,0.77172,0.491149,0,"#8ecfec"
1606606903,RayitoRub,7,0,2,2,0.425473,0.30844,0.000486,"#ffb800"
1606690310,UH_CMAS,34,0,2,2,0.366418,0.44264,0.000486,"#ff0d69"
1607210402,mimiros9,49,1,0,1,0.330915,0.622776,0,"#ff7007"
1608420782,nubeingrid,13,0,1,1,0.395636,0.367527,0,"#3bec00"
1608886388,JulianitaSj,22,0,1,1,0.679301,0.569048,0,"#00e8b2"
1608943446,hechoscomdo,49,1,0,1,0.419073,0.664674,0,"#ff7007"
1609102838,carlaa_hh,37,2,0,2,0.526593,0.380241,0.000486,"#006032"
1610674718,MrSushi1,7,0,3,3,0.554195,0.50599,0.000973,"#ffb800"
1612023889,MarioMacjunior,36,1,0,1,0.52348,0.290106,0,"#825403"
1612464666,UNEDMadridSur,30,0,3,3,0.539864,0.538212,0.000973,"#ff77ff"
1612763167,AnimaLectura,30,8,15,23,0.538548,0.542245,0.0107,"#ff77ff"
1613358336,wiligamez,13,0,2,2,0.435005,0.415292,0.000486,"#3bec00"
1613654574,Carlos_Ramos_N,34,0,1,1,0.500101,0.371476,0,"#ff0d69"
1614936007,ProfCabezas,22,0,1,1,0.909996,0.76002,0,"#00e8b2"
1615512858,ViejasLectoras,38,0,5,5,0.541718,0.419867,0.001946,"#662859"
1615554216,NowhereAlma,13,0,2,2,0.452662,0.412939,0.000486,"#3bec00"
1616505410,RasCisneros,4,0,1,1,0.859286,0.242595,0,"#f4c8cf"
1616773572,outofsightation,13,0,3,3,0.457715,0.435636,0.000973,"#3bec00"
1617420666,dalxsp,7,0,1,1,0.393682,0.203459,0,"#ffb800"
1618677194,DominikBoenisch,14,0,1,1,0.721768,0.507046,0,"#00eeff"
1618681904,MariaBBoned,22,0,1,1,0.735238,0.227243,0,"#00e8b2"
1619121919,radiolatinjazz,49,1,0,1,0.381323,0.667067,0,"#ff7007"
1619418860,mariaatp7,38,0,1,1,0.541457,0.363713,0,"#662859"
1620517770,AMBADANAROBA,22,0,2,2,0.590064,0.707062,0.000486,"#00e8b2"
1621344962,ArtLibJournal,7,0,4,4,0.450833,0.43685,0.001459,"#ffb800"
1621374198,KathyHartWeimer,34,0,6,6,0.458999,0.462316,0.002432,"#ff0d69"
1622519646,UniValencia,14,9,0,9,0.568473,0.523622,0.003891,"#00eeff"
1623968797,NoemiNPerez,1,0,2,2,0.663123,0.447455,0.000486,"#b6cb00"
1624241750,su_silvina,49,4,0,4,0.440528,0.573636,0.001459,"#ff7007"
1627827128,RenataBastosSS,36,0,2,2,0.477044,0.382463,0.000486,"#825403"
1627994419,novatto7,14,0,1,1,0.67516,0.496248,0,"#00eeff"
1628439068,JAfgana,21,0,2,2,0.240891,0.220553,0.000486,"#c6cc85"
1628806272,MsCrapBag,22,0,2,2,0.756968,0.234665,0.000486,"#00e8b2"
1629790608,Masterup_UCA,31,2,3,5,0.552271,0.581991,0.001946,"#3e93ff"
1632191034,AlumnosUCMsuppo,19,1,0,1,0.663318,0.789922,0,"#00d3ff"
1633090664,MarceTakahashi,21,0,1,1,0.141176,0.615599,0,"#c6cc85"
1633748976,ja_gonzals,7,0,2,2,0.414286,0.371611,0.000486,"#ffb800"
1634213233,TecnicoInfantil,30,0,1,1,0.531862,0.62959,0,"#ff77ff"
1634236682,Mony01virgo,7,0,1,1,0.404808,0.306385,0,"#ffb800"
1635281684,CCCientifica,22,1,0,1,0.520468,0.674805,0,"#00e8b2"
1635858990,messinagodoy,21,0,2,2,0.232301,0.250596,0.000486,"#c6cc85"
1635990978,EmbaMexPay,7,1,1,2,0.415468,0.323543,0.000486,"#ffb800"
1636354368,serendipomatic,36,1,0,1,0.571763,0.425211,0,"#825403"
1636382334,FrancoColucci05,7,0,2,2,0.583753,0.397929,0.000486,"#ffb800"
1636590253,tim_cook,49,4,0,4,0.445171,0.630022,0.001459,"#ff7007"
1636726280,EliGonSau,55,0,1,1,0.666636,0.559762,0,"#cb3f32"
1637285161,mjfrapolli,31,1,0,1,0.783845,0.472953,0,"#3e93ff"
1637434778,MakDigHist,30,0,4,4,0.475482,0.529313,0.001459,"#ff77ff"
1637555491,bea_reme,22,0,1,1,0.635738,0.452053,0,"#00e8b2"
1637877529,EduRaitzin,37,0,1,1,0.281423,0.366482,0,"#006032"
1637975492,bioplug,36,0,1,1,0.491272,0.295897,0,"#825403"
1638417583,zenobiewan,34,0,1,1,0.32465,0.429,0,"#ff0d69"
1638695353,JosueRM320,7,0,4,4,0.433877,0.395197,0.001459,"#ffb800"
1638948078,NoheMillan,55,0,4,4,0.642858,0.586862,0.001459,"#cb3f32"
1639352005,IBICTbr,36,25,2,27,0.515364,0.360948,0.012646,"#825403"
1639384873,Dive_col,38,0,2,2,0.411729,0.619228,0.000486,"#662859"
1639947949,pat_inteligente,49,3,1,4,0.453053,0.561125,0.001459,"#ff7007"
1641252577,UNLModLang,34,4,3,7,0.430666,0.470845,0.002918,"#ff0d69"
1641532076,traductoresHD,14,1,6,7,0.479826,0.550326,0.002918,"#00eeff"
1643809694,Ramirez01Ramrez,38,0,1,1,0.657036,0.416143,0,"#662859"
1645564886,queta_ayala,49,2,0,2,0.395792,0.563723,0.000486,"#ff7007"
1646623290,R_RodrigoRoy,13,0,5,5,0.496992,0.49157,0.001946,"#3bec00"
1647100686,terricolesbtv,8,8,0,8,0.619612,0.319579,0.003405,"#00ed5d"
1647703436,bibliounipe,49,0,1,1,0.411068,0.645747,0,"#ff7007"
1648086121,AgicPt,36,0,1,1,0.559505,0.387177,0,"#825403"
1648526168,el_jota_te,22,0,1,1,0.605978,0.614655,0,"#00e8b2"
1648922935,davidto302,3,0,1,1,0.496269,0.770981,0,"#ffb3ff"
1649581790,DarioFlores1470,20,0,1,1,0.406429,0.072052,0,"#f0be45"
1649603491,mompypaiton,0,0,3,3,0.414563,0.553739,0.000973,"#8ecfec"
1650333073,2709books,14,0,1,1,0.301849,0.440721,0,"#00eeff"
1652064559,jotae1975,3,0,1,1,0.463125,0.757536,0,"#ffb3ff"
1652416692,framospalencia,1,2,3,5,0.462122,0.558597,0.001946,"#b6cb00"
1653544160,CarlosGaMart,30,3,0,3,0.526515,0.594538,0.000973,"#ff77ff"
1655540839,Lusitania100,22,1,0,1,0.629354,0.613024,0,"#00e8b2"
1656308850,altarrga,49,1,0,1,0.338862,0.662914,0,"#ff7007"
1656581156,EticaUP,22,0,2,2,0.823238,0.302688,0.000486,"#00e8b2"
1657710265,areche60,58,0,3,3,0.591274,0.288233,0.000973,"#005076"
1658108256,rociondo_h,30,0,1,1,0.627023,0.619682,0,"#ff77ff"
1658570527,LAGRRRIPAL,13,1,1,2,0.401929,0.311253,0.000486,"#3bec00"
1658740566,UMETbiblioteca,49,10,18,28,0.480561,0.542741,0.013132,"#ff7007"
1659334471,ProductorLuisM,13,0,2,2,0.454341,0.4315,0.000486,"#3bec00"
1660197828,laura_tinajero,1,0,2,2,0.526804,0.616193,0.000486,"#b6cb00"
1660569511,misssclafani,41,0,1,1,0.36474,0.398673,0,"#697b00"
1661175252,4srdiego,49,9,6,15,0.470297,0.515152,0.006809,"#ff7007"
1663288981,gabo8arpo,3,0,1,1,0.479079,0.757642,0,"#ffb3ff"
1663843550,Deepestpurple81,13,0,1,1,0.434216,0.41031,0,"#3bec00"
1665903386,susana5880,1,0,1,1,0.344959,0.53946,0,"#b6cb00"
1668955033,HilosMujeres,30,0,1,1,0.630118,0.609259,0,"#ff77ff"
1669074486,luizverso,36,0,1,1,0.486311,0.233446,0,"#825403"
1669474812,juadiegozuluaga,38,0,1,1,0.695278,0.467217,0,"#662859"
1669795718,paullushistoric,30,1,1,2,0.299952,0.556613,0.000486,"#ff77ff"
1670475145,scielomexico,13,16,28,44,0.485211,0.449379,0.020914,"#3bec00"
1671411253,inesolza,1,0,7,7,0.593353,0.500174,0.002918,"#b6cb00"
1671970100,cultura_valle,38,2,1,3,0.627929,0.62725,0.000973,"#662859"
1672017145,GetSetLearning,0,0,1,1,0.540211,0.406742,0,"#8ecfec"
1672439168,DraTereGasca,13,2,1,3,0.422102,0.446853,0.000973,"#3bec00"
1673319098,Carme_Carbo,2,0,1,1,0.64368,0.646981,0,"#ffa64e"
1674343255,as_diseno_MX,22,0,1,1,0.600293,0.643881,0,"#00e8b2"
1674823189,luismorguz,13,0,1,1,0.464052,0.307082,0,"#3bec00"
1675145382,BizneoHR,49,1,0,1,0.317692,0.627725,0,"#ff7007"
1675825620,semanariovision,49,1,0,1,0.426549,0.672731,0,"#ff7007"
1676139596,GuilleGCR,19,2,1,3,0.623509,0.658344,0.000973,"#00d3ff"
1676882180,VictorJDH,41,0,1,1,0.385668,0.399557,0,"#697b00"
1677187706,apetitodelojo,31,0,2,2,0.533662,0.503417,0.000486,"#3e93ff"
1678524036,PatyBanuelos24,3,0,1,1,0.309177,0.595644,0,"#ffb3ff"
1678643042,jcsantamarta,22,0,2,2,0.636618,0.618491,0.000486,"#00e8b2"
1679272206,gfueguino,21,0,2,2,0.260334,0.218369,0.000486,"#c6cc85"
1679484248,Kelebekler19,58,0,1,1,0.61637,0.579452,0,"#005076"
1680067740,mpolocamacho,41,0,1,1,0.36613,0.3945,0,"#697b00"
1680294020,FJuanpacheco,38,0,1,1,0.604855,0.340128,0,"#662859"
1680866616,FemTechNet,41,1,0,1,0.370252,0.396744,0,"#697b00"
1681161600,PretelDavid,7,0,1,1,0.427846,0.323479,0,"#ffb800"
1681604288,CortesRichard,21,0,1,1,0.173482,0.21315,0,"#c6cc85"
1682991576,REF_Filosofia,15,3,0,3,0.442518,0.694331,0.000973,"#008ebb"
1684172437,UofADHSA,36,0,1,1,0.388703,0.469386,0,"#825403"
1684181748,GeoHum_SIG,30,7,14,21,0.514349,0.488318,0.009728,"#ff77ff"
1684372074,Raul_RQR,30,0,2,2,0.511758,0.481844,0.000486,"#ff77ff"
1684793785,gumartinezz,3,1,3,4,0.456653,0.614938,0.001459,"#ffb3ff"
1684961790,yangamx,34,1,0,1,0.455851,0.282193,0,"#ff0d69"
1685960502,CurrentHistory1,19,1,0,1,0.67831,0.784895,0,"#00d3ff"
1685979276,moralesleo_,13,0,1,1,0.648973,0.98697,0,"#3bec00"
1686178242,AmaliaPedreiras,14,0,1,1,0.588971,0.477867,0,"#00eeff"
1686443648,DiputadosMPN,49,1,0,1,0.361703,0.650831,0,"#ff7007"
1687081603,ComiteMattaSur,21,0,2,2,0.228171,0.229188,0.000486,"#c6cc85"
1687113422,mariaestorino,34,0,1,1,0.327812,0.40835,0,"#ff0d69"
1687132957,GestionUAH,38,2,0,2,0.446739,0.554911,0.000486,"#662859"
1687213934,elplancnet,49,0,5,5,0.513513,0.517202,0.001946,"#ff7007"
1687596402,Ch1noGomez,49,1,0,1,0.317932,0.624925,0,"#ff7007"
1687752842,amendiri,0,0,3,3,0.429697,0.553153,0.000973,"#8ecfec"
1688883667,yale_dhwg,30,0,8,8,0.492996,0.51492,0.003405,"#ff77ff"
1689283094,sociotecnico,8,0,1,1,0.282101,0.264591,0,"#00ed5d"
1689534049,Paulabiblos,34,0,1,1,0.601697,0.412408,0,"#ff0d69"
1689563276,OsoPerezoso_,38,0,1,1,0.435191,0.776753,0,"#662859"
1690412382,observadorpt,36,3,0,3,0.618525,0.418477,0.000973,"#825403"
1691049480,lupitacu61,31,0,1,1,0.623116,0.449117,0,"#3e93ff"
1691473742,Danielalvarezdg,30,0,1,1,0.704986,0.638748,0,"#ff77ff"
1691536992,dmasuamc,8,0,1,1,0.34058,0.506143,0,"#00ed5d"
1692058656,dorisnellyorteg,38,0,1,1,0.641252,0.387253,0,"#662859"
1692847412,ParranderaRadio,42,0,1,1,0.727275,0.461704,0,"#66e087"
1695011292,charlyMyM,49,0,3,3,0.426331,0.586724,0.000973,"#ff7007"
1697015683,ginagrossgodoy,49,1,0,1,0.292376,0.644021,0,"#ff7007"
1697160798,gerpaezm,15,0,1,1,0.55452,0.683185,0,"#008ebb"
1697370691,SonMusicRC,7,0,1,1,0.196372,0.384172,0,"#ffb800"
1699608505,AngevinKandy,22,1,3,4,0.551855,0.564521,0.001459,"#00e8b2"
1699689775,_kelseyswift,34,0,2,2,0.36264,0.409811,0.000486,"#ff0d69"
1700982726,isumaepg,34,0,8,8,0.496156,0.435851,0.003405,"#ff0d69"
1702198044,wineworldtoursp,2,0,3,3,0.62349,0.645951,0.000973,"#ffa64e"
1702215787,Miguel_Fcom,31,0,3,3,0.563974,0.604774,0.000973,"#3e93ff"
1702372200,RetoHistorico,22,1,0,1,0.565996,0.794237,0,"#00e8b2"
1704637898,cronicasamonite,49,1,0,1,0.361613,0.594065,0,"#ff7007"
1704935276,BigData_Machine,49,13,3,16,0.472294,0.564284,0.007296,"#ff7007"
1705539680,BibliotecasRBJ,49,4,76,80,0.47107,0.56076,0.038424,"#ff7007"
1706762870,zaidagarro,37,0,1,1,0.516957,0.902851,0,"#006032"
1706801244,melchorsm,13,5,3,8,0.526275,0.467544,0.003405,"#3bec00"
1707052416,ICS_unav,30,4,5,9,0.600226,0.566217,0.003891,"#ff77ff"
1707338683,Ce_AQUA,19,0,5,5,0.63544,0.672717,0.001946,"#00d3ff"
1707822566,Teachlr,42,4,2,6,0.717528,0.395806,0.002432,"#66e087"
1708046491,beamarizq,37,0,2,2,0.539755,0.580032,0.000486,"#006032"
1708987255,AnahiCoca,13,0,1,1,0.421275,0.419775,0,"#3bec00"
1710581694,DE_TIC_A,7,0,4,4,0.44265,0.412335,0.001459,"#ffb800"
1710996530,Inma_Casdel,14,0,3,3,0.554385,0.518855,0.000973,"#00eeff"
1711281463,clancynewyork,34,0,1,1,0.463484,0.375827,0,"#ff0d69"
1712010084,am_cuaresma,1,13,26,39,0.506279,0.531137,0.018482,"#b6cb00"
1712238061,soyEvaH,34,0,1,1,0.475329,0.377796,0,"#ff0d69"
1712456996,AlfPlotino,13,0,1,1,0.419768,0.501877,0,"#3bec00"
1713039841,CONICETDoc,49,1,0,1,0.314328,0.687905,0,"#ff7007"
1713430909,abrahamrammar,14,2,0,2,0.604611,0.575192,0.000486,"#00eeff"
1713483133,GaleriaOrfila,30,0,1,1,0.467196,0.644147,0,"#ff77ff"
1713996618,Anaulula,38,0,1,1,0.324967,0.161295,0,"#662859"
1714364792,khj5c,13,0,1,1,0.386652,0.434377,0,"#3bec00"
1715970883,Yerikson553,22,0,2,2,0.620563,0.522916,0.000486,"#00e8b2"
1716057560,ArcaZoo10,21,0,1,1,0.209051,0.220339,0,"#c6cc85"
1716798163,estebanAvaccaro,8,0,2,2,0.467861,0.495734,0.000486,"#00ed5d"
1720373568,Cinejante,40,0,1,1,0.633086,0.016952,0,"#ff12a3"
1721874307,AA_1mayo,19,6,6,12,0.642706,0.756624,0.00535,"#00d3ff"
1722330648,zapardiel_diego,14,0,1,1,0.510625,0.644112,0,"#00eeff"
1723463833,charibotella,1,0,2,2,0.661762,0.465333,0.000486,"#b6cb00"
1723565546,IIE_ES,49,1,0,1,0.492845,0.669297,0,"#ff7007"
1724553624,XLSalvador,0,0,16,16,0.541147,0.542892,0.007296,"#8ecfec"
1725715489,MarineTortuga,49,1,0,1,0.404648,0.664691,0,"#ff7007"
1726898534,NotiCantabria,49,1,0,1,0.289525,0.646289,0,"#ff7007"
1728306902,ApuntoDisparo,49,1,0,1,0.417202,0.660058,0,"#ff7007"
1728381668,beatrizjuste,49,1,0,1,0.307419,0.661333,0,"#ff7007"
1728486997,PrensaUNIR,14,13,5,18,0.461934,0.572341,0.008268,"#00eeff"
1728604734,didpatri,4,4,2,6,0.545261,0.659005,0.002432,"#f4c8cf"
1728835093,libreriaelpozo,30,0,1,1,0.594482,0.662337,0,"#ff77ff"
1729193269,JFSebastian146,30,0,1,1,0.557665,0.594279,0,"#ff77ff"
1730309484,lucasmontojo,15,0,1,1,0.532099,0.726794,0,"#008ebb"
1731470172,kilmunbooks,36,0,3,3,0.434313,0.569137,0.000973,"#825403"
1731915241,CDL_Madrid,37,1,0,1,0.662603,0.584141,0,"#006032"
1732012424,Sopa_Cultural,36,1,0,1,0.481085,0.3371,0,"#825403"
1734653155,hugo_barrosm,14,0,1,1,0.638727,0.581597,0,"#00eeff"
1735768969,KenosScanda,49,1,0,1,0.345804,0.629209,0,"#ff7007"
1737960920,CiberlawyerA,31,0,4,4,0.562895,0.553988,0.001459,"#3e93ff"
1763552412,EinerEiner71,58,0,1,1,0.546467,0.180321,0,"#005076"
1829923675,JuanManuelGera3,49,0,2,2,0.754407,0.362586,0.000486,"#ff7007"
1830717019,beurruti,31,13,4,17,0.599195,0.539096,0.007782,"#3e93ff"
1833265892,vmgonzalez68,34,0,2,2,0.539212,0.424654,0.000486,"#ff0d69"
1833610776,anacrobless,13,0,1,1,0.411189,0.427407,0,"#3bec00"
1843358101,ccssmurcia,55,1,0,1,0.654731,0.624018,0,"#cb3f32"
1850403312,arqueoblog,49,1,0,1,0.382839,0.666611,0,"#ff7007"
1851353246,fmolinapublica,14,0,2,2,0.437468,0.546595,0.000486,"#00eeff"
1851393025,HangoutON,31,4,5,9,0.542881,0.505331,0.003891,"#3e93ff"
1851539467,DVCTVS,37,1,2,3,0.631337,0.40573,0.000973,"#006032"
1852324602,obseurbano,7,0,1,1,0.394634,0.358856,0,"#ffb800"
1854297050,EscuelaEduUdeSA,49,0,1,1,0.765637,0.814253,0,"#ff7007"
1854455490,JuanfranReus_31,13,0,1,1,0.400829,0.385249,0,"#3bec00"
1854809810,virsedamarta,22,10,2,12,0.532417,0.515856,0.00535,"#00e8b2"
1855362589,randaelka,30,1,3,4,0.541896,0.44712,0.001459,"#ff77ff"
1855559198,LabVis_UFRJ,36,1,0,1,0.446195,0.341611,0,"#825403"
1855891748,TextUW,34,0,1,1,0.480716,0.375162,0,"#ff0d69"
1857644222,RicardoPerezGo5,35,0,1,1,0.733154,0.421553,0,"#00faff"
1857781238,HISTORICAS_UABC,7,0,1,1,0.65644,0.370357,0,"#ffb800"
1857997632,LilianSalado1,0,0,3,3,0.456905,0.420928,0.000973,"#8ecfec"
1858327705,inguniandes,34,6,2,8,0.589363,0.410083,0.003405,"#ff0d69"
1858744802,FranMMarBla,13,1,11,12,0.512108,0.478034,0.00535,"#3bec00"
1859478451,NajlaJarkas1,36,3,0,3,0.461824,0.383114,0.000973,"#825403"
1860326010,CSAHeadhunter,49,1,0,1,0.382603,0.685241,0,"#ff7007"
1861363302,CheMendele,49,1,0,1,0.268653,0.547064,0,"#ff7007"
1863463070,Javier_Rios_,0,0,1,1,0.347032,0.583337,0,"#8ecfec"
1863520032,MesieArmand,49,1,0,1,0.353524,0.620224,0,"#ff7007"
1863871164,ColombiaOEI,38,0,1,1,0.551306,0.45769,0,"#662859"
1864637101,jamvallmitjana,30,0,1,1,0.647164,0.548399,0,"#ff77ff"
1864869428,JavaMajor,30,0,1,1,0.488933,0.617049,0,"#ff77ff"
1865110723,maulenalejita,21,0,2,2,0.255247,0.28007,0.000486,"#c6cc85"
1867617678,amaurimor,10,0,1,1,0.659487,0.812512,0,"#52d7c0"
1867937264,ZhelmaSmart,42,0,1,1,0.710056,0.441215,0,"#66e087"
1869654667,yoko_nh,49,26,7,33,0.460016,0.517802,0.015564,"#ff7007"
1870000812,_lleom_,13,0,1,1,0.415167,0.423593,0,"#3bec00"
1871217757,7rondo,19,6,0,6,0.635656,0.758844,0.002432,"#00d3ff"
1871931842,AnaPlanet1,37,1,6,7,0.553339,0.51068,0.002918,"#006032"
1872210793,CONCHYVARA,40,0,1,1,0.561402,0.017627,0,"#ff12a3"
1872841651,AnglicaMGonzlez,38,0,2,2,0.662299,0.277537,0.000486,"#662859"
1875141326,ccss_usal,22,5,0,5,0.554277,0.590634,0.001946,"#00e8b2"
1875653292,CGutierrez78,4,0,1,1,0.83661,0.239838,0,"#f4c8cf"
1875656520,CrossLib,30,1,0,1,0.544064,0.61674,0,"#ff77ff"
1876290277,cajamarce1972,49,2,0,2,0.431999,0.540637,0.000486,"#ff7007"
1877544588,Ekonosaurus,7,0,3,3,0.43343,0.35288,0.000973,"#ffb800"
1878886411,DARIAHde,58,10,0,10,0.513473,0.521206,0.004377,"#005076"
1879247953,monteiro_carola,13,1,0,1,0.573249,0.312292,0,"#3bec00"
1880105924,EthicalBAU,0,0,1,1,0.241442,0.551821,0,"#8ecfec"
1881687991,PeruMira,30,3,2,5,0.473765,0.572994,0.001946,"#ff77ff"
1881806084,ladyClonazepam,49,0,1,1,0.358567,0.569681,0,"#ff7007"
1882002834,epiCCodingNET,49,0,1,1,0.359846,0.472506,0,"#ff7007"
1882963615,iha_uji,34,0,1,1,0.5761,0.356506,0,"#ff0d69"
1884276475,LordJimjr,49,1,0,1,0.317281,0.645287,0,"#ff7007"
1884398202,ricardo_sada,22,0,1,1,0.709275,0.610724,0,"#00e8b2"
1885178714,LauAceldas,38,0,1,1,0.135428,0.805716,0,"#662859"
1886602513,HectorVillarri,13,0,6,6,0.467452,0.43674,0.002432,"#3bec00"
1887124507,PsiPolitica_UNC,0,0,1,1,0.423334,0.381011,0,"#8ecfec"
1887639126,ceciroz,0,0,7,7,0.522775,0.535334,0.002918,"#8ecfec"
1888932589,marianaleyvart,13,0,2,2,0.478317,0.429425,0.000486,"#3bec00"
1890411570,JamieALee2013,13,0,1,1,0.356124,0.438033,0,"#3bec00"
1890732188,yackpa87,38,0,3,3,0.541855,0.423225,0.000973,"#662859"
1891188390,mstrEdge,0,0,3,3,0.292261,0.561559,0.000973,"#8ecfec"
1892212711,c_fulanito_West,34,0,4,4,0.513217,0.413702,0.001459,"#ff0d69"
1892686711,AltoElLoa,21,0,1,1,0.175466,0.237142,0,"#c6cc85"
1893860880,UniqToursEurope,58,0,1,1,0.559488,0.191118,0,"#005076"
1894132141,EthnoArchaeon,22,4,0,4,0.458964,0.586502,0.001459,"#00e8b2"
1894231788,datasociety,36,1,0,1,0.469683,0.209905,0,"#825403"
1895033647,_mmaryne,3,0,1,1,0.468776,0.748697,0,"#ffb3ff"
1896407568,okfnedu,49,4,5,9,0.505307,0.555858,0.003891,"#ff7007"
1896609324,CapelGonzalez,8,4,16,20,0.634548,0.336519,0.009241,"#00ed5d"
1898217662,ADN_Bucaramanga,29,1,1,2,0.276105,0.091058,0.000486,"#1fab00"
1898516952,fanny_oropeza05,42,0,1,1,0.743023,0.415184,0,"#66e087"
1898646811,sbeddy38,49,1,0,1,0.313445,0.614089,0,"#ff7007"
1900789958,UOEquity,34,0,3,3,0.371815,0.418827,0.000973,"#ff0d69"
1901423880,Franciscov137,21,0,2,2,0.252633,0.289263,0.000486,"#c6cc85"
1901655595,CCeHum,49,1,3,4,0.449802,0.542831,0.001459,"#ff7007"
1901681767,cvanarkelsimon,30,0,3,3,0.522047,0.599891,0.000973,"#ff77ff"
1901773910,virmacchi,49,0,2,2,0.323224,0.553304,0.000486,"#ff7007"
1902305198,ProfSeahorn,34,0,2,2,0.388344,0.403594,0.000486,"#ff0d69"
1905554318,opucarobugaro,36,3,0,3,0.515967,0.370318,0.000973,"#825403"
1906109682,CLAGeogs,30,0,2,2,0.463804,0.495469,0.000486,"#ff77ff"
1906220870,LSUGeogBAmajors,30,0,1,1,0.453006,0.548053,0,"#ff77ff"
1907261348,jalcazarc,30,0,1,1,0.615139,0.571263,0,"#ff77ff"
1907614836,estocastica,36,0,4,4,0.520917,0.218657,0.001459,"#825403"
1908023054,Pauladelmundo,21,0,1,1,0.239641,0.206005,0,"#c6cc85"
1908860100,amolinamartin,30,0,1,1,0.551996,0.698181,0,"#ff77ff"
1909126262,aldomanucio,14,7,17,24,0.553713,0.431758,0.011187,"#00eeff"
1909584397,trishaoconnor88,49,8,12,20,0.426034,0.485613,0.009241,"#ff7007"
1910339113,AlexDcho18,13,0,3,3,0.411093,0.405941,0.000973,"#3bec00"
1910495233,UNED_Algeciras,30,0,1,1,0.504738,0.637417,0,"#ff77ff"
1910779644,animatechile,49,0,1,1,0.416657,0.713408,0,"#ff7007"
1912156778,tadeocantopena,30,0,1,1,0.508814,0.657926,0,"#ff77ff"
1912365942,jimepiano,13,0,1,1,0.628622,0.998119,0,"#3bec00"
1912438093,Cariver2Carla,13,0,6,6,0.478647,0.48175,0.002432,"#3bec00"
1915404506,mary_b_68,10,0,2,2,0.661499,0.817705,0.000486,"#52d7c0"
1918065115,chukbak,13,0,1,1,0.526075,0.397485,0,"#3bec00"
1918401414,rchd,36,2,0,2,0.481197,0.470296,0.000486,"#825403"
1918566632,NathyAguileraF,30,0,1,1,0.500641,0.702197,0,"#ff77ff"
1919614692,Junta_Educacion,30,1,0,1,0.399861,0.770663,0,"#ff77ff"
1920478915,JaneGoodallCL,49,1,0,1,0.286022,0.63823,0,"#ff7007"
1923605372,ClauMoller0802,31,0,2,2,0.597026,0.496623,0.000486,"#3e93ff"
1924190935,globitohuracan,49,4,0,4,0.423564,0.590681,0.001459,"#ff7007"
1926008946,EditorialGrao,31,1,1,2,0.486224,0.586892,0.000486,"#3e93ff"
1926147684,ICFS_UAM,37,4,2,6,0.488037,0.625123,0.002432,"#006032"
1927152535,noelpm_,35,0,1,1,0.414602,0.609813,0,"#00faff"
1927524588,MartaAT_,40,0,1,1,0.642243,0.047924,0,"#ff12a3"
1928198575,triana_alexis,44,1,1,2,0.842231,0.594343,0.000486,"#6c241e"
1929622856,Jorge_Tamames,40,0,2,2,0.108098,0.411355,0.000486,"#ff12a3"
1929708145,lauraortegaglez,40,0,1,1,0.563928,0.019811,0,"#ff12a3"
1929850704,sergiorm092,49,1,0,1,0.322042,0.63397,0,"#ff7007"
1930419168,onprojects_es,31,1,1,2,0.600035,0.490863,0.000486,"#3e93ff"
1931009498,DHapproved,30,0,1,1,0.565162,0.460958,0,"#ff77ff"
1931885485,DHCarleton,30,0,1,1,0.561199,0.465086,0,"#ff77ff"
1931947148,pdomgs,22,0,2,2,0.553805,0.634971,0.000486,"#00e8b2"
1932513894,dolofleitas,49,1,3,4,0.460171,0.574747,0.001459,"#ff7007"
1933195292,campusoria,22,0,1,1,0.747864,0.475531,0,"#00e8b2"
1933953356,BiblioPalencia,49,1,0,1,0.368529,0.536232,0,"#ff7007"
1934268980,fepem1,30,2,3,5,0.200033,0.569172,0.001946,"#ff77ff"
1934670072,VianneyNere,7,0,1,1,0.360423,0.355191,0,"#ffb800"
1934941458,France_Colombia,9,6,5,11,0.655024,0.603781,0.004864,"#008f7b"
1936241773,tesiture,7,0,1,1,0.822841,0.541671,0,"#ffb800"
1936654669,RBatell,49,1,4,5,0.418585,0.643516,0.001946,"#ff7007"
1936874472,MurciaVisual,22,2,0,2,0.587145,0.594241,0.000486,"#00e8b2"
1937668256,Historieseuropa,14,0,3,3,0.636844,0.542769,0.000973,"#00eeff"
1937708048,Frioacero,30,0,1,1,0.597886,0.674814,0,"#ff77ff"
1938630679,Elevapuntovista,49,1,0,1,0.388365,0.707297,0,"#ff7007"
1938952987,JaumeRamonE,58,3,5,8,0.496517,0.570136,0.003405,"#005076"
1941110808,AlfonsoDeLaEra,49,0,1,1,0.251625,0.7005,0,"#ff7007"
1941460278,josejimr,38,0,1,1,0.609556,0.346032,0,"#662859"
1942567098,Roselyn_amarob,49,2,0,2,0.408595,0.562728,0.000486,"#ff7007"
1943340522,nodegoat,36,7,1,8,0.513973,0.404393,0.003405,"#825403"
1943363076,mayur_shingote,34,0,3,3,0.456749,0.466482,0.000973,"#ff0d69"
1944287011,manchaCinnova,31,0,1,1,0.713517,0.570776,0,"#3e93ff"
1944834853,ajquiroga1,22,1,1,2,0.406374,0.627077,0.000486,"#00e8b2"
1944835998,FabricandoLS,7,1,2,3,0.361933,0.369966,0.000973,"#ffb800"
1944877693,AliciaOcaso1,13,0,4,4,0.454993,0.451467,0.001459,"#3bec00"
1946470682,sandra_history,22,0,1,1,0.712253,0.624373,0,"#00e8b2"
1949404088,sisbiuba,49,4,0,4,0.467457,0.586716,0.001459,"#ff7007"
1949408102,fitzbub,36,0,1,1,0.413467,0.570019,0,"#825403"
1950015572,Maria_Aurora_1,30,1,1,2,0.541825,0.551381,0.000486,"#ff77ff"
1950230353,Lab101UNAL,38,0,3,3,0.532117,0.425001,0.000973,"#662859"
1950250616,VPerciante,1,0,2,2,0.487071,0.683823,0.000486,"#b6cb00"
1951208335,drmperezgarcia,1,0,1,1,0.484009,0.610739,0,"#b6cb00"
1951306459,EmblEsp,30,2,1,3,0.62609,0.684616,0.000973,"#ff77ff"
1951972399,RevistaEmpiria,30,0,1,1,0.50644,0.632537,0,"#ff77ff"
1952238739,tribunadetoledo,15,17,1,18,0.543632,0.605455,0.008268,"#008ebb"
1952470740,FIGRIExternado,53,8,3,11,0.508149,0.689826,0.004864,"#008bdd"
1952648671,RogerioMouraIec,36,0,1,1,0.642337,0.317441,0,"#825403"
1953269040,danielmnds34,36,2,2,4,0.522289,0.424528,0.001459,"#825403"
1953607634,mariacostaIP,0,4,1,5,0.498796,0.539867,0.001946,"#8ecfec"
1953926360,AoniaEdu,9,1,0,1,0.503407,0.645654,0,"#008f7b"
1954925419,Areusa46,22,0,1,1,0.662961,0.508077,0,"#00e8b2"
1956837272,bib_mais,49,0,8,8,0.490449,0.584806,0.003405,"#ff7007"
1957583623,VictorDezCastro,31,0,3,3,0.600113,0.533291,0.000973,"#3e93ff"
1957896704,F_A_B_B_S,37,2,0,2,0.596538,0.377508,0.000486,"#006032"
1958515710,MariusTheRoman,40,0,1,1,0.655983,0.046717,0,"#ff12a3"
1959032965,iesgm,15,0,1,1,0.549159,0.704301,0,"#008ebb"
1959342428,fernandogposada,22,0,1,1,0.55816,0.305494,0,"#00e8b2"
1960461116,crai_ub,30,0,2,2,0.533144,0.6892,0.000486,"#ff77ff"
1961144214,slavevoyages,36,3,0,3,0.482935,0.301096,0.000973,"#825403"
1962476652,DadunUnav,1,8,9,17,0.522666,0.592473,0.007782,"#b6cb00"
1962999248,tULEctura_ULE,37,5,3,8,0.500619,0.662945,0.003405,"#006032"
1963519538,antievictionmap,42,1,0,1,0.624085,0.40241,0,"#66e087"
1963682815,AuroraSore,4,0,1,1,0.829741,0.229587,0,"#f4c8cf"
1964862414,xaviermarin07,49,1,0,1,0.402401,0.655491,0,"#ff7007"
1965561835,ChicaDeCuero,40,0,1,1,0.604819,0.045109,0,"#ff12a3"
1965610009,coomunicando,49,1,0,1,0.361842,0.626532,0,"#ff7007"
1966403688,MadCulTour,37,0,1,1,0.370451,0.505135,0,"#006032"
1966455439,atc_ugr,22,1,3,4,0.644582,0.499899,0.001459,"#00e8b2"
1966785139,fungeuva,22,1,0,1,0.516795,0.711427,0,"#00e8b2"
1967039358,Karilibrarian,49,0,2,2,0.413299,0.578922,0.000486,"#ff7007"
1967146153,AcicomCom,37,1,0,1,0.469582,0.350596,0,"#006032"
1967492844,acamachoruiz,31,0,4,4,0.605471,0.547491,0.001459,"#3e93ff"
1968590478,mengjinzhao,30,0,2,2,0.560935,0.540725,0.000486,"#ff77ff"
1968828768,HealeyParera,34,9,19,28,0.461399,0.422662,0.013132,"#ff0d69"
1969289610,dea_ln_,36,0,1,1,0.573987,0.278869,0,"#825403"
1973024648,Nnadialba,30,0,5,5,0.526781,0.444078,0.001946,"#ff77ff"
1973455369,duartedeleon,49,1,0,1,0.329636,0.687587,0,"#ff7007"
1973605789,H_Buddhism,36,0,2,2,0.409361,0.463987,0.000486,"#825403"
1974768362,HesperidesAnd,49,2,0,2,0.353243,0.708165,0.000486,"#ff7007"
1975163382,LaMecedoraTEC,14,0,1,1,0.332695,0.555266,0,"#00eeff"
1975187095,MarcosbdsMarcos,36,0,1,1,0.48036,0.224955,0,"#825403"
1976854369,Vivir_En_Panama,49,1,0,1,0.370921,0.602802,0,"#ff7007"
1977823740,currmon,14,0,9,9,0.538428,0.53089,0.003891,"#00eeff"
1978307863,Gatete_NanA,37,0,1,1,0.614163,0.558705,0,"#006032"
1978993478,EBernalesAlbite,37,0,1,1,0.726536,0.269222,0,"#006032"
1979083904,ICArchiv,34,5,0,5,0.489346,0.526212,0.001946,"#ff0d69"
1979105492,TechneMexico,49,1,0,1,0.417419,0.684877,0,"#ff7007"
2147600652,dederusheni,36,0,2,2,0.441397,0.345899,0.000486,"#825403"
2147907888,ropinionpublica,34,0,2,2,0.607409,0.336828,0.000486,"#ff0d69"
2149684494,MaguaRED,38,1,1,2,0.602008,0.379765,0.000486,"#662859"
2149981274,Roxanamd09,42,0,1,1,0.712702,0.436106,0,"#66e087"
2150468880,anita_b_c,22,0,1,1,0.513638,0.703048,0,"#00e8b2"
2151032708,mimedellin,38,0,1,1,0.41011,0.35875,0,"#662859"
2152056204,abolicionistx,3,0,3,3,0.457468,0.566909,0.000973,"#ffb3ff"
2152209938,arsnovadelperu,31,0,2,2,0.595287,0.483951,0.000486,"#3e93ff"
2152668890,FU_Berlin,7,1,0,1,0.400706,0.239989,0,"#ffb800"
2153048057,SantosMMateos,14,0,1,1,0.576591,0.592505,0,"#00eeff"
2153214982,FernandoAlba0,38,0,1,1,0.071262,0.433156,0,"#662859"
2153380921,VorMX,49,0,1,1,0.383436,0.519012,0,"#ff7007"
2154323890,MariaElenaHerg,58,0,1,1,0.589399,0.172877,0,"#005076"
2154875112,icppr,49,1,0,1,0.407469,0.676942,0,"#ff7007"
2154965129,PepeCampana_Com,49,1,0,1,0.387077,0.628753,0,"#ff7007"
2155104415,MemoriaUniandes,37,18,5,23,0.546928,0.422433,0.0107,"#006032"
2155201212,UEFSoficial,36,1,0,1,0.565638,0.397985,0,"#825403"
2155293006,RosyLauraC,7,0,1,1,0.39541,0.729052,0,"#ffb800"
2155612308,ariciula,30,0,17,17,0.492301,0.511438,0.007782,"#ff77ff"
2155770324,PabloCDaz,30,0,2,2,0.578808,0.637254,0.000486,"#ff77ff"
2156301287,sanz_luc,22,0,2,2,0.503277,0.629353,0.000486,"#00e8b2"
2157886640,alphaomega343,22,0,1,1,0.553102,0.807178,0,"#00e8b2"
2158772880,CINoficial,49,2,0,2,0.403843,0.588954,0.000486,"#ff7007"
2158933553,Oximorona,49,0,3,3,0.429452,0.545009,0.000973,"#ff7007"
2159060402,rutgersdh,36,6,0,6,0.461205,0.378989,0.002432,"#825403"
2161155108,negritasycursiv,30,0,1,1,0.529612,0.73112,0,"#ff77ff"
2161181208,aamansofl,30,8,6,14,0.552231,0.561787,0.006323,"#ff77ff"
2161221152,idiosyncra_sie,13,0,1,1,0.384532,0.354586,0,"#3bec00"
2161236932,DANIELSENDA,22,0,1,1,0.667732,0.474091,0,"#00e8b2"
2161368259,RositaMerken,21,0,1,1,0.026412,0.634904,0,"#c6cc85"
2161671931,PuntodeVistaEd,22,0,1,1,0.613672,0.627247,0,"#00e8b2"
2161743601,Joseluiscalvoch,49,1,0,1,0.375924,0.636803,0,"#ff7007"
2162169318,julloa_d,13,0,2,2,0.439317,0.454568,0.000486,"#3bec00"
2162629226,zeialmeida,36,0,1,1,0.567447,0.396134,0,"#825403"
2162649109,FMatteoda,15,0,1,1,0.629218,0.420248,0,"#008ebb"
2162804552,MediaticoMFM,31,0,1,1,0.714812,0.264728,0,"#3e93ff"
2163086088,ANdeChile,21,1,7,8,0.519619,0.35222,0.003405,"#c6cc85"
2163358477,Nelton_Rivera,13,0,3,3,0.435774,0.45202,0.000973,"#3bec00"
2163967520,BDGuidance,49,1,0,1,0.311097,0.635251,0,"#ff7007"
2165186563,MismisimoJulian,49,1,0,1,0.392844,0.658822,0,"#ff7007"
2165315462,siers2,14,2,13,15,0.524657,0.548887,0.006809,"#00eeff"
2165639028,GiraldoGranda,9,0,2,2,0.67903,0.914942,0.000486,"#008f7b"
2167855734,jaimevargasluna,34,0,1,1,0.383318,0.46764,0,"#ff0d69"
2168094626,N_Perreaux,22,0,5,5,0.492048,0.585327,0.001946,"#00e8b2"
2168288684,AHDig,36,33,5,38,0.518126,0.483346,0.017996,"#825403"
2168351200,HoRichy,22,0,1,1,0.578051,0.678528,0,"#00e8b2"
2168504367,fru_javier,14,0,2,2,0.564598,0.564666,0.000486,"#00eeff"
2168931679,ActaAcademica,49,16,12,28,0.470076,0.542303,0.013132,"#ff7007"
2169018288,Patrciobarreiro,36,2,0,2,0.561966,0.438547,0.000486,"#825403"
2169207751,HazRizoma,13,0,1,1,0.503204,0.308768,0,"#3bec00"
2169482554,SHAFRhistorians,41,0,2,2,0.385864,0.396582,0.000486,"#697b00"
2171143608,RosinaLozano,34,0,1,1,0.302949,0.423487,0,"#ff0d69"
2171362475,MarinFlix,31,0,2,2,0.637191,0.548544,0.000486,"#3e93ff"
2171922163,ccnn1_CFIEVA,2,0,5,5,0.693864,0.451352,0.001946,"#ffa64e"
2172489460,Spassky63,49,1,0,1,0.358412,0.612954,0,"#ff7007"
2172605850,QUBDH,36,0,2,2,0.471277,0.574863,0.000486,"#825403"
2173041961,elburrolechoso,13,0,1,1,0.387894,0.327677,0,"#3bec00"
2173138592,JuanchiRG,49,0,1,1,0.340502,0.544069,0,"#ff7007"
2173676122,francoisperea,9,2,0,2,0.727413,0.671379,0.000486,"#008f7b"
2174482088,story645,34,0,3,3,0.409316,0.403002,0.000973,"#ff0d69"
2174542651,leandrocrestani,49,0,1,1,0.489902,0.352344,0,"#ff7007"
2174591569,artcathistorian,38,0,1,1,0.081165,0.438098,0,"#662859"
2174636612,rsvanduinen,36,0,1,1,0.400963,0.46582,0,"#825403"
2174766378,Bajoelalmendro_,22,0,1,1,0.393393,0.601618,0,"#00e8b2"
2174894173,continuum_ele,3,0,5,5,0.523888,0.640063,0.001946,"#ffb3ff"
2175301537,LGKEwbank,13,0,1,1,0.38434,0.392207,0,"#3bec00"
2175874323,pacoalbalate,31,0,1,1,0.782563,0.279343,0,"#3e93ff"
2175909506,javi_redondo14,15,0,2,2,0.53754,0.713124,0.000486,"#008ebb"
2176531326,UNEDAbierta,30,1,3,4,0.519726,0.596022,0.001459,"#ff77ff"
2176552094,isanavarrofc,31,1,7,8,0.601681,0.556043,0.003405,"#3e93ff"
2176875143,_JesusAlcaide,38,0,1,1,0.067078,0.437844,0,"#662859"
2177300574,galvisoscarw,8,0,1,1,0.273505,0.253502,0,"#00ed5d"
2178248406,Audiense_es,49,1,0,1,0.405591,0.696827,0,"#ff7007"
2178381952,ManojMayogi,22,0,2,2,0.627349,0.462894,0.000486,"#00e8b2"
2178904442,LkjonesSOC,34,0,4,4,0.481104,0.430494,0.001459,"#ff0d69"
2180073241,ITwareLatam,49,1,0,1,0.292073,0.654235,0,"#ff7007"
2180423107,mmespino20,34,0,5,5,0.43616,0.255382,0.001946,"#ff0d69"
2180633874,marcemendezmkt,49,0,1,1,0.393723,0.520392,0,"#ff7007"
2180719362,antoniodomr8,17,0,1,1,0.922532,0.376672,0,"#ff9cc7"
2181274552,alfredinbcn,40,0,1,1,0.604136,0.002027,0,"#ff12a3"
2182111008,AlaBuenaGente,40,0,1,1,0.592244,0.003369,0,"#ff12a3"
2183056898,Ubitsco,49,1,0,1,0.341646,0.641746,0,"#ff7007"
2183069016,2003Pati,21,0,2,2,0.262797,0.28423,0.000486,"#c6cc85"
2183659913,restreposofia27,38,0,1,1,0.678291,0.447413,0,"#662859"
2183948778,seecmadrid,58,1,4,5,0.649892,0.543097,0.001946,"#005076"
2184660524,dgestudiantes,30,4,2,6,0.514,0.528861,0.002432,"#ff77ff"
2184765414,TRICLab,14,8,2,10,0.528643,0.597908,0.004377,"#00eeff"
2185096929,PetauroSensual5,31,0,3,3,0.61931,0.532524,0.000973,"#3e93ff"
2186321981,AnaCasadoSa,8,0,1,1,0.244965,0.257952,0,"#00ed5d"
2186834906,GrOC__,1,1,1,2,0.35707,0.71303,0.000486,"#b6cb00"
2187029244,embigei,49,2,0,2,0.42312,0.616134,0.000486,"#ff7007"
2187101753,_carminaburana,30,0,3,3,0.39812,0.614988,0.000973,"#ff77ff"
2188213258,jorgegustavof,3,0,1,1,0.460494,0.73352,0,"#ffb3ff"
2188794080,FMAPFREHistoria,13,7,1,8,0.575992,0.516751,0.003405,"#3bec00"
2188868180,BiblioColmex,7,225,34,259,0.451105,0.423612,0.125486,"#ffb800"
2188896918,sanantoniortv,49,1,0,1,0.326991,0.661743,0,"#ff7007"
2189039479,nan_pere,49,0,1,1,0.371334,0.569947,0,"#ff7007"
2189970301,VBerjaga,15,0,3,3,0.595733,0.44764,0.000973,"#008ebb"
2190381132,ALAArchivos,36,3,2,5,0.588091,0.422257,0.001946,"#825403"
2190876324,SocialCultura,31,0,8,8,0.593307,0.491852,0.003405,"#3e93ff"
2191227130,ricardhuerta,31,5,0,5,0.596484,0.554142,0.001946,"#3e93ff"
2191751429,pablocastillo97,58,0,1,1,0.598036,0.184227,0,"#005076"
2192078248,anonimusbeba,21,0,2,2,0.278904,0.245503,0.000486,"#c6cc85"
2192093752,MadeleineSaint,34,0,5,5,0.453428,0.456535,0.001946,"#ff0d69"
2192870503,Uniandesbiblio,37,0,1,1,0.656248,0.379038,0,"#006032"
2193113990,thewordmechanic,34,0,1,1,0.328963,0.412379,0,"#ff0d69"
2193736076,jibalari,34,0,2,2,0.431234,0.486301,0.000486,"#ff0d69"
2194476668,SemanaEd,38,1,0,1,0.681945,0.478851,0,"#662859"
2194760965,PaisajeHistoria,58,0,1,1,0.55316,0.188258,0,"#005076"
2196019344,UAB_Coursera,14,20,8,28,0.605463,0.525157,0.013132,"#00eeff"
2196574902,ParrillaAmador,30,0,4,4,0.539066,0.603383,0.001459,"#ff77ff"
2197086420,IvanAgudeloZ,9,11,1,12,0.670675,0.864757,0.00535,"#008f7b"
2197205938,mjoseposa,30,0,1,1,0.613552,0.672359,0,"#ff77ff"
2197423633,LaMalagaModerna,49,0,1,1,0.480342,0.718785,0,"#ff7007"
2197602265,EgiptoAlDia,30,0,1,1,0.685402,0.620571,0,"#ff77ff"
2197805160,notherIdiot,58,0,1,1,0.467121,0.637431,0,"#005076"
2198189983,jonortizgarcia,34,0,3,3,0.511158,0.494862,0.000973,"#ff0d69"
2200033718,VnGallier,37,1,0,1,0.577115,0.369221,0,"#006032"
2200160047,VAtradu,15,0,1,1,0.537507,0.681167,0,"#008ebb"
2200403064,adeniho,7,1,8,9,0.486749,0.512392,0.003891,"#ffb800"
2200870478,JuliettaOnescu,36,0,2,2,0.399429,0.377167,0.000486,"#825403"
2201878938,Altmannbrunner,58,0,2,2,0.62456,0.303316,0.000486,"#005076"
2203691011,flaviuscerialis,2,0,1,1,0.394261,0.552165,0,"#ffa64e"
2204753449,Indika1096,38,0,2,2,0.68853,0.586839,0.000486,"#662859"
2204881088,NuevaCanariasTF,14,0,2,2,0.601886,0.691372,0.000486,"#00eeff"
2205202104,MujeresJefasFam,7,0,1,1,0.363016,0.363486,0,"#ffb800"
2205518958,LNCleon,37,6,0,6,0.532005,0.612471,0.002432,"#006032"
2205872328,Jaime2Amador,17,0,1,1,0.821227,0.238679,0,"#ff9cc7"
2205950088,MagdalenaM21,49,1,0,1,0.323451,0.685783,0,"#ff7007"
2205986137,insfranmariav,14,0,1,1,0.626172,0.545035,0,"#00eeff"
2206545987,jannunezm,21,0,1,1,0.013167,0.646291,0,"#c6cc85"
2206639501,amajoki,49,1,0,1,0.396126,0.649724,0,"#ff7007"
2207175750,LibraryGamerES,22,0,7,7,0.575564,0.513039,0.002918,"#00e8b2"
2208142365,unipymemadrid,14,4,1,5,0.653759,0.692993,0.001946,"#00eeff"
2209053620,MidAtlanticArts,34,0,2,2,0.359504,0.430064,0.000486,"#ff0d69"
2209534382,carolinaleo66,49,1,0,1,0.335362,0.604905,0,"#ff7007"
2209706828,NorahLAGharala,22,0,2,2,0.558126,0.602573,0.000486,"#00e8b2"
2209843980,CMELGAREJOR,13,0,1,1,0.436164,0.353731,0,"#3bec00"
2210397950,annavsk,49,0,1,1,0.360563,0.495251,0,"#ff7007"
2210832192,mpilarpuig,58,0,7,7,0.499966,0.570061,0.002918,"#005076"
2210859930,citizenkang77,38,0,1,1,0.532223,0.319399,0,"#662859"
2211060619,Marggordillo,1,0,1,1,0.425979,0.633574,0,"#b6cb00"
2212790731,Inigo_LRB,14,0,3,3,0.520078,0.574838,0.000973,"#00eeff"
2213062418,23ALZAT,38,0,3,3,0.620558,0.418035,0.000973,"#662859"
2213161453,LuzGomezGar,37,0,4,4,0.610362,0.485909,0.001459,"#006032"
2213772019,llangarcia1,30,0,1,1,0.570189,0.66426,0,"#ff77ff"
2213996546,u_0043,22,4,0,4,0.740379,0.284032,0.001459,"#00e8b2"
2214990090,Acacia360,49,0,1,1,0.251279,0.636624,0,"#ff7007"
2215605967,TIGnArqueologia,14,1,0,1,0.515861,0.610124,0,"#00eeff"
2215659596,irenefreyre74,1,0,4,4,0.511826,0.583518,0.001459,"#b6cb00"
2215729160,zachcaceres,14,1,0,1,0.711837,0.568958,0,"#00eeff"
2215899439,_lamenor,37,0,2,2,0.53771,0.683315,0.000486,"#006032"
2216257418,MaraLGilLaureir,30,0,2,2,0.548873,0.615751,0.000486,"#ff77ff"
2216636924,PilaricaLectora,31,0,1,1,0.629582,0.58978,0,"#3e93ff"
2216651700,dlhistoria,2,3,0,3,0.511454,0.40949,0.000973,"#ffa64e"
2216977044,xFertrick,38,0,1,1,0.824884,0.637039,0,"#662859"
2218307641,AlReyesR,30,0,1,1,0.455357,0.597011,0,"#ff77ff"
2218461564,Ed_Baptist,36,1,0,1,0.504929,0.330047,0,"#825403"
2218480500,Brujabrarian,34,0,2,2,0.342254,0.41407,0.000486,"#ff0d69"
2218642603,valentinazapico,13,1,0,1,0.319027,0.349551,0,"#3bec00"
2219216983,FlogCorr,30,0,4,4,0.438027,0.577357,0.001459,"#ff77ff"
2220031674,bbaw_de,49,1,0,1,0.371804,0.491241,0,"#ff7007"
2221239056,bego_her,2,0,2,2,0.681472,0.369371,0.000486,"#ffa64e"
2221802778,DThinkingUS,1,0,2,2,0.442119,0.633476,0.000486,"#b6cb00"
2222108763,AlvarezAmalia84,38,0,1,1,0.150463,0.824488,0,"#662859"
2222176923,ramongolia,58,0,2,2,0.614701,0.295788,0.000486,"#005076"
2222945773,mortuuminurbe,30,0,7,7,0.565192,0.42053,0.002918,"#ff77ff"
2224965637,RonaldDuran_CM,31,2,3,5,0.468878,0.544521,0.001946,"#3e93ff"
2225015562,Decaeloveniet,22,0,2,2,0.49935,0.655762,0.000486,"#00e8b2"
2225707479,marriavsf,37,0,1,1,0.753618,0.503099,0,"#006032"
2226123904,averaquiroz,21,0,2,2,0.202786,0.250287,0.000486,"#c6cc85"
2226890449,AcademicaUBA,49,7,4,11,0.402591,0.543946,0.004864,"#ff7007"
2227010643,anatlazaro,13,0,6,6,0.499394,0.510436,0.002432,"#3bec00"
2227356042,Ego_sumergo,58,0,3,3,0.627926,0.425568,0.000973,"#005076"
2228466859,DatosCientific,41,0,3,3,0.384359,0.487815,0.000973,"#697b00"
2228914730,AP_APAlmeria,0,3,10,13,0.89785,0.702119,0.005837,"#8ecfec"
2229131067,MarinaGM15,19,0,1,1,0.677941,0.838334,0,"#00d3ff"
2229143096,tomatesoy_,37,2,0,2,0.583594,0.369483,0.000486,"#006032"
2229186753,renemolinag,49,2,0,2,0.334715,0.696385,0.000486,"#ff7007"
2229951426,BChapaprieta,49,2,0,2,0.433609,0.660068,0.000486,"#ff7007"
2230003999,nfarias1976,55,0,1,1,0.721198,0.652476,0,"#cb3f32"
2230229036,avila71201798,7,0,1,1,0.404848,0.349013,0,"#ffb800"
2230346539,KUEnglish,41,1,0,1,0.342638,0.442129,0,"#697b00"
2230400479,crihunum,30,1,0,1,0.544206,0.62048,0,"#ff77ff"
2230670947,MattieT650,36,0,1,1,0.417213,0.572673,0,"#825403"
2230706274,ViejadelaguaDM,14,1,1,2,0.59854,0.454426,0.000486,"#00eeff"
2231140664,COPICLOUD,31,0,1,1,0.667043,0.547544,0,"#3e93ff"
2231260064,DHBerkeley,14,1,0,1,0.59128,0.576294,0,"#00eeff"
2231373823,GranadaCiencias,31,0,8,8,0.622116,0.533198,0.003405,"#3e93ff"
2231464708,bar_zie,0,0,2,2,0.52023,0.430732,0.000486,"#8ecfec"
2232171540,archaeoklammt,36,0,2,2,0.478889,0.374668,0.000486,"#825403"
2232449236,Sr_Aznar,16,0,2,2,0.942988,0.662846,0.000486,"#c42c63"
2234398223,Logiamillennium,31,0,9,9,0.555742,0.53639,0.003891,"#3e93ff"
2234750844,mamhoff,36,2,0,2,0.458905,0.346512,0.000486,"#825403"
2235103250,lhalo22,17,0,1,1,0.822905,0.242783,0,"#ff9cc7"
2235717645,romashente,14,0,2,2,0.631815,0.631108,0.000486,"#00eeff"
2236579298,angels_frances,58,0,1,1,0.567898,0.724498,0,"#005076"
2236744081,StephG_Cabello,7,0,1,1,0.804815,0.558879,0,"#ffb800"
2237045747,xos_schz,58,0,2,2,0.496258,0.579407,0.000486,"#005076"
2237172871,s_chavarri,14,0,1,1,0.404159,0.556451,0,"#00eeff"
2238111765,araramendia,30,0,1,1,0.624048,0.443833,0,"#ff77ff"
2238132050,ReartedixUma,14,11,6,17,0.577109,0.534354,0.007782,"#00eeff"
2238179850,guiants,13,0,1,1,0.497483,0.396974,0,"#3bec00"
2238250229,Llumjuan,22,1,3,4,0.579652,0.580897,0.001459,"#00e8b2"
2238281060,odacuba,43,0,1,1,0.71609,0.566745,0,"#fcae7e"
2239713997,carlosacreativo,49,0,11,11,0.483956,0.556866,0.004864,"#ff7007"
2240749921,AlmeriaJunta,2,0,2,2,0.677958,0.664167,0.000486,"#ffa64e"
2242127486,lucantamutto,49,30,19,49,0.470728,0.527323,0.023346,"#ff7007"
2243006317,CaseyLurtz,34,0,1,1,0.316212,0.276787,0,"#ff0d69"
2243162053,EsteTipin,13,0,2,2,0.481152,0.393276,0.000486,"#3bec00"
2243556684,BCNInnovacio,14,0,4,4,0.607924,0.467467,0.001459,"#00eeff"
2243785820,CSerranot2,49,4,0,4,0.439428,0.573748,0.001459,"#ff7007"
2244763136,Carmenciushappy,49,1,0,1,0.334873,0.652725,0,"#ff7007"
2245004198,RPAristarco,34,0,1,1,0.474539,0.374229,0,"#ff0d69"
2245342114,vmezadelc,8,0,1,1,0.265717,0.250361,0,"#00ed5d"
2245983919,enortasuna,31,4,7,11,0.557971,0.482852,0.004864,"#3e93ff"
2246026273,esartificial,49,0,1,1,0.290238,0.598449,0,"#ff7007"
2246225294,_Horizontal_,3,1,0,1,0.496989,0.658616,0,"#ffb3ff"
2246332859,upf_occ,31,2,2,4,0.565063,0.503304,0.001459,"#3e93ff"
2246428187,NunoTwitting,22,0,3,3,0.494136,0.527255,0.000973,"#00e8b2"
2246482128,acamijurado,3,0,2,2,0.337149,0.532897,0.000486,"#ffb3ff"
2246658294,SaApolinar,7,0,1,1,0.41162,0.304593,0,"#ffb800"
2246917988,talentiagestio,49,1,0,1,0.382321,0.653029,0,"#ff7007"
2246982871,TICsyFormacion,49,1,0,1,0.301657,0.60147,0,"#ff7007"
2247442387,vrivap,30,0,1,1,0.587661,0.684331,0,"#ff77ff"
2247791346,DrLuisG_IU,13,0,11,11,0.522195,0.549227,0.004864,"#3bec00"
2248027368,BlackDigitalHum,36,6,0,6,0.44367,0.378088,0.002432,"#825403"
2248525465,CulturalGranada,31,0,5,5,0.604234,0.515198,0.001946,"#3e93ff"
2249053897,milenajava,38,0,1,1,0.136549,0.825186,0,"#662859"
2249166906,LornaRebolledo1,22,0,1,1,0.594013,0.622883,0,"#00e8b2"
2249256122,MINCOMCuba,43,1,0,1,0.595435,0.744645,0,"#fcae7e"
2249296076,14AbrilCosta,19,2,5,7,0.636614,0.754516,0.002918,"#00d3ff"
2249376488,joseleivaaldea,14,0,8,8,0.559565,0.536265,0.003405,"#00eeff"
2250317311,CaramboloSCA,19,2,0,2,0.660745,0.747599,0.000486,"#00d3ff"
2250487007,angel_complutum,22,0,1,1,0.683172,0.594532,0,"#00e8b2"
2250564248,mmmortiz,14,4,1,5,0.447725,0.544467,0.001946,"#00eeff"
2250652961,EdithCaicedoC,38,0,1,1,0.615555,0.339017,0,"#662859"
2250718783,biafurst,48,0,1,1,0.22562,0.719526,0,"#ff7a78"
2252590692,DoFaRadio,22,0,9,9,0.466161,0.673039,0.003891,"#00e8b2"
2252922493,ale70xcc,14,0,2,2,0.681048,0.527002,0.000486,"#00eeff"
2253485054,pilycarolina,21,0,2,2,0.270039,0.225831,0.000486,"#c6cc85"
2253865244,VenerandaPalau,13,0,3,3,0.41326,0.396134,0.000973,"#3bec00"
2254108561,nataliamaillard,1,3,0,3,0.475979,0.558944,0.000973,"#b6cb00"
2255517997,SeedConsultingB,8,0,1,1,0.256262,0.248824,0,"#00ed5d"
2255888851,Emmanue2305,37,0,1,1,0.635748,0.38112,0,"#006032"
2257337244,daniel_cueroXD,41,0,3,3,0.395882,0.4215,0.000973,"#697b00"
2258223979,MexHistorian,36,0,2,2,0.370502,0.444664,0.000486,"#825403"
2258765649,samintheend,13,1,0,1,0.418121,0.37337,0,"#3bec00"
2259618787,EducacionXX1,30,0,5,5,0.493806,0.532349,0.001946,"#ff77ff"
2260355683,mymieres,30,0,4,4,0.5291,0.487235,0.001459,"#ff77ff"
2260364755,jabs305,22,0,2,2,0.640355,0.467446,0.000486,"#00e8b2"
2260612411,gabmarpe,30,0,3,3,0.551841,0.595854,0.000973,"#ff77ff"
2260912773,alvaroga97,38,0,1,1,0.717605,0.585465,0,"#662859"
2261792322,AgripinaMaior,30,0,1,1,0.274695,0.639078,0,"#ff77ff"
2261831748,lista_redes,30,0,1,1,0.621316,0.606311,0,"#ff77ff"
2263399680,hedisa44,37,0,1,1,0.695341,0.508532,0,"#006032"
2264471298,MexicoesCiencia,17,0,1,1,0.637179,0.270469,0,"#ff9cc7"
2264559204,Benji_Marcellus,30,0,1,1,0.449553,0.593253,0,"#ff77ff"
2264604044,FCompartirCol,34,0,1,1,0.565544,0.341882,0,"#ff0d69"
2265096360,albertolarrains,21,0,1,1,0.039303,0.621799,0,"#c6cc85"
2266466816,JuanJosePonsIzq,1,48,9,57,0.631523,0.464603,0.027237,"#b6cb00"
2269309716,Worondo,14,0,1,1,0.591215,0.520094,0,"#00eeff"
2271598559,robpmiro,49,1,0,1,0.392882,0.625769,0,"#ff7007"
2271676110,Lamachinearien,34,0,1,1,0.533844,0.344935,0,"#ff0d69"
2272083980,iicchhvvaall,7,0,1,1,0.370305,0.354506,0,"#ffb800"
2272120220,PapirosPerdidos,42,0,5,5,0.621957,0.518507,0.001946,"#66e087"
2272916900,delmonacofondie,36,1,0,1,0.56431,0.391209,0,"#825403"
2273320638,AndConectada,0,0,2,2,0.531373,0.547412,0.000486,"#8ecfec"
2273350579,bit_institute,49,1,0,1,0.324891,0.642867,0,"#ff7007"
2274752798,ArnoldHermosil1,21,0,1,1,0.204874,0.223282,0,"#c6cc85"
2274803772,MariaInesTato,13,0,1,1,0.432429,0.502642,0,"#3bec00"
2276255216,MariaDMayan,14,0,3,3,0.512168,0.574927,0.000973,"#00eeff"
2277357299,gran_guerra,22,1,0,1,0.642876,0.612388,0,"#00e8b2"
2277592465,SchezPablo,3,0,1,1,0.601595,0.710891,0,"#ffb3ff"
2277666787,WetheHumanities,30,0,1,1,0.496974,0.635339,0,"#ff77ff"
2277671516,BL_AdiKS,34,0,1,1,0.468452,0.376818,0,"#ff0d69"
2277851595,MkCangrejo,38,0,1,1,0.680135,0.458226,0,"#662859"
2278438327,LuisFeGF,34,0,1,1,0.583231,0.358183,0,"#ff0d69"
2278485025,LicLinaReyes,7,2,4,6,0.42915,0.471435,0.002432,"#ffb800"
2279322651,E_Estudiantes,37,0,1,1,0.653606,0.489919,0,"#006032"
2279505829,desobediencia_c,30,0,2,2,0.59375,0.445026,0.000486,"#ff77ff"
2280612877,quincocesa,30,0,4,4,0.514935,0.517927,0.001459,"#ff77ff"
2280762302,twitty_clair,22,0,4,4,0.842207,0.719227,0.001459,"#00e8b2"
2280982777,avamus2,34,0,1,1,0.577559,0.354063,0,"#ff0d69"
2281054586,Barros_Arana,21,2,1,3,0.367975,0.344755,0.000973,"#c6cc85"
2281290679,TedGroschScifi,36,0,1,1,0.727687,0.600214,0,"#825403"
2281453208,pesasymedidas,7,0,1,1,0.791944,0.547943,0,"#ffb800"
2281532326,library_gabirol,49,3,0,3,0.45033,0.584283,0.000973,"#ff7007"
2282125657,narrarelfuturo,38,0,2,2,0.546988,0.348116,0.000486,"#662859"
2282412624,UniRomaTre,22,3,3,6,0.538239,0.599935,0.002432,"#00e8b2"
2284320079,formasustancia,54,0,2,2,0.321974,0.819275,0.000486,"#ff332c"
2284763166,fotoshistori9,19,1,0,1,0.660001,0.775263,0,"#00d3ff"
2285625770,ICCMU,30,0,4,4,0.555908,0.60912,0.001459,"#ff77ff"
2286341286,jjcampos14,4,0,4,4,0.930514,0.242321,0.001459,"#f4c8cf"
2286768204,UPRMHumanidades,36,12,1,13,0.503614,0.380902,0.005837,"#825403"
2287114322,TtorresFelipe,21,0,2,2,0.232748,0.258707,0.000486,"#c6cc85"
2287169136,demijardin,22,0,12,12,0.582883,0.542565,0.00535,"#00e8b2"
2287287992,Patrimonio_Mas,49,0,1,1,0.400955,0.707385,0,"#ff7007"
2287431655,VigoloLiliana,8,0,2,2,0.347113,0.531542,0.000486,"#00ed5d"
2287474189,Robfem,49,1,0,1,0.419046,0.68254,0,"#ff7007"
2288138575,PODEMOS,14,1,0,1,0.595713,0.372554,0,"#00eeff"
2288588605,cuchufletapl,38,0,1,1,0.105814,0.444035,0,"#662859"
2288700554,Perfages,30,0,1,1,0.627494,0.584495,0,"#ff77ff"
2289105926,davidandresbus2,3,0,1,1,0.480675,0.790773,0,"#ffb3ff"
2289482047,fawcor,1,0,1,1,0.703032,0.486532,0,"#b6cb00"
2289771144,LaDelToboso,30,0,2,2,0.507689,0.526707,0.000486,"#ff77ff"
2289835369,lamusadecima,30,49,53,102,0.504093,0.53368,0.049125,"#ff77ff"
2290132986,lecturaseclipse,30,0,1,1,0.531468,0.641343,0,"#ff77ff"
2290286478,golosinacanibal,49,0,1,1,0.297935,0.593719,0,"#ff7007"
2290787012,HablamedeTIC,13,0,3,3,0.458258,0.453161,0.000973,"#3bec00"
2290913742,AnnaShalot,49,1,0,1,0.426193,0.695731,0,"#ff7007"
2291131110,guadatech,31,0,2,2,0.653953,0.546096,0.000486,"#3e93ff"
2291301439,anapcolombia,38,2,1,3,0.665012,0.424108,0.000973,"#662859"
2291367079,flamand_laura,7,8,21,29,0.458213,0.421971,0.013619,"#ffb800"
2291689898,HistoriaObrera,19,7,0,7,0.625624,0.724667,0.002918,"#00d3ff"
2292142094,claus_alarcon,35,1,0,1,0.68814,0.290779,0,"#00faff"
2292454884,arturjoyeux,34,0,4,4,0.504926,0.430604,0.001459,"#ff0d69"
2292852655,Minsky_robot,30,0,3,3,0.506964,0.572457,0.000973,"#ff77ff"
2293094474,rodrigoschneer,38,0,1,1,0.279764,0.622318,0,"#662859"
2293276585,anemoma5775,38,0,1,1,0.682175,0.458566,0,"#662859"
2293458549,cri_salazar,21,0,2,2,0.254401,0.227875,0.000486,"#c6cc85"
2294113730,usvirtualempleo,1,3,1,4,0.481896,0.615883,0.001459,"#b6cb00"
2294164837,UniversidadeUSC,14,41,8,49,0.482262,0.545901,0.023346,"#00eeff"
2294245189,BibliotecaUPSA,31,3,2,5,0.489678,0.563936,0.001946,"#3e93ff"
2294248922,URJConline,15,0,1,1,0.616628,0.464507,0,"#008ebb"
2294544162,umontpellier,9,2,0,2,0.706017,0.686123,0.000486,"#008f7b"
2295161101,pedraogeraldo,40,0,1,1,0.615948,0.053511,0,"#ff12a3"
2296142553,sandraceliah,36,4,3,7,0.725276,0.48711,0.002918,"#825403"
2296150742,fietcat,37,3,0,3,0.583074,0.348579,0.000973,"#006032"
2296379731,cesexto,14,0,1,1,0.644917,0.557608,0,"#00eeff"
2296975610,Sociedadeeii,30,0,3,3,0.546071,0.548537,0.000973,"#ff77ff"
2297150149,xala1952,49,1,0,1,0.323793,0.618741,0,"#ff7007"
2297195466,Gatoherrera200,37,0,1,1,0.639786,0.285443,0,"#006032"
2297281950,LNBagatela,34,0,1,1,0.551007,0.334978,0,"#ff0d69"
2298586285,afeministagr,19,2,0,2,0.55891,0.628115,0.000486,"#00d3ff"
2298954732,Edizsan5808Diaz,3,0,1,1,0.464915,0.752485,0,"#ffb3ff"
2299690216,frikiquark,30,0,1,1,0.264571,0.630557,0,"#ff77ff"
2299954243,bvcontentart,42,0,1,1,0.708376,0.443176,0,"#66e087"
2299976863,PodemosGuada,19,1,0,1,0.699991,0.769188,0,"#00d3ff"
2300299530,DiarioBitcoin,49,1,0,1,0.333545,0.627571,0,"#ff7007"
2300414440,Bnegronmar,21,0,1,1,0.042161,0.657921,0,"#c6cc85"
2301533310,ResidInvestig,22,6,2,8,0.515327,0.645006,0.003405,"#00e8b2"
2301798600,EvaMonNa,22,0,1,1,0.476075,0.735152,0,"#00e8b2"
2303043452,ArojasCastro,34,1,0,1,0.500235,0.397842,0,"#ff0d69"
2303412468,Eduardo280714,31,0,7,7,0.576685,0.512625,0.002918,"#3e93ff"
2303489407,parcdia,30,0,1,1,0.71066,0.650232,0,"#ff77ff"
2304003077,monrram,7,0,2,2,0.390602,0.35281,0.000486,"#ffb800"
2304322962,snehabohr,22,0,2,2,0.633769,0.458206,0.000486,"#00e8b2"
2305912220,AldoStuka,31,0,2,2,0.471149,0.642248,0.000486,"#3e93ff"
2306958823,celswords,40,0,2,2,0.092457,0.411196,0.000486,"#ff12a3"
2306990414,Lgo13Olg,17,0,1,1,0.932061,0.383933,0,"#ff9cc7"
2307746669,lamusadelarte,31,1,0,1,0.671407,0.485723,0,"#3e93ff"
2308243387,Anushka_Benari,30,0,1,1,0.606387,0.653534,0,"#ff77ff"
2308416843,E_lighthouse,30,0,2,2,0.482716,0.623087,0.000486,"#ff77ff"
2308473548,derknobs,36,1,0,1,0.564787,0.390795,0,"#825403"
2308520677,Ipoutrin,22,1,0,1,0.47987,0.677868,0,"#00e8b2"
2308613901,qvalcav,22,0,2,2,0.654755,0.599423,0.000486,"#00e8b2"
2308726730,nabucodonosorct,30,0,1,1,0.514802,0.630244,0,"#ff77ff"
2309271572,piggy135764,49,1,0,1,0.348494,0.704817,0,"#ff7007"
2309360775,amarin_sanchez,49,0,1,1,0.380422,0.601351,0,"#ff7007"
2310584452,ondiz_,22,0,1,1,0.494602,0.61405,0,"#00e8b2"
2310817608,Pekenoyoker,38,0,1,1,0.51926,0.313486,0,"#662859"
2310907670,gonzalez_zapata,21,0,2,2,0.296778,0.245743,0.000486,"#c6cc85"
2311073193,rosafalacoisas,36,1,0,1,0.567987,0.205134,0,"#825403"
2311490583,oletusbuevos,40,0,1,1,0.589588,0.009529,0,"#ff12a3"
2312145266,angelvinashist,19,1,0,1,0.671383,0.758111,0,"#00d3ff"
2313406124,CCBiblio,30,0,3,3,0.59679,0.611841,0.000973,"#ff77ff"
2313426584,fylUAH,37,2,0,2,0.6325,0.424453,0.000486,"#006032"
2313568376,Navarrainforma,49,2,0,2,0.429638,0.533484,0.000486,"#ff7007"
2313772268,Roblescorc,7,0,2,2,0.428825,0.332725,0.000486,"#ffb800"
2314322448,GabyEclissi,6,0,1,1,0.330315,0.752783,0,"#a67800"
2315254149,laura_llc27,30,0,1,1,0.53366,0.70558,0,"#ff77ff"
2315608478,SemanticsConf,0,2,0,2,0.316953,0.530744,0.000486,"#8ecfec"
2315798245,FeSPeriodistas,31,0,1,1,0.674188,0.533766,0,"#3e93ff"
2316479310,lectordigresivo,7,0,1,1,0.770961,0.642516,0,"#ffb800"
2316993702,forumsocialhist,19,1,0,1,0.671929,0.782717,0,"#00d3ff"
2317014671,ruhm_online,30,2,2,4,0.644889,0.571921,0.001459,"#ff77ff"
2317329480,CRH_ehess,35,4,4,8,0.54019,0.493603,0.003405,"#00faff"
2317570764,SpanishLe,2,0,2,2,0.478759,0.636038,0.000486,"#ffa64e"
2318490740,FLOENPC,22,0,1,1,0.559471,0.689367,0,"#00e8b2"
2319021019,ONB_RD,34,0,3,3,0.450806,0.501156,0.000973,"#ff0d69"
2319536772,_DigitalWriters,0,0,1,1,0.529816,0.405675,0,"#8ecfec"
2319631896,_ycarballar,49,1,0,1,0.397939,0.666542,0,"#ff7007"
2319997146,marijel_melo,34,0,2,2,0.362479,0.405198,0.000486,"#ff0d69"
2320585169,phishygirl62,34,0,1,1,0.330079,0.408191,0,"#ff0d69"
2322986172,Fran_CortesM,1,0,2,2,0.528616,0.619559,0.000486,"#b6cb00"
2324064712,AAnacronica64,37,0,1,1,0.548531,0.757037,0,"#006032"
2324414521,LaFresaCulta,7,0,1,1,0.420616,0.30236,0,"#ffb800"
2324809379,OpenArtspty,31,0,1,1,0.752194,0.930136,0,"#3e93ff"
2325434774,ilopezalcauza,0,1,0,1,0.912378,0.332783,0,"#8ecfec"
2325436118,AnesCreativo,31,0,5,5,0.600657,0.518323,0.001946,"#3e93ff"
2325798829,EstacionCKWEB,38,3,3,6,0.745938,0.42749,0.002432,"#662859"
2325856560,tysmagazine,22,4,0,4,0.583481,0.600327,0.001459,"#00e8b2"
2326031431,kaathlenC,13,0,1,1,0.409701,0.458131,0,"#3bec00"
2326741560,RISM_music,36,1,0,1,0.451916,0.295632,0,"#825403"
2327002302,mabermart,31,0,2,2,0.626226,0.516248,0.000486,"#3e93ff"
2327392447,beatriz39746205,13,0,4,4,0.462912,0.448278,0.001459,"#3bec00"
2327697072,Transmedia_UGR,31,28,9,37,0.563845,0.553975,0.01751,"#3e93ff"
2327832691,NumbersOficial,49,1,0,1,0.358648,0.661206,0,"#ff7007"
2327881154,ZerothMonica,8,0,1,1,0.247799,0.2612,0,"#00ed5d"
2328895178,christian_16ec,49,1,0,1,0.361269,0.664445,0,"#ff7007"
2329002257,LaSalleSdr,15,0,2,2,0.627384,0.422288,0.000486,"#008ebb"
2329062542,jramonvallejo,22,2,8,10,0.556448,0.546633,0.004377,"#00e8b2"
2329097689,SicromTech,49,2,0,2,0.395148,0.574704,0.000486,"#ff7007"
2329591376,hackrancho,14,2,0,2,0.491371,0.454308,0.000486,"#00eeff"
2329615820,Elizang61380150,40,0,1,1,0.642266,0.032122,0,"#ff12a3"
2329800492,WeAreWikipedia,13,0,2,2,0.448901,0.418943,0.000486,"#3bec00"
2330108059,abigranca,30,1,3,4,0.536671,0.60011,0.001459,"#ff77ff"
2330353434,LoteroLi,30,1,0,1,0.576597,0.544737,0,"#ff77ff"
2331251749,mirimuji,17,0,1,1,0.919208,0.388502,0,"#ff9cc7"
2332134478,conilena,58,0,2,2,0.466354,0.631848,0.000486,"#005076"
2332254709,Licsoniacesio,30,0,2,2,0.576289,0.46525,0.000486,"#ff77ff"
2332739696,hugolittico,21,0,2,2,0.201049,0.257295,0.000486,"#c6cc85"
2334332359,lnfoComunio,49,1,0,1,0.386143,0.624067,0,"#ff7007"
2335839211,arqueologo_,22,0,2,2,0.555986,0.602866,0.000486,"#00e8b2"
2335936626,researchinthedf,30,0,1,1,0.600756,0.652831,0,"#ff77ff"
2336399766,eldiarioCultura,14,3,0,3,0.480508,0.66911,0.000973,"#00eeff"
2336531028,NovosAlunosFCSH,36,1,0,1,0.566976,0.385758,0,"#825403"
2336599585,somar0209,58,0,1,1,0.596665,0.1785,0,"#005076"
2336611165,rguerralde,49,0,2,2,0.370509,0.508244,0.000486,"#ff7007"
2337307843,stttff,34,0,11,11,0.465542,0.484767,0.004864,"#ff0d69"
2337308792,rusodosky,13,0,1,1,0.465252,0.343721,0,"#3bec00"
2337417505,istacihuatzin,38,0,3,3,0.596679,0.503472,0.000973,"#662859"
2337473174,anarchytecture,38,1,0,1,0.393537,0.224572,0,"#662859"
2338340012,JamesStaig,49,0,7,7,0.438692,0.485518,0.002918,"#ff7007"
2338818666,loliteli,37,0,2,2,0.559011,0.332927,0.000486,"#006032"
2338900028,dalasonico,38,0,1,1,0.109001,0.80057,0,"#662859"
2339236500,OctavioHenao,15,0,2,2,0.531678,0.701468,0.000486,"#008ebb"
2339382436,celestinomutis_,1,0,2,2,0.387679,0.544805,0.000486,"#b6cb00"
2339382683,64drs,30,0,1,1,0.694506,0.622838,0,"#ff77ff"
2340240156,sig_caceres,22,0,1,1,0.588782,0.613895,0,"#00e8b2"
2340573194,JulenFigueras,8,0,1,1,0.589467,0.438133,0,"#00ed5d"
2340735822,CSICGalicia,14,21,3,24,0.530297,0.560605,0.011187,"#00eeff"
2340761001,ProyectosFB,38,0,1,1,0.631718,0.389782,0,"#662859"
2340801799,FGVDAPP,36,3,0,3,0.557017,0.404111,0.000973,"#825403"
2340833375,yo_delOlmo,13,0,1,1,0.393032,0.49839,0,"#3bec00"
2340969966,ETP_UAL,38,0,1,1,0.567855,0.702119,0,"#662859"
2342156539,TupmanC,36,0,1,1,0.404729,0.576805,0,"#825403"
2342502697,belenhidalgomar,30,0,2,2,0.576004,0.610042,0.000486,"#ff77ff"
2343932376,Flibrocuba,30,1,0,1,0.575303,0.547896,0,"#ff77ff"
2344229215,ProfTrevisan,36,0,2,2,0.512658,0.249573,0.000486,"#825403"
2344666371,SecondCanvas,2,2,0,2,0.488697,0.534297,0.000486,"#ffa64e"
2345035488,FrederikeNBR,34,0,4,4,0.46174,0.445516,0.001459,"#ff0d69"
2345681616,CarmeBuendia,40,0,1,1,0.628908,0.0033,0,"#ff12a3"
2347346353,cesar_garcia131,13,0,1,1,0.419006,0.348495,0,"#3bec00"
2347676396,beyondcitation,13,0,2,2,0.473443,0.386223,0.000486,"#3bec00"
2347683313,AlarconYlia,42,0,4,4,0.737936,0.429402,0.001459,"#66e087"
2348945065,mnalvear,22,0,2,2,0.594651,0.63439,0.000486,"#00e8b2"
2349155522,fotomuseo4c,55,0,1,1,0.66805,0.560688,0,"#cb3f32"
2349280170,AngelPerezSL,19,1,0,1,0.618231,0.79566,0,"#00d3ff"
2350404907,POtavio_Cunha,36,1,0,1,0.463422,0.32939,0,"#825403"
2350875075,d1egoAr,0,1,3,4,0.534743,0.624745,0.001459,"#8ecfec"
2351369450,Frontiere_,49,1,0,1,0.358483,0.618186,0,"#ff7007"
2351408825,josev2046,1,2,14,16,0.498972,0.535146,0.007296,"#b6cb00"
2351416290,LabEx_Hastec,13,1,0,1,0.403865,0.490907,0,"#3bec00"
2351666952,rochpoz,13,0,2,2,0.416611,0.309199,0.000486,"#3bec00"
2352978770,AugmentClass,18,4,2,6,0.639131,0.615234,0.002432,"#5456a6"
2353528159,VanesaPardos,22,0,2,2,0.544298,0.58767,0.000486,"#00e8b2"
2353592965,nepedagogicos,15,2,1,3,0.610824,0.502994,0.000973,"#008ebb"
2353929474,iuliatraductrix,22,0,1,1,0.23959,0.684062,0,"#00e8b2"
2354591678,OTRIUGR,31,5,6,11,0.592586,0.518041,0.004864,"#3e93ff"
2354844062,Abauskalo,30,0,1,1,0.552538,0.668196,0,"#ff77ff"
2355010883,isabelgbueno,31,0,2,2,0.545128,0.633579,0.000486,"#3e93ff"
2355218522,CEHColmex,7,22,7,29,0.406019,0.365343,0.013619,"#ffb800"
2356283725,AnibalPar1,37,2,0,2,0.52971,0.336781,0.000486,"#006032"
2356544024,CrisGTestal,14,0,3,3,0.614757,0.526758,0.000973,"#00eeff"
2356584932,GSGBusinessH,49,1,0,1,0.392557,0.63385,0,"#ff7007"
2356855903,Miranda__E,42,0,1,1,0.908858,0.431267,0,"#66e087"
2356888393,RosaMariaRaichD,8,0,1,1,0.692455,0.303799,0,"#00ed5d"
2357152261,KiddSoap,7,0,1,1,0.815933,0.545957,0,"#ffb800"
2358362910,esthrub,3,0,1,1,0.523578,0.664222,0,"#ffb3ff"
2358562603,andrewmorrisuk,36,0,2,2,0.51284,0.283577,0.000486,"#825403"
2359316703,JuandeRuano,30,0,1,1,0.575155,0.662297,0,"#ff77ff"
2359524018,eduland_es,31,3,0,3,0.751926,0.33985,0.000973,"#3e93ff"
2359997306,RAFAELURUEA,19,0,2,2,0.614002,0.472085,0.000486,"#00d3ff"
2360892878,BestiariMuseu,13,0,1,1,0.43257,0.496906,0,"#3bec00"
2361094927,LamonaMur,30,0,1,1,0.486978,0.699119,0,"#ff77ff"
2361372560,achdotorg,36,27,3,30,0.448146,0.465098,0.014105,"#825403"
2361511959,Emperatriz1827,37,0,1,1,0.304878,0.319248,0,"#006032"
2361764967,PablodeVicente2,8,0,1,1,0.238388,0.259146,0,"#00ed5d"
2361779232,cristoriojas,7,0,2,2,0.426188,0.330331,0.000486,"#ffb800"
2362796750,OTeAULPGC,30,0,5,5,0.571472,0.645124,0.001946,"#ff77ff"
2362907383,SocialMes,49,2,0,2,0.402112,0.584885,0.000486,"#ff7007"
2362932709,cristinakroll,49,1,0,1,0.30086,0.655747,0,"#ff7007"
2363214241,djliopons,21,0,1,1,0.773781,0.526408,0,"#c6cc85"
2363300558,am_corral,55,0,2,2,0.682486,0.444936,0.000486,"#cb3f32"
2363805961,Vladimirvl_,49,0,1,1,0.509706,0.376314,0,"#ff7007"
2363852793,AngelGMGO,30,0,1,1,0.662302,0.589422,0,"#ff77ff"
2364140240,Huris2014,49,0,1,1,0.35846,0.487759,0,"#ff7007"
2364377184,lgmerchant,34,19,13,32,0.42685,0.443144,0.015078,"#ff0d69"
2365847731,medicoprevi,37,0,1,1,0.695207,0.491309,0,"#006032"
2365940209,la_mondragora,13,0,1,1,0.417821,0.399371,0,"#3bec00"
2367729037,asanchezdelgado,22,0,2,2,0.639963,0.429397,0.000486,"#00e8b2"
2368265731,Elotroyomebusca,42,3,10,13,0.678734,0.480488,0.005837,"#66e087"
2369274090,LabARTblog,14,1,9,10,0.588998,0.587581,0.004377,"#00eeff"
2369498509,RamonSobrino1,30,0,1,1,0.588675,0.669765,0,"#ff77ff"
2369573840,AIBMontesDeOca,10,0,1,1,0.342,0.57697,0,"#52d7c0"
2370165132,EPEDIG,30,0,3,3,0.491839,0.518408,0.000973,"#ff77ff"
2370318888,EditorialUOC,31,2,0,2,0.608997,0.416224,0.000486,"#3e93ff"
2372127272,Asolfer_,49,3,0,3,0.426758,0.600589,0.000973,"#ff7007"
2372145799,El_Icanh,38,0,1,1,0.620089,0.369759,0,"#662859"
2372314050,CelesteSaenzM,49,1,0,1,0.434801,0.691624,0,"#ff7007"
2372536260,Historiascurio,30,0,1,1,0.696881,0.609843,0,"#ff77ff"
2373531362,lavieenrose7594,36,0,3,3,0.533893,0.385539,0.000973,"#825403"
2374081280,ChurrincheROU,19,0,1,1,0.697279,0.55871,0,"#00d3ff"
2374322006,miteatrocolon,38,1,1,2,0.596357,0.381607,0.000486,"#662859"
2374425787,iArtHis_Lab,14,10,0,10,0.568293,0.509844,0.004377,"#00eeff"
2374442881,Carlos_Musfeldt,49,0,2,2,0.450879,0.473587,0.000486,"#ff7007"
2374479512,iArtHislab,14,59,59,118,0.526657,0.505034,0.056907,"#00eeff"
2375316660,ce_had,14,3,6,9,0.570989,0.514384,0.003891,"#00eeff"
2375696683,linhduned,30,701,290,991,0.508765,0.545584,0.481518,"#ff77ff"
2376030277,JorgedeArlanza,30,0,1,1,0.715101,0.603243,0,"#ff77ff"
2376119360,WhaleRM,22,0,1,1,0.833957,0.455197,0,"#00e8b2"
2376892579,dsuner1,3,0,2,2,0.609105,0.646192,0.000486,"#ffb3ff"
2377064604,ArqLorea,34,0,1,1,0.409966,0.446627,0,"#ff0d69"
2377366531,bpmmadrid,58,1,2,3,0.593418,0.385632,0.000973,"#005076"
2377428560,mayantatoo,7,0,5,5,0.543733,0.417664,0.001946,"#ffb800"
2377816652,RaquelMtnez_tv,8,1,0,1,0.660546,0.234496,0,"#00ed5d"
2378423046,ECOmooc,30,15,0,15,0.503542,0.610962,0.006809,"#ff77ff"
2379266108,cefalea_,38,0,1,1,0.434078,0.776557,0,"#662859"
2380700180,Teatrocomparte,14,0,1,1,0.410615,0.529996,0,"#00eeff"
2380739256,MACSavio,36,0,2,2,0.47401,0.266517,0.000486,"#825403"
2381472966,Claudishka,13,7,43,50,0.509679,0.478721,0.023833,"#3bec00"
2382686736,LCF_UNAM,7,0,1,1,0.516997,0.189134,0,"#ffb800"
2382778009,patarevalo,22,0,1,1,0.285532,0.448181,0,"#00e8b2"
2383412623,EspacioJovenUni,49,1,0,1,0.388176,0.619636,0,"#ff7007"
2383580310,guillenpastorjl,2,0,1,1,0.399824,0.550023,0,"#ffa64e"
2383751928,facisouniandes,35,0,1,1,0.567667,0.255697,0,"#00faff"
2383883119,MarinaJodra,30,0,1,1,0.63463,0.456671,0,"#ff77ff"
2383987249,MjflorescC,37,0,2,2,0.563675,0.476836,0.000486,"#006032"
2384084136,USLDH,34,6,0,6,0.502445,0.455752,0.002432,"#ff0d69"
2384192587,PepeMolt,30,0,17,17,0.521276,0.548384,0.007782,"#ff77ff"
2384977358,commercetrain,58,0,9,9,0.529209,0.531944,0.003891,"#005076"
2385049771,Kode_Eskola,31,0,3,3,0.58597,0.552085,0.000973,"#3e93ff"
2385148075,Ric_Crea,22,1,0,1,0.621256,0.639174,0,"#00e8b2"
2385187231,ICMCSIC,30,1,0,1,0.584129,0.569928,0,"#ff77ff"
2385402476,jesusdiazcampo,14,1,2,3,0.446878,0.529124,0.000973,"#00eeff"
2385815029,DiRTdirectory,49,1,0,1,0.371448,0.500509,0,"#ff7007"
2385907075,pedadigigogy,36,0,1,1,0.457613,0.309544,0,"#825403"
2387433554,BiblioKino,13,0,6,6,0.453737,0.443221,0.002432,"#3bec00"
2388162240,gimenezbarbat,49,1,0,1,0.299625,0.683988,0,"#ff7007"
2388702384,memecerdeiras,38,0,1,1,0.800204,0.646873,0,"#662859"
2388943520,esgifo,8,0,1,1,0.286434,0.262235,0,"#00ed5d"
2389597301,loreleidem,49,7,18,25,0.458451,0.56997,0.011673,"#ff7007"
2389765283,jennytorilos75,7,0,2,2,0.490707,0.381638,0.000486,"#ffb800"
2389774215,Integrateucv,49,0,1,1,0.356235,0.489407,0,"#ff7007"
2390123358,jacarias56,13,0,1,1,0.42724,0.246418,0,"#3bec00"
2390472102,karina_urbanita,7,0,1,1,0.830567,0.563267,0,"#ffb800"
2390557590,jorgeoruizster,49,0,3,3,0.452782,0.669139,0.000973,"#ff7007"
2391095083,arimawasur,38,0,1,1,0.433955,0.756001,0,"#662859"
2391123854,MElenaEsteban,14,2,2,4,0.459873,0.528923,0.001459,"#00eeff"
2391225308,jeffreyianross,13,0,1,1,0.365128,0.584557,0,"#3bec00"
2391434617,Marga2160,34,0,3,3,0.523554,0.352984,0.000973,"#ff0d69"
2392962324,WWInscriptions,36,1,0,1,0.522938,0.138054,0,"#825403"
2393229264,PatrimoniBlog,49,2,0,2,0.440607,0.590836,0.000486,"#ff7007"
2393389555,enjambredigital,13,0,2,2,0.376285,0.390032,0.000486,"#3bec00"
2393400122,RCSEECI,42,0,1,1,0.70854,0.376061,0,"#66e087"
2394185244,Historia2punto0,30,0,1,1,0.69447,0.613733,0,"#ff77ff"
2394476376,odiupositivu,22,0,1,1,0.710645,0.626893,0,"#00e8b2"
2394646736,Esmeabogado,17,0,1,1,0.818498,0.246518,0,"#ff9cc7"
2395196430,julims25,34,0,2,2,0.579001,0.402769,0.000486,"#ff0d69"
2396037342,ETHEjournal,14,0,8,8,0.583597,0.509946,0.003405,"#00eeff"
2396675887,CarolinaRGa,38,0,3,3,0.532752,0.422183,0.000973,"#662859"
2397620451,alipuchesanchez,30,6,8,14,0.502403,0.614148,0.006323,"#ff77ff"
2397804818,deivid_gj,13,0,1,1,0.400015,0.40345,0,"#3bec00"
2397919777,elenapozougarte,49,1,0,1,0.294579,0.615095,0,"#ff7007"
2398367388,Fmillan30,58,0,2,2,0.612781,0.290927,0.000486,"#005076"
2398401368,aprender3c,49,55,28,83,0.487668,0.552182,0.039883,"#ff7007"
2398729219,jotadoblesse,41,0,1,1,0.344645,0.373384,0,"#697b00"
2399156426,mariona_lmi,14,0,2,2,0.5887,0.512494,0.000486,"#00eeff"
2400033049,JoseUrbanoCueva,2,0,2,2,0.661891,0.661373,0.000486,"#ffa64e"
2400055094,Javiertecteos,38,3,2,5,0.494884,0.689846,0.001946,"#662859"
2400596910,jlperezca,0,0,4,4,0.503484,0.533584,0.001459,"#8ecfec"
2401748312,Parsifal43,34,0,1,1,0.541591,0.332648,0,"#ff0d69"
2402129642,JdelafueG,7,0,6,6,0.44817,0.364173,0.002432,"#ffb800"
2402232062,sitioherradura,17,0,1,1,0.826245,0.23265,0,"#ff9cc7"
2403142175,Henararch,19,0,1,1,0.666529,0.681648,0,"#00d3ff"
2403254850,BEcal,37,1,0,1,0.199012,0.491336,0,"#006032"
2404868954,EdgarJLorCa,58,0,2,2,0.619658,0.29314,0.000486,"#005076"
2404915146,Sue_kai12,7,0,1,1,0.356061,0.321849,0,"#ffb800"
2405458387,azamora_,37,0,2,2,0.673454,0.521319,0.000486,"#006032"
2406542232,SanPabloOzt9,13,0,1,1,0.425015,0.401297,0,"#3bec00"
2409392563,R3Dmx,37,3,0,3,0.459041,0.252828,0.000973,"#006032"
2409571994,friendsrelec,30,0,1,1,0.724985,0.47993,0,"#ff77ff"
2409786289,RicardoDalLago2,37,2,0,2,0.591215,0.359644,0.000486,"#006032"
2410499372,pascalesolon,14,0,2,2,0.515782,0.480274,0.000486,"#00eeff"
2410856858,flcbib,19,0,1,1,0.630163,0.786245,0,"#00d3ff"
2410867260,SchoolOfMaaa,36,6,2,8,0.781251,0.304453,0.003405,"#825403"
2410936039,culturamalaga,14,7,1,8,0.605544,0.55629,0.003405,"#00eeff"
2412333264,alberttico45,22,0,1,1,0.567861,0.631429,0,"#00e8b2"
2412461503,UdGLletres,14,1,0,1,0.57871,0.531629,0,"#00eeff"
2412540625,sheridanmartinc,49,1,0,1,0.364721,0.659221,0,"#ff7007"
2412681614,AMPEBALEARES,49,1,0,1,0.335186,0.655654,0,"#ff7007"
2412796082,LRW3bb,34,0,2,2,0.513833,0.406604,0.000486,"#ff0d69"
2412925585,wanderfooders,31,0,1,1,0.478711,0.676353,0,"#3e93ff"
2413182241,AdAbsurdum,30,0,1,1,0.674695,0.618149,0,"#ff77ff"
2413458755,ProfeFoulis,41,3,9,12,0.453922,0.472636,0.00535,"#697b00"
2414049019,jmozocaamano,30,0,1,1,0.511632,0.652274,0,"#ff77ff"
2414104550,AgustinCarrer19,19,0,1,1,0.69064,0.571244,0,"#00d3ff"
2414335563,glbobadilla21,49,0,1,1,0.251162,0.698265,0,"#ff7007"
2414609995,torillo59,55,0,2,2,0.60602,0.562642,0.000486,"#cb3f32"
2415033829,EspanaRDN24,49,1,0,1,0.324515,0.625468,0,"#ff7007"
2415131411,Enlaperplejidad,30,0,2,2,0.549918,0.54904,0.000486,"#ff77ff"
2415380253,Luciana_Pinerua,49,0,1,1,0.245177,0.674326,0,"#ff7007"
2415746840,AHandVC,30,0,1,1,0.561885,0.625112,0,"#ff77ff"
2415944118,pelurabar,3,0,1,1,0.457028,0.7778,0,"#ffb3ff"
2415957524,aire_master,36,0,2,2,0.428591,0.479929,0.000486,"#825403"
2416383542,sercast99,13,3,9,12,0.480846,0.482243,0.00535,"#3bec00"
2416440216,PetePizarro,49,1,0,1,0.379771,0.639781,0,"#ff7007"
2417724294,jorgearushita,58,0,1,1,0.611641,0.582034,0,"#005076"
2418331285,EsbrinaRecerca,49,2,0,2,0.413093,0.709404,0.000486,"#ff7007"
2418785678,aroargallardo,14,2,1,3,0.679485,0.534661,0.000973,"#00eeff"
2419352912,Gandara27Pepe,38,0,2,2,0.550619,0.467898,0.000486,"#662859"
2419413246,mllvivo,22,0,1,1,0.560968,0.688252,0,"#00e8b2"
2419457618,ABU_Uruguay,55,0,1,1,0.676004,0.561987,0,"#cb3f32"
2419710651,ArcadiNavarro,8,9,0,9,0.643362,0.321805,0.003891,"#00ed5d"
2420351767,ArtXipelag,49,0,1,1,0.439839,0.627463,0,"#ff7007"
2420514602,nataliamesser,13,1,0,1,0.401535,0.407541,0,"#3bec00"
2420597785,politicspartids,19,4,0,4,0.643531,0.715832,0.001459,"#00d3ff"
2420728842,Tatianas_09,0,0,1,1,0.299423,0.596476,0,"#8ecfec"
2421396820,irisverdeymar,49,0,1,1,0.438118,0.733942,0,"#ff7007"
2421952788,MasterenUX,30,1,2,3,0.344951,0.530761,0.000973,"#ff77ff"
2422171706,aahdArg,49,464,80,544,0.477765,0.514425,0.264105,"#ff7007"
2422280432,luislopezlago,22,0,1,1,0.600993,0.597779,0,"#00e8b2"
2422465975,VirtudesIgles,22,0,3,3,0.601947,0.551849,0.000973,"#00e8b2"
2422543092,es_comunidad,38,1,1,2,0.60787,0.381165,0.000486,"#662859"
2422629836,EUIALLEIDA,49,1,0,1,0.344521,0.606884,0,"#ff7007"
2424325915,pi_katsu,37,1,2,3,0.564028,0.365134,0.000973,"#006032"
2424463903,RicardoFilosof,36,0,1,1,0.607616,0.406571,0,"#825403"
2424468703,SeHablaArte,42,3,2,5,0.639315,0.415957,0.001946,"#66e087"
2424671376,mariaceciliajuy,31,0,1,1,0.6927,0.513807,0,"#3e93ff"
2425419566,archivosugt,19,3,6,9,0.623532,0.719537,0.003891,"#00d3ff"
2425655856,Presurae,38,1,2,3,0.559976,0.598152,0.000973,"#662859"
2425984148,DID_ACTE,36,0,2,2,0.420317,0.512696,0.000486,"#825403"
2426847678,BouFerrer,22,1,1,2,0.547164,0.61459,0.000486,"#00e8b2"
2427366498,AIUCD,14,5,27,32,0.453799,0.502086,0.015078,"#00eeff"
2427546546,claudferraz,36,1,0,1,0.533006,0.250333,0,"#825403"
2427632082,dolgwol,14,0,1,1,0.645531,0.601929,0,"#00eeff"
2427646370,MANArqueologico,15,24,0,24,0.552562,0.607094,0.011187,"#008ebb"
2427974166,VicenteAlfonsoB,31,0,2,2,0.616299,0.488037,0.000486,"#3e93ff"
2428174303,Medieval_Gus,49,14,4,18,0.438025,0.526815,0.008268,"#ff7007"
2428790507,ibermaticaNAV,49,1,0,1,0.328781,0.593412,0,"#ff7007"
2428958608,consusm74,1,0,2,2,0.469527,0.609808,0.000486,"#b6cb00"
2429386357,___M_I_S_O___,22,0,2,2,0.597607,0.486396,0.000486,"#00e8b2"
2429786803,Ignatius_Walker,22,0,1,1,0.547167,0.64956,0,"#00e8b2"
2430772189,kbellamy_,4,1,4,5,0.518697,0.486939,0.001946,"#f4c8cf"
2431296204,DaveMazella,34,0,1,1,0.332277,0.412715,0,"#ff0d69"
2431500910,delma_rdgz,38,2,0,2,0.636753,0.460919,0.000486,"#662859"
2431611912,LabexMed,36,0,3,3,0.486173,0.589795,0.000973,"#825403"
2431772252,CUADROSOLEOS,14,0,1,1,0.684799,0.574107,0,"#00eeff"
2431930841,universitat_ac,38,0,1,1,0.742113,0.452675,0,"#662859"
2432554452,MariaEsquirozMa,30,0,13,13,0.517843,0.522993,0.005837,"#ff77ff"
2434143372,micaelamiau,49,2,0,2,0.426568,0.614253,0.000486,"#ff7007"
2434526558,contravientoss,49,1,0,1,0.384671,0.652572,0,"#ff7007"
2434557408,SalaPrensaUNAM,13,1,0,1,0.497122,0.340554,0,"#3bec00"
2434621272,piesderoble,1,2,1,3,0.462318,0.474757,0.000973,"#b6cb00"
2434651679,malevelardemull,36,0,2,2,0.821297,0.283071,0.000486,"#825403"
2435480911,SolisMarimar,13,1,0,1,0.530372,0.39708,0,"#3bec00"
2435780547,Jorge_BastidasR,38,0,1,1,0.68504,0.404993,0,"#662859"
2435967061,YousifAsfour,49,1,0,1,0.356342,0.562041,0,"#ff7007"
2436242671,thaasophobia,13,0,2,2,0.484939,0.384668,0.000486,"#3bec00"
2436460356,JLuisChavezMTZ,17,0,1,1,0.939973,0.38622,0,"#ff9cc7"
2436790365,DianaDipare,38,0,13,13,0.53635,0.446293,0.005837,"#662859"
2436903446,LluisaGuardia,22,0,2,2,0.615881,0.567623,0.000486,"#00e8b2"
2437409532,RUCDH,13,5,0,5,0.466851,0.48418,0.001946,"#3bec00"
2437457922,laurDelatorre01,3,0,2,2,0.446263,0.565647,0.000486,"#ffb3ff"
2438202151,DohertyTA,49,0,2,2,0.413471,0.507804,0.000486,"#ff7007"
2438417263,ClasiHispanicos,30,16,8,24,0.502069,0.552097,0.011187,"#ff77ff"
2438562277,Ciac_Ualg,1,1,0,1,0.495162,0.783234,0,"#b6cb00"
2439015110,ProvAtlantic,34,0,10,10,0.477274,0.458598,0.004377,"#ff0d69"
2439711755,emocionycambio,30,0,6,6,0.530532,0.573078,0.002432,"#ff77ff"
2439777349,GH_Catalina,38,10,3,13,0.510356,0.447845,0.005837,"#662859"
2439790826,HugPalouMiquel,30,0,16,16,0.486752,0.538074,0.007296,"#ff77ff"
2439926662,susanadv17,58,0,4,4,0.577107,0.349992,0.001459,"#005076"
2439975073,hralperta,13,45,32,77,0.455113,0.447254,0.036965,"#3bec00"
2441599722,OttaviaAllgood,30,11,3,14,0.581077,0.615871,0.006323,"#ff77ff"
2442872614,MeAramosp,34,0,1,1,0.545698,0.338633,0,"#ff0d69"
2443050291,arquilatria,58,0,2,2,0.623375,0.295511,0.000486,"#005076"
2443877420,jamcmadrid,22,3,1,4,0.348062,0.710606,0.001459,"#00e8b2"
2444574164,FViaLibre,49,0,1,1,0.287711,0.60166,0,"#ff7007"
2444943467,evagarcian,14,0,2,2,0.438378,0.542986,0.000486,"#00eeff"
2445648096,radehm,49,0,1,1,0.361079,0.64809,0,"#ff7007"
2445761281,RussoAdriana15,8,0,1,1,0.492534,0.800897,0,"#00ed5d"
2446370544,YCharotm,40,0,1,1,0.580128,0.003447,0,"#ff12a3"
2446959420,Cota667,14,1,0,1,0.633352,0.474047,0,"#00eeff"
2447778450,IHRNexus,34,0,1,1,0.332667,0.404785,0,"#ff0d69"
2447956501,pesquero_jimena,34,0,1,1,0.414327,0.349636,0,"#ff0d69"
2448810875,eglz2014,8,0,1,1,0.245073,0.263035,0,"#00ed5d"
2450196163,yunierriquenes,49,3,0,3,0.414827,0.387871,0.000973,"#ff7007"
2451892380,ccomUBA,3,1,5,6,0.471052,0.604567,0.002432,"#ffb3ff"
2451995562,ABGRAoficial,49,12,6,18,0.450584,0.565092,0.008268,"#ff7007"
2452187495,camilogvillegas,37,0,3,3,0.549356,0.465437,0.000973,"#006032"
2453304763,issac_davila,13,0,4,4,0.517934,0.377805,0.001459,"#3bec00"
2453359591,mujerconciencia,19,5,0,5,0.614328,0.738294,0.001946,"#00d3ff"
2455170074,GemaJimenez2011,41,0,1,1,0.320642,0.379211,0,"#697b00"
2455171654,bhumuc,30,5,5,10,0.476715,0.522237,0.004377,"#ff77ff"
2455365973,El_Sequero,58,0,3,3,0.604461,0.254146,0.000973,"#005076"
2455730743,RamMaravilla,7,0,1,1,0.423425,0.321712,0,"#ffb800"
2457557660,Zepeda_filosofo,13,2,0,2,0.507976,0.425742,0.000486,"#3bec00"
2457713543,campoeZA,34,0,1,1,0.321411,0.418829,0,"#ff0d69"
2458306136,promocionCDMX,36,0,1,1,0.38302,0.480436,0,"#825403"
2458387772,UNIR_Mexico,13,5,0,5,0.480289,0.501387,0.001946,"#3bec00"
2460146880,Culturacy,14,2,0,2,0.577466,0.489211,0.000486,"#00eeff"
2461916077,DaniWatsonF,21,0,1,1,0.195957,0.236423,0,"#c6cc85"
2462303683,mlbalbin,30,0,1,1,0.598666,0.666713,0,"#ff77ff"
2462710941,ireneramosgama,2,0,1,1,0.7605,0.526438,0,"#ffa64e"
2464423958,plataformanove,36,35,9,44,0.556453,0.455933,0.020914,"#825403"
2464883898,fasticongress,19,4,0,4,0.648923,0.624901,0.001459,"#00d3ff"
2465145164,leonorgaete,21,0,1,1,0.200177,0.229164,0,"#c6cc85"
2465232468,Pajarodelalmaa,47,0,1,1,0.584063,0.188737,0,"#a091c4"
2465425050,AnonymousVzLa13,49,1,0,1,0.387029,0.657172,0,"#ff7007"
2466228282,Pedagogavioleta,22,0,1,1,0.62431,0.50284,0,"#00e8b2"
2466441409,HispAmericaELE,1,0,1,1,0.421191,0.616302,0,"#b6cb00"
2466595274,Aristarcosnet,49,0,1,1,0.745414,0.7821,0,"#ff7007"
2466649260,noticiaslineapr,49,1,0,1,0.361677,0.622094,0,"#ff7007"
2467565462,mahnzu,13,0,1,1,0.420852,0.415861,0,"#3bec00"
2468431344,S_Bibliotecas_U,49,1,0,1,0.408872,0.663225,0,"#ff7007"
2468967666,olgaxgiraldo,22,0,2,2,0.568295,0.690567,0.000486,"#00e8b2"
2469201331,spalcl,1,0,1,1,0.359957,0.739491,0,"#b6cb00"
2469843301,viviresmortal,21,0,1,1,0.226368,0.200847,0,"#c6cc85"
2470506296,IMigraciones,31,3,0,3,0.578198,0.512785,0.000973,"#3e93ff"
2470521127,GesCulCyL,30,0,2,2,0.482635,0.574887,0.000486,"#ff77ff"
2471131716,OEIMEX,49,1,0,1,0.372862,0.66087,0,"#ff7007"
2472946543,DanielGaluchJr,36,0,1,1,0.533711,0.289146,0,"#825403"
2473603291,jeymontero_,34,0,3,3,0.399506,0.521323,0.000973,"#ff0d69"
2474807509,LuzMarielaLopez,38,0,1,1,0.620518,0.382072,0,"#662859"
2476725716,MADelArcoBlanco,38,0,3,3,0.499344,0.487962,0.000973,"#662859"
2476789478,loqueyomiraria,14,0,2,2,0.560471,0.491598,0.000486,"#00eeff"
2478249938,escueladebits,34,1,0,1,0.465995,0.541911,0,"#ff0d69"
2478798626,magdaturska,49,7,12,19,0.437145,0.518416,0.008755,"#ff7007"
2478849098,Galactero,22,0,1,1,0.645889,0.406646,0,"#00e8b2"
2478953063,vargas_daniel12,34,0,1,1,0.543645,0.38633,0,"#ff0d69"
2479141063,NoeTo_,55,0,2,2,0.672539,0.638044,0.000486,"#cb3f32"
2479900026,profjesusmj,7,0,1,1,0.781567,0.639974,0,"#ffb800"
2479936689,MiguelMayoral,8,0,3,3,0.671245,0.296682,0.000973,"#00ed5d"
2482484107,XodoPDF,37,1,0,1,0.346493,0.77253,0,"#006032"
2483830908,Fundalecturaco,38,1,0,1,0.626215,0.358681,0,"#662859"
2483909162,RoaVargasBecerr,38,0,13,13,0.474061,0.403125,0.005837,"#662859"
2484160723,SCARLPEZGMEZ,15,0,2,2,0.578408,0.637912,0.000486,"#008ebb"
2484692972,amaroolmeda,34,0,2,2,0.268133,0.458069,0.000486,"#ff0d69"
2485172227,fdehistoria,55,1,0,1,0.613487,0.430771,0,"#cb3f32"
2485242642,COIEUNEDTal,30,0,1,1,0.590301,0.670384,0,"#ff77ff"
2485768122,El_Moreno__,36,1,9,10,0.586719,0.41173,0.004377,"#825403"
2486622242,ConstanzaCBC,34,0,2,2,0.541731,0.397531,0.000486,"#ff0d69"
2487144673,NormaNormucha,19,1,0,1,0.687757,0.768013,0,"#00d3ff"
2488968978,LauCharras,30,0,1,1,0.454222,0.709312,0,"#ff77ff"
2490043825,Y__Barragan,34,0,1,1,0.339561,0.403857,0,"#ff0d69"
2490272527,adHistoria,37,1,0,1,0.607634,0.337821,0,"#006032"
2490462523,idiomasula,42,1,1,2,0.679773,0.420341,0.000486,"#66e087"
2490481441,psmyth01,34,0,1,1,0.516457,0.334455,0,"#ff0d69"
2492938236,NCCR_BU,13,0,1,1,0.483285,0.363851,0,"#3bec00"
2493175040,movimientosalba,49,1,0,1,0.379909,0.683803,0,"#ff7007"
2493203227,uofkdance,41,1,0,1,0.351067,0.443723,0,"#697b00"
2493304795,AnillaUy,38,2,0,2,0.645308,0.458533,0.000486,"#662859"
2494163485,DtoLenguaUNED,30,17,13,30,0.530287,0.583966,0.014105,"#ff77ff"
2494281164,proferomval,1,0,3,3,0.461717,0.603111,0.000973,"#b6cb00"
2494986438,ARQ_UC,49,0,1,1,0.375499,0.312499,0,"#ff7007"
2495003798,naelgomis,2,0,1,1,0.389064,0.543731,0,"#ffa64e"
2495832074,Alanisch85,7,0,2,2,0.47561,0.396045,0.000486,"#ffb800"
2496062407,UoSShipwrecks,22,1,0,1,0.515734,0.667403,0,"#00e8b2"
2496201115,BibCampusSoria,22,0,5,5,0.629437,0.524109,0.001946,"#00e8b2"
2497068924,herbert_mirus,17,0,1,1,0.825395,0.21301,0,"#ff9cc7"
2497934976,BUS_Antiguo,58,0,5,5,0.518405,0.547805,0.001946,"#005076"
2498229038,cano_corina,49,1,0,1,0.342697,0.637964,0,"#ff7007"
2498311532,3DOpenHardware,49,1,0,1,0.306346,0.63077,0,"#ff7007"
2498736252,DrAngelaSutton,34,0,2,2,0.339404,0.410567,0.000486,"#ff0d69"
2499212210,ljcarrascosa,14,0,1,1,0.560875,0.637712,0,"#00eeff"
2501142379,jafgaqt,14,0,4,4,0.43811,0.551029,0.001459,"#00eeff"
2501635278,MarcoAPeresU,38,0,1,1,0.424835,0.753222,0,"#662859"
2501933394,jm_taboada,22,0,1,1,0.639703,0.670249,0,"#00e8b2"
2502256902,MediosTec21_Vva,22,6,4,10,0.504531,0.539038,0.004377,"#00e8b2"
2504286346,agnostico2007,3,0,1,1,0.473319,0.74635,0,"#ffb3ff"
2504482741,GPellissa,30,0,10,10,0.473148,0.542121,0.004377,"#ff77ff"
2507298325,redredial,30,8,5,13,0.508299,0.516452,0.005837,"#ff77ff"
2508252109,Cpontigol,21,0,1,1,0.029133,0.642398,0,"#c6cc85"
2508306920,laurahparks,40,0,1,1,0.641959,0.009768,0,"#ff12a3"
2508652020,BiblioU,49,1,0,1,0.558309,0.487718,0,"#ff7007"
2509406823,agusstoessel_,37,1,1,2,0.582454,0.366462,0.000486,"#006032"
2509973791,sepiegob,30,1,0,1,0.402358,0.768183,0,"#ff77ff"
2510152353,EDiSoLuisaRojo,37,0,2,2,0.553257,0.493565,0.000486,"#006032"
2510220319,AtlanticDValley,22,0,2,2,0.70887,0.594556,0.000486,"#00e8b2"
2511163166,ArchivosCDMX,49,0,1,1,0.3263,0.471755,0,"#ff7007"
2511174586,EQUOGU,19,1,0,1,0.681335,0.769951,0,"#00d3ff"
2511461743,rightrelevance,0,2,0,2,0.460671,0.48289,0.000486,"#8ecfec"
2511978589,el_pato_cosmico,1,0,1,1,0.360236,0.547232,0,"#b6cb00"
2512620972,ARPACEC_UNED,30,5,8,13,0.50251,0.560892,0.005837,"#ff77ff"
2512858105,ColArqMadrid,37,1,0,1,0.618196,0.345773,0,"#006032"
2513021414,ciajihle2015,1,1,0,1,0.454389,0.643585,0,"#b6cb00"
2513438480,JuanGlzBaigorri,14,0,1,1,0.568115,0.538394,0,"#00eeff"
2515301341,MiPLEytu,13,0,6,6,0.538221,0.489112,0.002432,"#3bec00"
2515305493,MaraOlivaPhD,13,0,1,1,0.54413,0.453277,0,"#3bec00"
2515473380,Nefvil,31,0,2,2,0.611177,0.52458,0.000486,"#3e93ff"
2516000313,erickgarcia1779,58,1,1,2,0.445214,0.581601,0.000486,"#005076"
2516205145,goodluck_Bock,38,0,1,1,0.728757,0.320187,0,"#662859"
2517742119,entendendimento,36,0,2,2,0.525576,0.33159,0.000486,"#825403"
2519082066,mariaanachinita,21,0,1,1,0.226718,0.221072,0,"#c6cc85"
2519843085,esthet1cs,36,0,1,1,0.432592,0.592366,0,"#825403"
2520477284,altairmagazine,3,1,0,1,0.630517,0.579485,0,"#ffb3ff"
2520668425,LogosNat,36,0,7,7,0.506306,0.479233,0.002918,"#825403"
2523618793,RunRanaGames,49,1,0,1,0.258578,0.35209,0,"#ff7007"
2525308170,ExploraMaule,49,2,4,6,0.301169,0.382729,0.002432,"#ff7007"
2525889794,BlogLTCDI,49,2,0,2,0.430399,0.617594,0.000486,"#ff7007"
2525982746,Aprendizaciones,49,1,0,1,0.319763,0.674679,0,"#ff7007"
2526076992,Elcinequesomos,38,1,1,2,0.609022,0.377277,0.000486,"#662859"
2526751470,gabioshka,49,4,4,8,0.522307,0.427127,0.003405,"#ff7007"
2527539140,paulaatorress_,37,0,3,3,0.397335,0.407714,0.000973,"#006032"
2527832778,FranckMarin25,37,0,1,1,0.659205,0.385025,0,"#006032"
2527928608,Donatunimpuls,22,0,1,1,0.785192,0.517728,0,"#00e8b2"
2528246576,ElRigel_,49,1,0,1,0.364751,0.69651,0,"#ff7007"
2528275846,VictoriaRedond,49,2,0,2,0.419485,0.620794,0.000486,"#ff7007"
2528356046,MarimarMorn,17,0,1,1,0.612021,0.279595,0,"#ff9cc7"
2528749954,Vanesa_RguezGal,30,0,3,3,0.514414,0.601649,0.000973,"#ff77ff"
2529670518,filosofiauned,49,1,0,1,0.385332,0.624093,0,"#ff7007"
2529674432,Paula_C_Vega,49,7,11,18,0.445334,0.520737,0.008268,"#ff7007"
2530476367,AlcaldesEn,49,1,0,1,0.325107,0.633642,0,"#ff7007"
2531015160,TillyShepard,34,2,2,4,0.421158,0.437728,0.001459,"#ff0d69"
2533057321,izqverdemx,7,0,1,1,0.403587,0.72022,0,"#ffb800"
2533524259,gestiondemto,31,0,1,1,0.670868,0.546207,0,"#3e93ff"
2534683734,GrupMicros,49,1,0,1,0.385686,0.661437,0,"#ff7007"
2534687467,bibliotecaule,37,0,6,6,0.532508,0.592107,0.002432,"#006032"
2535815031,salegrelanda,30,0,1,1,0.611825,0.671163,0,"#ff77ff"
2536695988,s_valls,22,0,1,1,0.540575,0.643294,0,"#00e8b2"
2537399659,CreateCaribbean,14,1,0,1,0.588454,0.481855,0,"#00eeff"
2537749436,negrojosema,49,0,6,6,0.448217,0.54056,0.002432,"#ff7007"
2539249513,dgtrapaga,13,2,3,5,0.513581,0.476555,0.001946,"#3bec00"
2539640557,BeingDigitalBD,36,2,2,4,0.562495,0.441947,0.001459,"#825403"
2539810990,SoyAlexArredo,38,0,4,4,0.531313,0.45039,0.001459,"#662859"
2541568843,MarcToreille,38,0,3,3,0.502545,0.488965,0.000973,"#662859"
2541807602,UFMposgrado,14,3,3,6,0.618203,0.552064,0.002432,"#00eeff"
2541847868,ehp14,58,0,4,4,0.483847,0.62642,0.001459,"#005076"
2541871466,Dibuworld,34,0,1,1,0.385472,0.449109,0,"#ff0d69"
2541879043,TvUAQ,13,3,3,6,0.469374,0.478943,0.002432,"#3bec00"
2542124610,Solepronatura,49,1,0,1,0.427772,0.694315,0,"#ff7007"
2543030203,CardumenTeatro,7,0,1,1,0.744162,0.355966,0,"#ffb800"
2543214114,ideinfo,49,6,0,6,0.430946,0.451155,0.002432,"#ff7007"
2543312586,HumanisticaDH,36,12,3,15,0.491305,0.477895,0.006809,"#825403"
2543573486,ArScielo,49,3,7,10,0.449891,0.551281,0.004377,"#ff7007"
2543649940,Choriador,38,0,3,3,0.481024,0.41223,0.000973,"#662859"
2545642496,DARIAHie,36,8,1,9,0.498657,0.556968,0.003891,"#825403"
2546134279,fitantic,14,0,3,3,0.416793,0.54505,0.000973,"#00eeff"
2546494410,girartepoder,30,4,0,4,0.606797,0.58142,0.001459,"#ff77ff"
2546914784,Reinnovatio_es,49,1,0,1,0.372298,0.70234,0,"#ff7007"
2547096150,FRaderue,30,1,0,1,0.4983,0.655283,0,"#ff77ff"
2547360847,Cinismomagico,38,0,1,1,0.646495,0.609324,0,"#662859"
2547629088,innovacionufv,49,2,0,2,0.397149,0.575978,0.000486,"#ff7007"
2548967527,SocialistasRev,49,2,0,2,0.468027,0.592796,0.000486,"#ff7007"
2549302783,Gelassenheit67,13,2,7,9,0.467729,0.460092,0.003891,"#3bec00"
2549407680,jannikstroetgen,30,3,4,7,0.51331,0.514439,0.002918,"#ff77ff"
2549556306,ArtUsSL,30,0,2,2,0.546339,0.637497,0.000486,"#ff77ff"
2551947621,gonzalezgerald1,41,0,1,1,0.322304,0.385038,0,"#697b00"
2552167188,GianlucaMis,38,0,4,4,0.520416,0.458331,0.001459,"#662859"
2553525745,kztapia,21,0,1,1,0.325295,0.445076,0,"#c6cc85"
2555166319,cl379,22,3,8,11,0.539573,0.586989,0.004864,"#00e8b2"
2556100203,icok1102,13,0,2,2,0.374488,0.252186,0.000486,"#3bec00"
2556418063,auriartee,30,0,1,1,0.5794,0.740788,0,"#ff77ff"
2556689184,SibjuJujuy,49,0,3,3,0.441986,0.601353,0.000973,"#ff7007"
2557188062,karlaceja21,49,1,0,1,0.331639,0.68874,0,"#ff7007"
2559920624,VirtuaNostrum,30,0,1,1,0.518827,0.621761,0,"#ff77ff"
2560184200,LILLOTERESA,15,0,3,3,0.604341,0.684106,0.000973,"#008ebb"
2560685903,ElviraSivelo,19,0,3,3,0.647203,0.645066,0.000973,"#00d3ff"
2561615265,jmorenoabenza,37,0,2,2,0.550416,0.54508,0.000486,"#006032"
2561647358,digdiv2015,36,0,1,1,0.388214,0.480226,0,"#825403"
2562091772,AccionMayor,21,0,2,2,0.263951,0.235511,0.000486,"#c6cc85"
2562109014,libconferences,36,0,1,1,0.432973,0.59569,0,"#825403"
2562285950,SPereyra_Uy,55,0,1,1,0.72248,0.650262,0,"#cb3f32"
2562347646,ubafsoc,3,1,0,1,0.464291,0.66639,0,"#ffb3ff"
2563084643,FJavierLuengo,58,0,1,1,0.546651,0.173611,0,"#005076"
2563263715,JOSANTONIOLVAR2,30,0,2,2,0.585423,0.607814,0.000486,"#ff77ff"
2563383121,BNUruguay,55,4,0,4,0.640344,0.643885,0.001459,"#cb3f32"
2563427430,ULA_Venezuela,42,6,1,7,0.625623,0.482821,0.002918,"#66e087"
2563711675,mcgilldigihum,13,6,10,16,0.480319,0.447144,0.007296,"#3bec00"
2564090383,AlfredoJalifeR_,7,1,0,1,0.194898,0.386405,0,"#ffb800"
2564826572,CLARIN_ES_LAB,30,9,39,48,0.525464,0.515916,0.02286,"#ff77ff"
2565955727,treinil,7,0,1,1,0.378917,0.362497,0,"#ffb800"
2566012206,cecytegro,17,0,1,1,0.931128,0.388543,0,"#ff9cc7"
2566104311,biblio_kelma,36,0,1,1,0.522902,0.261101,0,"#825403"
2566112035,chuchobetopaz,13,0,1,1,0.396709,0.318652,0,"#3bec00"
2566247413,Veropaz2014,49,0,2,2,0.354415,0.526621,0.000486,"#ff7007"
2568442671,SalasAlsago4,49,2,0,2,0.428535,0.540189,0.000486,"#ff7007"
2568897518,spadinelena,14,0,2,2,0.451699,0.518366,0.000486,"#00eeff"
2569377410,fondosocialeeu,37,1,0,1,0.7028,0.37157,0,"#006032"
2569569106,7afced537f8c4eb,58,0,1,1,0.543066,0.170128,0,"#005076"
2570466438,piensateclado,31,0,5,5,0.625911,0.541954,0.001946,"#3e93ff"
2570721228,ricardovilarde,55,0,2,2,0.608192,0.516467,0.000486,"#cb3f32"
2571468702,CulturalAcatlan,13,0,1,1,0.407807,0.288794,0,"#3bec00"
2571697430,ELEUK2014,1,0,2,2,0.454911,0.698528,0.000486,"#b6cb00"
2572474921,BibRosalia,30,0,2,2,0.524578,0.545784,0.000486,"#ff77ff"
2572950912,StellaMassa2,38,0,5,5,0.712917,0.573155,0.001946,"#662859"
2573112702,mrdaniel_then,34,0,1,1,0.536518,0.387386,0,"#ff0d69"
2573347506,redaltexto,13,1,5,6,0.414364,0.354964,0.002432,"#3bec00"
2574683079,koloro666,21,0,1,1,0.219631,0.228342,0,"#c6cc85"
2575022572,BaronSirFred,58,0,2,2,0.584442,0.30247,0.000486,"#005076"
2575124365,dgarijov,22,0,2,2,0.561379,0.69287,0.000486,"#00e8b2"
2576544451,ETorresSimon,36,0,1,1,0.605127,0.406797,0,"#825403"
2577347317,geova_salazar,20,0,2,2,0.418611,0.155214,0.000486,"#f0be45"
2577753841,marcela67903637,49,1,0,1,0.309611,0.65261,0,"#ff7007"
2577756284,LaDesficiosa,30,0,1,1,0.578979,0.561216,0,"#ff77ff"
2577817112,yevenes_carlos,21,0,2,2,0.246881,0.233023,0.000486,"#c6cc85"
2577916699,Lebunardo,21,0,1,1,0.224481,0.194817,0,"#c6cc85"
2578297190,CexUnizar,37,1,0,1,0.55804,0.371794,0,"#006032"
2578398188,12nubes,31,0,1,1,0.71267,0.269389,0,"#3e93ff"
2578718656,ajapitonisa,38,0,4,4,0.525068,0.426881,0.001459,"#662859"
2579129798,PMovimiento,7,5,3,8,0.438514,0.394043,0.003405,"#ffb800"
2579554586,elguayatunoinfo,38,0,3,3,0.599272,0.397771,0.000973,"#662859"
2579561367,sevillacristia1,4,0,1,1,0.856911,0.226716,0,"#f4c8cf"
2579789336,Andres_Mage,3,0,5,5,0.467827,0.616582,0.001946,"#ffb3ff"
2580477667,aolaizola1,49,6,15,21,0.489785,0.528866,0.009728,"#ff7007"
2582640500,MHistorico,7,5,4,9,0.490192,0.139932,0.003891,"#ffb800"
2582682320,nonoigle,15,0,1,1,0.549896,0.691715,0,"#008ebb"
2583138523,AAcruz1009,41,0,1,1,0.334969,0.342777,0,"#697b00"
2583766427,JimenezIsabeljh,1,1,0,1,0.248088,0.586304,0,"#b6cb00"
2584085789,celiaricoperez,30,9,14,23,0.574968,0.528678,0.0107,"#ff77ff"
2584401463,CUAE_UV,52,0,2,2,0.874878,0.703127,0.000486,"#b56eed"
2584848486,conmipresidente,49,1,0,1,0.40939,0.693611,0,"#ff7007"
2585066168,vogelfeuers,13,1,0,1,0.495036,0.396008,0,"#3bec00"
2585390190,JCaminanteC,2,0,2,2,0.673125,0.656244,0.000486,"#ffa64e"
2585714009,santiagopms,38,0,1,1,0.709235,0.588341,0,"#662859"
2585790432,IEMOFCSHUNL,22,0,1,1,0.570207,0.680107,0,"#00e8b2"
2585939353,AbiertaEDU,14,4,5,9,0.563182,0.507662,0.003891,"#00eeff"
2586219824,JoseVteMM,14,1,0,1,0.576918,0.449358,0,"#00eeff"
2587166667,carlosdiazred,58,2,2,4,0.489031,0.614271,0.001459,"#005076"
2587814610,EISIUIS,34,1,0,1,0.650668,0.172004,0,"#ff0d69"
2587851210,RigobertoRmz,7,0,1,1,0.798182,0.561372,0,"#ffb800"
2588640793,BuenrostrJavier,13,0,4,4,0.469935,0.358793,0.001459,"#3bec00"
2588812315,jimmy703243001,37,0,1,1,0.451505,0.282501,0,"#006032"
2588991259,todaycourses,49,1,0,1,0.406697,0.634463,0,"#ff7007"
2589377569,SECONDS_group,30,3,0,3,0.505219,0.590182,0.000973,"#ff77ff"
2589447139,FilologiaUCM,58,34,14,48,0.546046,0.543912,0.02286,"#005076"
2590296144,jbodhishavuot,21,0,1,1,0.303571,0.458416,0,"#c6cc85"
2590487610,FLACSOVirtualAR,37,0,1,1,0.689727,0.542887,0,"#006032"
2590891690,EmiCagnacci,49,0,1,1,0.466538,0.720368,0,"#ff7007"
2591031499,alveselvis2,36,1,0,1,0.458842,0.326956,0,"#825403"
2591048566,ZulmaVillaV,1,0,1,1,0.362922,0.560048,0,"#b6cb00"
2591865290,UNAVirtualCR,22,0,2,2,0.490919,0.688063,0.000486,"#00e8b2"
2592124849,bau_malaga,14,0,1,1,0.586165,0.579283,0,"#00eeff"
2595371521,FloriJanet,13,1,2,3,0.517352,0.431916,0.000973,"#3bec00"
2595459530,CamiladeEpalzaA,31,0,2,2,0.73638,0.574172,0.000486,"#3e93ff"
2596061704,ArsenioDacosta,22,11,21,32,0.534116,0.565032,0.015078,"#00e8b2"
2596211173,priotty,49,1,0,1,0.383822,0.689807,0,"#ff7007"
2596526503,tablilladecera,2,1,1,2,0.618518,0.514545,0.000486,"#ffa64e"
2596856936,villaclaravang,49,1,0,1,0.397107,0.65284,0,"#ff7007"
2596932721,PMBorrazas,14,0,3,3,0.512564,0.562277,0.000973,"#00eeff"
2598545269,RMComu,31,0,1,1,0.617602,0.716681,0,"#3e93ff"
2599699194,Talentix,49,1,0,1,0.390333,0.617421,0,"#ff7007"
2599707104,AlvaroBarreiroG,14,0,2,2,0.51276,0.48105,0.000486,"#00eeff"
2600038704,LeninMaury,37,0,3,3,0.483518,0.401451,0.000973,"#006032"
2601916711,juanp_fdez,22,0,2,2,0.517163,0.687246,0.000486,"#00e8b2"
2602055096,vitruvius29,22,0,1,1,0.543621,0.689401,0,"#00e8b2"
2603215771,UNED_Bergara,30,3,0,3,0.511668,0.590779,0.000973,"#ff77ff"
2603262781,TonySanJose,1,0,2,2,0.688129,0.474124,0.000486,"#b6cb00"
2604730241,elizitavivas,34,0,1,1,0.550257,0.334625,0,"#ff0d69"
2604980775,sanzbel,31,0,1,1,0.631775,0.49594,0,"#3e93ff"
2606166613,UNLEthnicStu,49,0,2,2,0.457441,0.605383,0.000486,"#ff7007"
2607404960,Pardoe_AI,36,0,2,2,0.553509,0.295982,0.000486,"#825403"
2607681390,arte_lab,1,1,6,7,0.464838,0.557911,0.002918,"#b6cb00"
2607986142,EscuelaAQ,31,0,1,1,0.619454,0.591575,0,"#3e93ff"
2608171524,MaciejEder,14,3,4,7,0.47106,0.523886,0.002918,"#00eeff"
2609484936,ArtyHum,30,58,59,117,0.501551,0.529455,0.05642,"#ff77ff"
2612642079,fundacionciev,49,3,4,7,0.468342,0.5614,0.002918,"#ff7007"
2613185593,RecerCaixa,14,0,5,5,0.598536,0.589409,0.001946,"#00eeff"
2613829772,ArchivosEst,19,85,13,98,0.581046,0.573843,0.047179,"#00d3ff"
2613832962,UNEDprehistoria,30,3,3,6,0.566284,0.522114,0.002432,"#ff77ff"
2614760851,CeidisULA,42,1,0,1,0.705141,0.454944,0,"#66e087"
2615304872,pereztalento,13,0,1,1,0.442269,0.355884,0,"#3bec00"
2615549862,eglemoscone,13,0,1,1,0.394065,0.409602,0,"#3bec00"
2615861635,perpetuocambio,34,0,3,3,0.518146,0.493005,0.000973,"#ff0d69"
2616034494,lavaleartigas,21,0,2,2,0.242748,0.248508,0.000486,"#c6cc85"
2616500618,Thaisanastefani,36,0,2,2,0.516128,0.247524,0.000486,"#825403"
2616797064,workpoint_es,22,1,2,3,0.520956,0.593609,0.000973,"#00e8b2"
2616883074,UdL_info,14,9,0,9,0.51358,0.510123,0.003891,"#00eeff"
2617406750,oierldl,34,0,2,2,0.440562,0.459227,0.000486,"#ff0d69"
2617725602,olvidoandujar,1,0,2,2,0.442899,0.704613,0.000486,"#b6cb00"
2618463545,MarMarhoyas,30,0,3,3,0.559051,0.563485,0.000973,"#ff77ff"
2618835398,ArqueologiaUGR,37,1,0,1,0.640631,0.352267,0,"#006032"
2622171961,sajein_espyem,49,1,0,1,0.402389,0.6358,0,"#ff7007"
2623935130,jai_meg,49,1,0,1,0.389446,0.682815,0,"#ff7007"
2625278321,ChemistredPuck,22,1,1,2,0.555633,0.674433,0.000486,"#00e8b2"
2633482222,isaksr_,13,0,1,1,0.545887,0.464587,0,"#3bec00"
2638030163,GrijoMarcio,36,0,1,1,0.498805,0.305513,0,"#825403"
2640171342,MzsDanubia,36,0,1,1,0.510238,0.302529,0,"#825403"
2644022782,maricruzsalced1,30,0,1,1,0.258614,0.633111,0,"#ff77ff"
2644749420,iesjorgejuanalc,49,2,0,2,0.399752,0.572306,0.000486,"#ff7007"
2645648308,alextheknitter,34,0,12,12,0.49568,0.486718,0.00535,"#ff0d69"
2646023662,lomarcos8,55,0,5,5,0.670489,0.667915,0.001946,"#cb3f32"
2646056544,JhonJhonRequena,31,0,1,1,0.594934,0.47458,0,"#3e93ff"
2646122101,MGomAlb,31,0,7,7,0.54943,0.525615,0.002918,"#3e93ff"
2649437522,gracetruj,40,0,1,1,0.61087,0.035896,0,"#ff12a3"
2649691839,MeliaMA15,38,0,1,1,0.81444,0.637044,0,"#662859"
2649695214,so1camponesa,48,0,1,1,0.263006,0.716416,0,"#ff7a78"
2650474338,NoticiasGr,31,0,1,1,0.65152,0.571679,0,"#3e93ff"
2650976759,ColMex,13,6,0,6,0.444024,0.461527,0.002432,"#3bec00"
2651395240,luzm2016,42,0,1,1,0.851334,0.429035,0,"#66e087"
2652136800,LitteraCarolina,22,0,1,1,0.577284,0.640762,0,"#00e8b2"
2653569085,E_GilyCarrasco,37,0,3,3,0.559981,0.665576,0.000973,"#006032"
2655139293,jennydanna1,3,0,1,1,0.523405,0.766305,0,"#ffb3ff"
2656446570,AH_PCE,19,11,0,11,0.623463,0.733147,0.004864,"#00d3ff"
2656882268,fcshrossio,36,28,14,42,0.519507,0.442142,0.019942,"#825403"
2657321190,raq_asilva,36,0,3,3,0.554889,0.407113,0.000973,"#825403"
2657599226,losa737,37,0,1,1,0.163813,0.612449,0,"#006032"
2659312076,Galabeckett,36,0,1,1,0.601549,0.402078,0,"#825403"
2660112860,SEOMagnetism,49,0,4,4,0.438607,0.614979,0.001459,"#ff7007"
2662139235,GeorginaFlesia,13,0,1,1,0.630121,0.995772,0,"#3bec00"
2663838817,CXPressMx,7,0,1,1,0.35296,0.365796,0,"#ffb800"
2663935537,WilliamsChicang,49,1,0,1,0.388263,0.660232,0,"#ff7007"
2665141411,Ivana_PDL,30,0,1,1,0.495429,0.627307,0,"#ff77ff"
2667480012,VanessaDharma,30,0,1,1,0.613887,0.434582,0,"#ff77ff"
2671914959,profabelglezp,15,0,1,1,0.537698,0.745856,0,"#008ebb"
2673181909,USPCEUHumYCom,2,8,11,19,0.508882,0.558486,0.008755,"#ffa64e"
2673381195,marielly_sy,3,0,1,1,0.489251,0.771595,0,"#ffb3ff"
2673526793,ELEelenap,1,0,2,2,0.466221,0.698217,0.000486,"#b6cb00"
2674574675,ssalazar_c,3,0,1,1,0.839107,0.740808,0,"#ffb3ff"
2675632226,MoisesHasson,21,0,2,2,0.273905,0.239479,0.000486,"#c6cc85"
2676240002,EconomiaAnd,31,0,2,2,0.635767,0.547994,0.000486,"#3e93ff"
2676371539,JoernTurner,49,0,3,3,0.366419,0.519336,0.000973,"#ff7007"
2679109831,411emilio,31,1,2,3,0.511326,0.605565,0.000973,"#3e93ff"
2679127730,mlmforero,22,5,7,12,0.557403,0.562539,0.00535,"#00e8b2"
2679652530,alexmmpinto,36,0,2,2,0.574179,0.422611,0.000486,"#825403"
2681377153,cifuentesjan,38,0,1,1,0.431662,0.77133,0,"#662859"
2681683495,RafaGrande_,22,0,1,1,0.571218,0.303557,0,"#00e8b2"
2685577428,sharecollabco,38,0,3,3,0.692256,0.443415,0.000973,"#662859"
2685579046,jcoh42,5,0,1,1,0.621039,0.301436,0,"#b2dd44"
2686356938,LatidosYMemoria,30,1,0,1,0.533226,0.629313,0,"#ff77ff"
2686936668,LuciaInigo_CDTI,22,0,2,2,0.637523,0.477562,0.000486,"#00e8b2"
2688070376,fundacaofhc,36,4,0,4,0.517804,0.368283,0.001459,"#825403"
2690635532,contradictorius,31,1,0,1,0.785758,0.469161,0,"#3e93ff"
2690980370,nenapiink69,49,1,0,1,0.345536,0.596646,0,"#ff7007"
2692076577,Joanenric67Joan,49,0,2,2,0.433942,0.505944,0.000486,"#ff7007"
2692094678,peggybockwinkel,14,0,12,12,0.499378,0.514327,0.00535,"#00eeff"
2692496635,corepatrimoni,14,6,2,8,0.526265,0.579286,0.003405,"#00eeff"
2695096082,refindcom,22,1,0,1,0.520701,0.694388,0,"#00e8b2"
2695143194,wrkclasshistory,19,1,0,1,0.659543,0.77812,0,"#00d3ff"
2695371602,EvaEvd,36,0,2,2,0.428735,0.507477,0.000486,"#825403"
2695827850,SidVina,49,1,0,1,0.270967,0.539802,0,"#ff7007"
2695847653,LKourchenko,3,2,0,2,0.446012,0.625163,0.000486,"#ffb3ff"
2696064845,AlancayDel,8,0,1,1,0.354369,0.783044,0,"#00ed5d"
2698670421,oaperezh,13,0,10,10,0.526279,0.492563,0.004377,"#3bec00"
2699618231,ai30pg,30,0,1,1,0.605803,0.678264,0,"#ff77ff"
2701611164,BornDigital2015,55,2,1,3,0.556267,0.567027,0.000973,"#cb3f32"
2702074278,lawluwu,38,0,2,2,0.693134,0.555958,0.000486,"#662859"
2702084341,sujetosUY,55,4,3,7,0.55782,0.613469,0.002918,"#cb3f32"
2704310310,acastrosalgado,49,4,3,7,0.517014,0.429636,0.002918,"#ff7007"
2704452690,ElisaGironzetti,1,0,2,2,0.460703,0.705308,0.000486,"#b6cb00"
2706179137,SIGECAH,22,0,1,1,0.579888,0.629359,0,"#00e8b2"
2706969109,citmacuba,43,0,1,1,0.85835,0.548538,0,"#fcae7e"
2708171904,Macario_Matus,13,0,1,1,0.470468,0.384878,0,"#3bec00"
2708854387,PAXenColombia,38,1,0,1,0.548322,0.369772,0,"#662859"
2710520456,friesgom,49,1,0,1,0.416924,0.529108,0,"#ff7007"
2710562852,corrientefil919,13,3,2,5,0.647076,0.451678,0.001946,"#3bec00"
2710927408,AmezcAlvarez,30,0,1,1,0.610703,0.666232,0,"#ff77ff"
2712448951,CONICETCenpat,49,7,0,7,0.284269,0.668491,0.002918,"#ff7007"
2713180697,LaradominguezMe,37,1,3,4,0.532303,0.480709,0.001459,"#006032"
2714357890,KammererRR,40,0,1,1,0.614883,0.02906,0,"#ff12a3"
2715099920,PoluxArq,35,5,7,12,0.552213,0.435737,0.00535,"#00faff"
2715268516,germanep53,34,0,1,1,0.561126,0.418215,0,"#ff0d69"
2715586508,Nat_Mora_,37,0,1,1,0.288995,0.474682,0,"#006032"
2715616655,dgplcs,36,0,1,1,0.56593,0.388304,0,"#825403"
2718754947,EPolcha,13,0,1,1,0.393796,0.391027,0,"#3bec00"
2718765609,phosterii,30,0,8,8,0.488488,0.539269,0.003405,"#ff77ff"
2718779594,isantossalazar,22,0,1,1,0.541838,0.65174,0,"#00e8b2"
2719788874,sutersan69,49,7,0,7,0.441337,0.574443,0.002918,"#ff7007"
2719811084,milenamartin001,37,0,2,2,0.561183,0.394026,0.000486,"#006032"
2719924677,hurtado_arantza,1,0,2,2,0.66202,0.439391,0.000486,"#b6cb00"
2720144785,OctavianoTatau,36,0,1,1,0.847694,0.341069,0,"#825403"
2720308072,Sara_Fontenla,38,1,1,2,0.53668,0.48975,0.000486,"#662859"
2721222714,_INED21,49,3,0,3,0.462415,0.64203,0.000973,"#ff7007"
2721390467,AllendeAlli,37,0,1,1,0.312885,0.342972,0,"#006032"
2721769351,tonyreis_tr1,36,0,1,1,0.53566,0.291249,0,"#825403"
2723310037,Pelantura,58,0,2,2,0.627644,0.310125,0.000486,"#005076"
2724594590,kacsavio,36,0,1,1,0.436081,0.268362,0,"#825403"
2726191908,OEIUruguay,55,0,1,1,0.700444,0.666175,0,"#cb3f32"
2729908174,nachosuarez31,22,0,1,1,0.711484,0.619613,0,"#00e8b2"
2730165104,fer_hist,7,0,1,1,0.517525,0.084576,0,"#ffb800"
2730618352,ramapida,55,0,2,2,0.659378,0.640999,0.000486,"#cb3f32"
2731985244,UNALOficial,38,3,0,3,0.328582,0.458477,0.000973,"#662859"
2732502944,Jacquelin267,13,0,2,2,0.446169,0.426275,0.000486,"#3bec00"
2732550780,tekniikka_zgz,49,1,0,1,0.349341,0.650485,0,"#ff7007"
2733023213,molano_mario,38,3,3,6,0.567384,0.408064,0.002432,"#662859"
2735127410,javierodonte,10,0,1,1,0.350377,0.503006,0,"#52d7c0"
2735372614,50_mms,21,0,1,1,0.025055,0.632683,0,"#c6cc85"
2736397896,ham_gretsky,22,0,1,1,0.543698,0.652032,0,"#00e8b2"
2736580617,LRM2112,38,0,1,1,0.080164,0.431202,0,"#662859"
2736632361,Catalina_valpo,21,0,3,3,0.225633,0.23657,0.000973,"#c6cc85"
2741056433,SoyBouvard,13,0,1,1,0.483168,0.388985,0,"#3bec00"
2741188028,ManuelGilAnton,13,1,0,1,0.619632,0.32862,0,"#3bec00"
2741973764,EdukaTICS,30,0,8,8,0.512134,0.566293,0.003405,"#ff77ff"
2742053771,mguerrerobr,14,0,3,3,0.671081,0.510178,0.000973,"#00eeff"
2743311150,papachambo1,30,0,1,1,0.605559,0.444746,0,"#ff77ff"
2743700423,garciabarace,22,6,3,9,0.484299,0.561637,0.003891,"#00e8b2"
2743985000,LosMuseos,13,0,2,2,0.446847,0.352056,0.000486,"#3bec00"
2744374523,mari4luz,21,0,2,2,0.234044,0.261355,0.000486,"#c6cc85"
2744703018,vic_cuesta,14,0,1,1,0.42788,0.573361,0,"#00eeff"
2745281278,herero36,16,0,2,2,0.949027,0.667677,0.000486,"#c42c63"
2745604503,escribidor2005,3,0,1,1,0.44069,0.757518,0,"#ffb3ff"
2747274925,belett_g,21,0,2,2,0.265699,0.281967,0.000486,"#c6cc85"
2747468199,titularesdehoy1,42,1,1,2,0.987633,0.373879,0.000486,"#66e087"
2747621768,nellstra,41,29,9,38,0.386218,0.393151,0.017996,"#697b00"
2747646295,LeoLBell,41,0,2,2,0.354419,0.352137,0.000486,"#697b00"
2747657225,DiscourseNet,13,0,1,1,0.415496,0.417697,0,"#3bec00"
2748428697,evamacon,14,0,3,3,0.519552,0.576822,0.000973,"#00eeff"
2749803914,RedxlaEducacion,17,53,0,53,0.864589,0.382348,0.025292,"#ff9cc7"
2750510594,dravfonseca,34,0,2,2,0.355417,0.410853,0.000486,"#ff0d69"
2750551660,LaBitagora,38,0,1,1,0.609923,0.362648,0,"#662859"
2751082377,ManelTrenchs,42,2,3,5,0.669156,0.485181,0.001946,"#66e087"
2751459527,lacoquitadelata,7,0,1,1,0.403418,0.196422,0,"#ffb800"
2753191789,4bdonsanch,13,0,4,4,0.46941,0.405206,0.001459,"#3bec00"
2753836147,UNICyT,49,1,0,1,0.390629,0.623129,0,"#ff7007"
2753888687,yanettMM19,31,0,3,3,0.59896,0.511711,0.000973,"#3e93ff"
2754618733,HPartzschTTT,30,0,2,2,0.526906,0.579534,0.000486,"#ff77ff"
2755172514,elsborja,22,0,1,1,0.548451,0.64704,0,"#00e8b2"
2755645412,xene1ze10,7,0,1,1,0.796673,0.319954,0,"#ffb800"
2757032955,florencicosb,30,0,1,1,0.604807,0.443163,0,"#ff77ff"
2757089827,DanLeonRuiz,36,0,1,1,0.488018,0.27901,0,"#825403"
2759592300,ElDeOjosTristes,13,1,0,1,0.403943,0.342406,0,"#3bec00"
2759857111,mmontivero1,22,0,1,1,0.581452,0.629965,0,"#00e8b2"
2761477982,PatricioGonzl17,49,1,0,1,0.321609,0.629446,0,"#ff7007"
2761950271,mpf421,30,5,0,5,0.65099,0.62287,0.001946,"#ff77ff"
2762327574,Juan_C_Chaparro,13,0,1,1,0.388815,0.392034,0,"#3bec00"
2762502008,HistorywithLilo,38,0,1,1,0.465733,0.363079,0,"#662859"
2763810417,orto1941,19,1,0,1,0.679525,0.772925,0,"#00d3ff"
2766383400,Juanredondod,8,0,2,2,0.66016,0.305202,0.000486,"#00ed5d"
2770064414,TFeminista_,19,2,0,2,0.558514,0.625423,0.000486,"#00d3ff"
2770431583,MissPucheros,35,0,1,1,0.578126,0.262766,0,"#00faff"
2772101085,LetrasMara,36,0,6,6,0.537449,0.484937,0.002432,"#825403"
2772239741,IngridGomezrod,30,0,1,1,0.621523,0.654404,0,"#ff77ff"
2772920576,GAITEC_Topo,22,0,1,1,0.590213,0.618794,0,"#00e8b2"
2773068864,gvalecillos26,1,0,1,1,0.44897,0.716413,0,"#b6cb00"
2773664899,MAPEOTIC,3,1,1,2,0.462442,0.671154,0.000486,"#ffb3ff"
2774471581,MagSocialesUCH,49,0,1,1,0.405078,0.415505,0,"#ff7007"
2774843917,MedievalUB,22,0,2,2,0.511339,0.550192,0.000486,"#00e8b2"
2775127970,megaHabilidades,49,1,0,1,0.350049,0.631407,0,"#ff7007"
2775296517,Betbopa,14,0,1,1,0.677025,0.580195,0,"#00eeff"
2775361834,Sole_SM1,1,0,5,5,0.444606,0.626731,0.001946,"#b6cb00"
2775624237,ArchivoRTVE,19,1,0,1,0.613922,0.797938,0,"#00d3ff"
2776002049,InductES,49,1,0,1,0.364497,0.669922,0,"#ff7007"
2776107172,orlapeach,30,1,0,1,0.607695,0.433803,0,"#ff77ff"
2776151320,valero_maite,13,0,1,1,0.584119,0.467742,0,"#3bec00"
2776202812,geohisteacher,13,0,1,1,0.427128,0.500978,0,"#3bec00"
2776265964,cortetotal,49,1,0,1,0.359837,0.604696,0,"#ff7007"
2776392849,pblcarmona,36,1,0,1,0.64892,0.354648,0,"#825403"
2778112415,alejandromaiza,55,0,1,1,0.674167,0.558465,0,"#cb3f32"
2778799206,iruskieta_m,30,19,24,43,0.500326,0.510197,0.020428,"#ff77ff"
2778963222,ESAElatam,3,1,1,2,0.507295,0.660659,0.000486,"#ffb3ff"
2779889225,interlinea_ce,13,2,0,2,0.415508,0.315466,0.000486,"#3bec00"
2781359551,Marta51970,22,1,7,8,0.515563,0.562334,0.003405,"#00e8b2"
2782478520,KaisQuest,38,0,1,1,0.716625,0.580821,0,"#662859"
2782636145,winescobedo,31,0,1,1,0.622835,0.498084,0,"#3e93ff"
2783877980,virgulillahispa,30,0,2,2,0.60134,0.421554,0.000486,"#ff77ff"
2784361462,UNEDMadrid,30,0,2,2,0.509782,0.606067,0.000486,"#ff77ff"
2784573630,karen_basfi,21,0,1,1,0.15231,0.613369,0,"#c6cc85"
2784958667,emmaperz,49,0,2,2,0.410329,0.626053,0.000486,"#ff7007"
2786168472,EdUniLibraries,31,2,0,2,0.613061,0.601075,0.000486,"#3e93ff"
2786350644,osnavarrom,38,0,1,1,0.329698,0.182177,0,"#662859"
2786392888,TierrActivaPeru,40,0,1,1,0.599617,0.024366,0,"#ff12a3"
2786532867,JimenezLadys,3,0,1,1,0.508846,0.765156,0,"#ffb3ff"
2786905824,DianaInes1385,7,0,1,1,0.842333,0.541128,0,"#ffb800"
2787551460,bibliocraiUPF,31,0,2,2,0.586053,0.501494,0.000486,"#3e93ff"
2787768872,luisguti18,49,1,0,1,0.381955,0.671487,0,"#ff7007"
2787917493,RinaTxaro,58,0,1,1,0.481232,0.654588,0,"#005076"
2788369548,araceli_us_es,1,0,1,1,0.430535,0.635934,0,"#b6cb00"
2788572134,sarcathtic,49,0,2,2,0.399474,0.524889,0.000486,"#ff7007"
2788631498,uamex,41,2,0,2,0.343453,0.390856,0.000486,"#697b00"
2788797393,bierzopromo,37,0,1,1,0.543533,0.852689,0,"#006032"
2789492814,pgpinacho,2,0,2,2,0.451772,0.53412,0.000486,"#ffa64e"
2789520523,mrodrivelasco,2,0,10,10,0.531861,0.573314,0.004377,"#ffa64e"
2789673272,BiblioHack,34,2,5,7,0.479045,0.525522,0.002918,"#ff0d69"
2789907950,Edu4meLatAm,13,0,1,1,0.584297,0.21781,0,"#3bec00"
2789997291,fundVazFerreira,55,0,3,3,0.655323,0.591811,0.000973,"#cb3f32"
2790551606,trameproject,30,1,24,25,0.497118,0.513525,0.011673,"#ff77ff"
2790802182,ArquivoEphemera,19,2,0,2,0.62879,0.764493,0.000486,"#00d3ff"
2791510020,Instituto25M,36,6,0,6,0.573557,0.425974,0.002432,"#825403"
2791752635,RaxHyperboreia,22,1,0,1,0.514776,0.682487,0,"#00e8b2"
2792182600,juliomtzcava,36,6,0,6,0.573553,0.433341,0.002432,"#825403"
2792205364,bettzan,34,0,1,1,0.570713,0.351824,0,"#ff0d69"
2792368833,TimoTransicion,19,6,0,6,0.610145,0.686095,0.002432,"#00d3ff"
2792700795,Memoriasdesohar,42,0,1,1,0.765881,0.441002,0,"#66e087"
2793003623,novivasi,31,0,2,2,0.54005,0.498029,0.000486,"#3e93ff"
2793029926,danitzaruizc,31,0,3,3,0.559586,0.547411,0.000973,"#3e93ff"
2793158291,acatlancom,10,0,1,1,0.333084,0.478572,0,"#52d7c0"
2793547524,QuimSalvi,8,1,0,1,0.675218,0.245634,0,"#00ed5d"
2793593106,DespProfesional,49,1,0,1,0.347929,0.668199,0,"#ff7007"
2794614248,CarrieEJohnston,13,0,1,1,0.39325,0.39423,0,"#3bec00"
2795060425,franper_s,21,0,1,1,0.039295,0.655472,0,"#c6cc85"
2795190696,GoliardosUN,13,7,1,8,0.446838,0.379267,0.003405,"#3bec00"
2795294176,fmasoares2,36,2,3,5,0.532688,0.457998,0.001946,"#825403"
2795345308,MEnredes,40,0,1,1,0.559352,0.022579,0,"#ff12a3"
2796496262,ASINES_,14,0,1,1,0.308368,0.69569,0,"#00eeff"
2797036612,nortinita,49,1,0,1,0.32415,0.66836,0,"#ff7007"
2798022975,GeocienciasPUC,21,0,1,1,0.287379,0.230331,0,"#c6cc85"
2798495453,CDigital_USJ,30,0,1,1,0.83993,0.628749,0,"#ff77ff"
2798718260,JesuitasARU,49,1,0,1,0.347162,0.655704,0,"#ff7007"
2798791320,jbosgil,22,0,4,4,0.534692,0.636422,0.001459,"#00e8b2"
2798836581,InternetFF,49,1,0,1,0.336052,0.395655,0,"#ff7007"
2799214211,angelnegro2x68,7,0,1,1,0.64249,0.370674,0,"#ffb800"
2799596069,PLUS_1622,37,1,0,1,0.649332,0.487505,0,"#006032"
2800080527,anabelanogs,22,0,1,1,0.599272,0.646947,0,"#00e8b2"
2800466720,northeastMLA,34,0,1,1,0.43447,0.340133,0,"#ff0d69"
2800633298,RevistaMasTuria,31,1,0,1,0.74819,0.578631,0,"#3e93ff"
2800686884,LuisUdaquiola,55,0,4,4,0.668543,0.65072,0.001459,"#cb3f32"
2800719783,WeekendArchaeo,34,0,4,4,0.507771,0.415149,0.001459,"#ff0d69"
2801264297,DISTRIBLUAR,37,1,0,1,0.572367,0.371498,0,"#006032"
2801651715,ConchaLanga,14,0,1,1,0.658979,0.540275,0,"#00eeff"
2801724797,GuadaUNED,30,1,0,1,0.538188,0.661173,0,"#ff77ff"
2801764013,euromemories,19,2,15,17,0.615412,0.681988,0.007782,"#00d3ff"
2801825917,RuCantor,13,1,5,6,0.453072,0.459321,0.002432,"#3bec00"
2801878704,weshamrick,13,0,1,1,0.352743,0.441419,0,"#3bec00"
2802202724,CUATheoPhilLib,30,0,1,1,0.51272,0.630907,0,"#ff77ff"
2802433341,CECyTE_Ayala,17,0,1,1,0.917254,0.357058,0,"#ff9cc7"
2802778752,UnescomUJ,37,9,4,13,0.533038,0.454103,0.005837,"#006032"
2802886084,waltersena8,55,0,2,2,0.659848,0.637366,0.000486,"#cb3f32"
2803062424,YetziCarPe,17,0,1,1,0.923325,0.386273,0,"#ff9cc7"
2803145630,jpelegriseb,22,0,2,2,0.601151,0.334414,0.000486,"#00e8b2"
2803316848,carminaovargas,38,0,2,2,0.616971,0.426477,0.000486,"#662859"
2803372351,AngelAstorqui,31,0,2,2,0.610384,0.585458,0.000486,"#3e93ff"
2803834418,BibliobbaaUCM,58,2,0,2,0.573658,0.575492,0.000486,"#005076"
2803854799,Epicureo_samos,8,0,1,1,0.796913,0.18802,0,"#00ed5d"
2805487668,CecytejCocula,17,0,1,1,0.914213,0.383979,0,"#ff9cc7"
2805685381,linuxmil,22,0,2,2,0.550403,0.611849,0.000486,"#00e8b2"
2805730836,UdeLaHabana,43,8,6,14,0.691418,0.600721,0.006323,"#fcae7e"
2806375215,tomitomastomate,37,0,1,1,0.261003,0.46218,0,"#006032"
2806836826,aprendedorweb,49,1,0,1,0.367982,0.685273,0,"#ff7007"
2807319779,juanmariaburto,18,2,0,2,0.744371,0.64174,0.000486,"#5456a6"
2808004552,Velma___Dinkley,22,0,3,3,0.586482,0.547086,0.000973,"#00e8b2"
2808204046,CCaraboboLibre,49,0,2,2,0.397344,0.424407,0.000486,"#ff7007"
2808421840,barbaraxfranca,36,0,1,1,0.435769,0.203491,0,"#825403"
2809191225,Elisabeth_FM,30,0,4,4,0.5372,0.567262,0.001459,"#ff77ff"
2809546069,EEII_UMA,14,0,1,1,0.661065,0.514968,0,"#00eeff"
2809936846,UOCphd,14,0,2,2,0.642305,0.566286,0.000486,"#00eeff"
2810545623,EspacioOrbitas,1,1,0,1,0.425524,0.641474,0,"#b6cb00"
2810888871,fercavd,40,0,1,1,0.628804,0.028691,0,"#ff12a3"
2810923151,Atreides_P,36,2,2,4,0.515611,0.356916,0.001459,"#825403"
2810943158,arapch,14,0,2,2,0.492184,0.524196,0.000486,"#00eeff"
2811072474,rmisart,22,0,1,1,0.644835,0.560035,0,"#00e8b2"
2811362492,Gusaf778,49,1,0,1,0.313525,0.632835,0,"#ff7007"
2811602003,Arahis3,43,0,1,1,0.859033,0.541469,0,"#fcae7e"
2811842481,NASWells,30,0,5,5,0.491019,0.533639,0.001946,"#ff77ff"
2811880892,UCARGranada,31,1,0,1,0.647792,0.583255,0,"#3e93ff"
2811918919,MediaCritiques,36,0,3,3,0.452851,0.495508,0.000973,"#825403"
2812117031,Arce85Azul,4,0,1,1,0.860771,0.233392,0,"#f4c8cf"
2812225372,Adelina0061,7,0,1,1,0.559809,0.476142,0,"#ffb800"
2812720619,luncetag,37,0,2,2,0.599545,0.517058,0.000486,"#006032"
2812800296,MosaicoSpanish,1,0,1,1,0.427345,0.639055,0,"#b6cb00"
2814343416,Raquela1976,22,0,1,1,0.608968,0.603852,0,"#00e8b2"
2814838689,cysoc_ual,49,1,3,4,0.501415,0.582404,0.001459,"#ff7007"
2815077014,chrmanning,13,1,0,1,0.522744,0.391572,0,"#3bec00"
2815623109,CCUSalmona,9,9,0,9,0.710273,0.658941,0.003891,"#008f7b"
2815798704,Ascolbi,38,1,1,2,0.573904,0.406286,0.000486,"#662859"
2816350113,SAA_LACCHA,34,2,0,2,0.361695,0.433985,0.000486,"#ff0d69"
2816574404,socioanalisys,13,0,3,3,0.493992,0.44729,0.000973,"#3bec00"
2818376061,RogerSSFerreira,36,0,1,1,0.619095,0.406007,0,"#825403"
2819518735,PatriceKiraly,30,0,2,2,0.53503,0.614199,0.000486,"#ff77ff"
2819704739,ISempereSerrano,22,0,2,2,0.550485,0.618712,0.000486,"#00e8b2"
2819889892,MediPiratas,30,0,1,1,0.553264,0.706454,0,"#ff77ff"
2820074219,Sandi6mx,4,0,1,1,0.8827,0.228512,0,"#f4c8cf"
2820372511,fredymoralez5,31,0,1,1,0.767724,0.918236,0,"#3e93ff"
2820445726,DirectoBogota1,37,0,2,2,0.572731,0.400189,0.000486,"#006032"
2821170946,XatakaFeed,49,1,0,1,0.375942,0.683123,0,"#ff7007"
2821337206,floalibert,22,0,2,2,0.496227,0.640509,0.000486,"#00e8b2"
2821352285,BibliotecaBVFE,1,1,0,1,0.445118,0.6397,0,"#b6cb00"
2821479417,RedVitruvioOK,22,1,0,1,0.477686,0.701033,0,"#00e8b2"
2822561332,UruguayHoy24h,49,2,0,2,0.397949,0.55932,0.000486,"#ff7007"
2823178103,EquipoTcnico,31,0,1,1,0.67254,0.55399,0,"#3e93ff"
2823218818,CongressoHDPT,36,7,6,13,0.53783,0.497029,0.005837,"#825403"
2823260849,mapili_cuairan,34,0,2,2,0.467809,0.362091,0.000486,"#ff0d69"
2823488469,Irenedeluque77,19,0,6,6,0.642927,0.765441,0.002432,"#00d3ff"
2824997824,jathiele,22,0,1,1,0.61672,0.5941,0,"#00e8b2"
2825170003,IUFRONTFormal,42,0,1,1,0.762575,0.417272,0,"#66e087"
2825178147,olga_villoslada,30,0,1,1,0.613237,0.666726,0,"#ff77ff"
2825483244,DanielBejarano_,38,0,1,1,0.436686,0.779565,0,"#662859"
2825580511,julietacoqueta,34,0,2,2,0.506374,0.411198,0.000486,"#ff0d69"
2825635431,ProtocoloUNED,19,0,1,1,0.638314,0.635525,0,"#00d3ff"
2826162619,CEDID_UAB,19,4,11,15,0.618413,0.727996,0.006809,"#00d3ff"
2826971485,Josep_hzd,38,0,1,1,0.809007,0.649068,0,"#662859"
2827111214,majovenromero,15,0,4,4,0.492958,0.590648,0.001459,"#008ebb"
2827156087,mdinsman,49,1,0,1,0.43956,0.666836,0,"#ff7007"
2827395683,ArtnodesUOC,14,86,32,118,0.529465,0.491934,0.056907,"#00eeff"
2827976493,palax_palacis,30,0,1,1,0.612356,0.420785,0,"#ff77ff"
2828007681,gloriaserranos,31,0,6,6,0.612037,0.558305,0.002432,"#3e93ff"
2828024638,guillermogis,15,0,3,3,0.515185,0.565566,0.000973,"#008ebb"
2828117077,vanstriendaniel,34,26,0,26,0.470255,0.476398,0.01216,"#ff0d69"
2828162748,ch_gardiner,30,1,0,1,0.537978,0.619597,0,"#ff77ff"
2828413039,bibliomedia21,7,0,1,1,0.643799,0.367278,0,"#ffb800"
2828420725,depredadortk,13,1,5,6,0.379261,0.471134,0.002432,"#3bec00"
2828541606,CCPPySOCUCM,22,5,0,5,0.885666,0.747992,0.001946,"#00e8b2"
2828750324,AnaMari50889687,49,1,0,1,0.304078,0.63826,0,"#ff7007"
2828754742,neoflash5,49,1,0,1,0.325931,0.633713,0,"#ff7007"
2828967669,ortogalenico,22,0,5,5,0.583998,0.435777,0.001946,"#00e8b2"
2829656422,SaberULA,42,11,2,13,0.69727,0.416098,0.005837,"#66e087"
2830032510,TeacherGrunon,0,0,1,1,0.424069,0.394298,0,"#8ecfec"
2830049640,ernesto1maya,1,0,1,1,0.295396,0.481461,0,"#b6cb00"
2830381969,_swordswoman_,19,0,4,4,0.608878,0.715461,0.001459,"#00d3ff"
2831347669,lauram_fjb,8,0,1,1,0.586568,0.435886,0,"#00ed5d"
2831461462,MoniMonipeny,14,0,3,3,0.504842,0.564322,0.000973,"#00eeff"
2832120712,layla_jreis,30,5,25,30,0.513701,0.524086,0.014105,"#ff77ff"
2832149999,brico_manny,8,0,1,1,0.266958,0.264371,0,"#00ed5d"
2832366634,MasterLitTIC,31,0,4,4,0.614208,0.544787,0.001459,"#3e93ff"
2832562473,ihc_fcsh,36,62,62,124,0.528488,0.440487,0.059825,"#825403"
2832938615,Miguel_MMA_,21,0,1,1,0.190987,0.245781,0,"#c6cc85"
2833735906,nerpmp,18,0,10,10,0.711634,0.631296,0.004377,"#5456a6"
2835280714,bit_LAV,0,0,2,2,0.505587,0.490245,0.000486,"#8ecfec"
2835320266,amayapf,30,0,1,1,0.599681,0.659984,0,"#ff77ff"
2835439978,iObservo,38,0,1,1,0.292771,0.172343,0,"#662859"
2835967198,icufop,31,1,3,4,0.527338,0.51806,0.001459,"#3e93ff"
2836224539,musicologyspain,1,2,0,2,0.550571,0.708474,0.000486,"#b6cb00"
2836415896,Noelia_LSouto,58,0,4,4,0.524149,0.497987,0.001459,"#005076"
2836924110,FV_Marchand,30,0,1,1,0.543679,0.645026,0,"#ff77ff"
2837353354,iNorman55,31,3,4,7,0.637678,0.538811,0.002918,"#3e93ff"
2837373958,moebiusmdq,49,1,0,1,0.371277,0.675027,0,"#ff7007"
2837423607,ecatepeclomas1,13,0,1,1,0.305917,0.394925,0,"#3bec00"
2837834625,tallersocial_it,13,0,1,1,0.399195,0.382594,0,"#3bec00"
2838035806,BoixRichter,3,1,0,1,0.410843,0.756226,0,"#ffb3ff"
2838773181,silviaclaudiam1,49,0,4,4,0.442178,0.553407,0.001459,"#ff7007"
2839578186,ConclusionRos,49,1,0,1,0.359326,0.633771,0,"#ff7007"
2840652033,aarribasa,30,1,0,1,0.724447,0.619316,0,"#ff77ff"
2840780920,Carito_Rod8,13,0,1,1,0.438969,0.35406,0,"#3bec00"
2841106119,mdsf55,34,8,0,8,0.47259,0.511222,0.003405,"#ff0d69"
2841107997,jeroendereu,2,0,2,2,0.685212,0.660793,0.000486,"#ffa64e"
2841148233,LatineEtGraece,22,1,0,1,0.208344,0.626125,0,"#00e8b2"
2841209698,HoraJaen,37,1,0,1,0.567115,0.372046,0,"#006032"
2841472809,Escribir_TFG,14,0,2,2,0.538836,0.473723,0.000486,"#00eeff"
2841767663,fercobla,58,0,2,2,0.553761,0.599989,0.000486,"#005076"
2841915940,ChmdDigital,3,25,11,36,0.489818,0.543108,0.017023,"#ffb3ff"
2841980194,CidemUntref,37,0,1,1,0.285289,0.36445,0,"#006032"
2842023100,mrpenalba,14,0,2,2,0.429661,0.529181,0.000486,"#00eeff"
2842050971,Kike551,3,0,2,2,0.472238,0.608877,0.000486,"#ffb3ff"
2842668453,etarsettiq,21,0,1,1,0.25049,0.203303,0,"#c6cc85"
2843621296,PilarArandaUGR,31,0,1,1,0.68024,0.542307,0,"#3e93ff"
2844499877,M_A_RubioHeras,22,0,1,1,0.596401,0.647912,0,"#00e8b2"
2844738463,humanasunal,38,10,5,15,0.509828,0.403334,0.006809,"#662859"
2844946777,BurriezaMateos,30,1,10,11,0.557552,0.516887,0.004864,"#ff77ff"
2845563751,rivas_siri,7,0,1,1,0.356784,0.372256,0,"#ffb800"
2845589140,anavacer,38,0,1,1,0.785093,0.572515,0,"#662859"
2845607121,imcoterof,2,0,4,4,0.686514,0.453559,0.001459,"#ffa64e"
2845699134,Digital_Fellows,34,8,10,18,0.485619,0.401092,0.008268,"#ff0d69"
2845800712,erubioperea,58,0,2,2,0.517732,0.649745,0.000486,"#005076"
2846508538,lapeceracba,37,0,1,1,0.690333,0.501481,0,"#006032"
2846700448,conferenciacs,3,0,2,2,0.48316,0.609149,0.000486,"#ffb3ff"
2847200350,josemadrina,30,0,1,1,0.492232,0.616683,0,"#ff77ff"
2847264520,UrRevista,37,0,1,1,0.649585,0.380842,0,"#006032"
2847550421,MisionCubaONUG,49,1,0,1,0.376289,0.640608,0,"#ff7007"
2847781366,tallerhistoria2,30,0,1,1,0.526281,0.643916,0,"#ff77ff"
2847904055,IsaGribomont,38,3,1,4,0.454342,0.39776,0.001459,"#662859"
2848422827,rocibe02,22,0,2,2,0.817255,0.294083,0.000486,"#00e8b2"
2848438769,rubeninsky11,13,0,4,4,0.400378,0.411069,0.001459,"#3bec00"
2848476137,mapicone,34,0,1,1,0.4859,0.377103,0,"#ff0d69"
2849040833,JournalSLT,1,37,7,44,0.467196,0.640607,0.020914,"#b6cb00"
2849224400,MedievalLitura,7,0,4,4,0.448842,0.440824,0.001459,"#ffb800"
2850387213,RaquelFilmGuru,49,1,0,1,0.299767,0.677289,0,"#ff7007"
2850473147,MDulceFreire,36,0,1,1,0.571399,0.392915,0,"#825403"
2851047484,InterpretandoP,14,0,2,2,0.597485,0.519354,0.000486,"#00eeff"
2851144780,OurenseConcello,30,2,1,3,0.558201,0.706313,0.000973,"#ff77ff"
2852140001,debmedia_com,49,1,0,1,0.389176,0.67403,0,"#ff7007"
2853416129,AHistAutonoma,13,0,1,1,0.656821,0.510829,0,"#3bec00"
2855411429,PepeTruchita,37,0,1,1,0.471097,0.312654,0,"#006032"
2855416553,malonsom1,30,0,1,1,0.309334,0.552069,0,"#ff77ff"
2855479659,merchesevillan,30,0,1,1,0.491169,0.603783,0,"#ff77ff"
2855684781,AnaAnanobrega1,36,0,1,1,0.551221,0.238426,0,"#825403"
2856442481,HistoryatSussex,13,0,1,1,0.529961,0.462714,0,"#3bec00"
2857319315,MedialabUGR,31,271,66,337,0.585438,0.533383,0.163424,"#3e93ff"
2858194979,memoriacampesin,21,0,2,2,0.273297,0.233539,0.000486,"#c6cc85"
2858507469,obsigu,49,1,0,1,0.311991,0.607013,0,"#ff7007"
2858507985,BiblioBodoni,58,12,5,17,0.510461,0.521821,0.007782,"#005076"
2858588895,rodriguez__mar,55,0,2,2,0.655313,0.64067,0.000486,"#cb3f32"
2859177011,subetealanutria,14,0,3,3,0.493361,0.547225,0.000973,"#00eeff"
2859261646,AndresMenchero,49,2,0,2,0.435159,0.62071,0.000486,"#ff7007"
2860134261,Ines_R_G,31,2,2,4,0.623067,0.409878,0.001459,"#3e93ff"
2860469503,OmarRinconTV,38,17,3,20,0.518314,0.438121,0.009241,"#662859"
2861296203,marjobed,30,0,1,1,0.542207,0.64101,0,"#ff77ff"
2861429074,AutenticoFabu,13,0,1,1,0.433201,0.310584,0,"#3bec00"
2862215242,lozomarti,36,1,0,1,0.579662,0.426849,0,"#825403"
2862477022,hernandez_sau,58,0,2,2,0.57022,0.40008,0.000486,"#005076"
2863217422,EloisaVaq,22,1,3,4,0.551983,0.593223,0.001459,"#00e8b2"
2863821769,teresaaatf,31,0,3,3,0.608147,0.509678,0.000973,"#3e93ff"
2864109269,serbudc,30,0,3,3,0.556032,0.556043,0.000973,"#ff77ff"
2864465837,latatiperez,13,0,3,3,0.488928,0.410673,0.000973,"#3bec00"
2865031324,UntoldHistories,34,0,2,2,0.472251,0.420928,0.000486,"#ff0d69"
2865328068,cboteromarino,34,20,3,23,0.572265,0.382163,0.0107,"#ff0d69"
2865579346,eaiyago,36,1,1,2,0.479971,0.325081,0.000486,"#825403"
2865730870,met_valpo,21,0,1,1,0.193663,0.244182,0,"#c6cc85"
2865951965,mariahelena57b1,30,0,1,1,0.611764,0.437652,0,"#ff77ff"
2866372972,alashayas,30,0,1,1,0.50261,0.704484,0,"#ff77ff"
2866559229,tepozan3,13,0,2,2,0.430958,0.380019,0.000486,"#3bec00"
2866975437,alemondle,35,0,2,2,0.643026,0.347751,0.000486,"#00faff"
2867153662,m_actea,22,1,0,1,0.207722,0.623872,0,"#00e8b2"
2867900419,JMBarrueco,14,7,0,7,0.586368,0.526694,0.002918,"#00eeff"
2868065168,DraXochChavez,34,0,2,2,0.35725,0.428295,0.000486,"#ff0d69"
2868081134,LyR_UAMC,13,0,1,1,0.43616,0.329846,0,"#3bec00"
2868481599,reyes_viveros,10,0,2,2,0.303477,0.476645,0.000486,"#52d7c0"
2869310231,PodCastizo,58,0,2,2,0.6089,0.293658,0.000486,"#005076"
2869429238,tlamelas,22,0,1,1,0.660208,0.409114,0,"#00e8b2"
2869692951,LASACONGRESS,37,24,11,35,0.457649,0.430656,0.016537,"#006032"
2869925478,AnaMLoaizaG,34,0,2,2,0.587455,0.239256,0.000486,"#ff0d69"
2870054576,Jose__Manzo,49,1,0,1,0.399516,0.648424,0,"#ff7007"
2870115454,MauGenta,7,0,2,2,0.419814,0.398579,0.000486,"#ffb800"
2870952847,rorst5,13,0,1,1,0.427291,0.403208,0,"#3bec00"
2871167445,tripsandflips_,13,1,3,4,0.458024,0.4308,0.001459,"#3bec00"
2872057085,ieEMBA,49,2,0,2,0.405575,0.565605,0.000486,"#ff7007"
2872174283,Angelino_ruiz,49,1,0,1,0.358792,0.66482,0,"#ff7007"
2872308971,SciComExoEsa,37,0,1,1,0.632669,0.437137,0,"#006032"
2872676986,LazaroSerch,17,0,1,1,0.819607,0.227516,0,"#ff9cc7"
2872680129,SorianoRaque,13,0,3,3,0.473399,0.348884,0.000973,"#3bec00"
2873347576,ArtificiosR,38,0,1,1,0.325777,0.180654,0,"#662859"
2873362715,mcatagz,38,0,3,3,0.525955,0.429907,0.000973,"#662859"
2873503431,Traficantes_Ed,36,5,11,16,0.590833,0.413436,0.007296,"#825403"
2873679370,alumniusal,58,0,1,1,0.475728,0.660029,0,"#005076"
2873882573,raguilera1986,22,0,1,1,0.571814,0.6316,0,"#00e8b2"
2873992843,UN_InTIColombia,38,2,3,5,0.484869,0.537983,0.001946,"#662859"
2874368207,jgarcedi,14,0,1,1,0.706891,0.034634,0,"#00eeff"
2874418891,IMFAHE,30,3,1,4,0.330239,0.491174,0.001459,"#ff77ff"
2874642297,ArturismoVT,13,0,2,2,0.451359,0.380188,0.000486,"#3bec00"
2875784429,Lixabier,37,0,1,1,0.709674,0.578283,0,"#006032"
2876202767,gelapithecus,30,0,1,1,0.601107,0.248414,0,"#ff77ff"
2876501555,Sundae_Mao,21,0,1,1,0.463856,0.946755,0,"#c6cc85"
2876512348,ILIA_CSIC,14,1,1,2,0.633402,0.514067,0.000486,"#00eeff"
2876559956,consumidorsoyyo,42,0,2,2,0.688415,0.522186,0.000486,"#66e087"
2877732249,datadista,1,1,0,1,0.384319,0.581273,0,"#b6cb00"
2877853552,J_Cshdsur,14,7,5,12,0.540026,0.517808,0.00535,"#00eeff"
2877951449,ejo_pt,9,2,2,4,0.651635,0.43543,0.001459,"#008f7b"
2878658775,BarriPdmx,36,2,0,2,0.398017,0.36051,0.000486,"#825403"
2879308287,LEDnnabis,30,0,1,1,0.532709,0.643387,0,"#ff77ff"
2879338306,dodata_,14,0,1,1,0.683136,0.588484,0,"#00eeff"
2879725251,dorisyaneth1304,3,0,1,1,0.446397,0.744013,0,"#ffb3ff"
2880889678,artevsbeta,31,0,1,1,0.651849,0.546143,0,"#3e93ff"
2881362106,TheEduDistrict,30,2,0,2,0.56651,0.657315,0.000486,"#ff77ff"
2881373775,LudwigGuru,31,33,6,39,0.591235,0.537114,0.018482,"#3e93ff"
2882390683,BPDigital_cl,21,0,2,2,0.24602,0.250638,0.000486,"#c6cc85"
2882912390,ahsoubervielle,13,1,3,4,0.508929,0.433615,0.001459,"#3bec00"
2883066112,barbiefilosofa,13,0,2,2,0.485638,0.417526,0.000486,"#3bec00"
2883843188,jlgoncalez,22,0,1,1,0.598063,0.620312,0,"#00e8b2"
2883889251,enaraartetxe,18,1,0,1,0.657477,0.637242,0,"#5456a6"
2885205046,sandragrull,13,1,0,1,0.321955,0.399226,0,"#3bec00"
2885828620,AntonioRRos,22,2,3,5,0.440802,0.497638,0.001946,"#00e8b2"
2886908020,arcontefrisseo,37,1,0,1,0.57491,0.372978,0,"#006032"
2887491371,ACgonzalopez1,37,0,2,2,0.585428,0.486018,0.000486,"#006032"
2887507997,serWyl,31,0,3,3,0.609359,0.487051,0.000973,"#3e93ff"
2889339563,carpjuarez1,57,0,1,1,0.707721,0.54395,0,"#b66f7a"
2889397025,RevistaCirce,13,15,4,19,0.510386,0.482228,0.008755,"#3bec00"
2889417706,perezfuilleratn,31,0,4,4,0.622941,0.542721,0.001459,"#3e93ff"
2889922738,MabelMoralesTa,21,0,1,1,0.184049,0.201206,0,"#c6cc85"
2889959246,emprendet_com,14,0,1,1,0.68742,0.571576,0,"#00eeff"
2890270402,aimeevegam,7,0,2,2,0.414182,0.636149,0.000486,"#ffb800"
2890465774,coLenguando,30,7,4,11,0.463349,0.611981,0.004864,"#ff77ff"
2890597829,masteressevilla,1,5,0,5,0.396541,0.540689,0.001946,"#b6cb00"
2891039514,cesta_stanford,34,6,2,8,0.458218,0.446464,0.003405,"#ff0d69"
2891161305,Anarquismoenpdf,19,1,3,4,0.60425,0.755002,0.001459,"#00d3ff"
2891170505,DataSmartTools,49,1,0,1,0.372579,0.640799,0,"#ff7007"
2891934202,ChemPlusChem,49,1,0,1,0.419366,0.655034,0,"#ff7007"
2891965821,MDA_Barcelona,30,0,2,2,0.591865,0.6365,0.000486,"#ff77ff"
2892368649,jeniffermendo20,34,0,9,9,0.505913,0.444977,0.003891,"#ff0d69"
2893046385,acpedagogia,58,0,2,2,0.589077,0.584066,0.000486,"#005076"
2893145265,asehismi,19,0,2,2,0.55443,0.500719,0.000486,"#00d3ff"
2893213199,roterbooks,14,0,1,1,0.622303,0.662436,0,"#00eeff"
2893228318,carlosrising1,30,0,4,4,0.554943,0.583283,0.001459,"#ff77ff"
2893560599,filosunam,13,12,0,12,0.455628,0.443405,0.00535,"#3bec00"
2893893154,VozMediaLatam,49,0,2,2,0.419386,0.592933,0.000486,"#ff7007"
2894256844,DorisMenchaca66,17,0,1,1,0.924268,0.374707,0,"#ff9cc7"
2896200718,colibrisulfuric,21,0,2,2,0.237591,0.245942,0.000486,"#c6cc85"
2896868541,rodolfoelbert,38,1,0,1,0.428879,0.868942,0,"#662859"
2897285536,ga_brieell_,36,2,9,11,0.509774,0.363319,0.004864,"#825403"
2897308048,mirabel_revues,13,1,0,1,0.394441,0.497342,0,"#3bec00"
2898010524,FrancesMiquel,3,1,0,1,0.547353,0.794443,0,"#ffb3ff"
2898300309,carlosandradas,30,5,0,5,0.526208,0.566406,0.001946,"#ff77ff"
2898948431,juangomiscoloma,36,0,3,3,0.632444,0.523106,0.000973,"#825403"
2899223091,Xinsolem,37,0,1,1,0.615232,0.631704,0,"#006032"
2899500747,cruze_andrea,7,0,4,4,0.501788,0.41725,0.001459,"#ffb800"
2899606613,culturemad_,0,0,2,2,0.601706,0.537714,0.000486,"#8ecfec"
2900446215,begona_casas,0,0,1,1,0.336326,0.57092,0,"#8ecfec"
2901004694,entreP_,49,6,2,8,0.23463,0.643606,0.003405,"#ff7007"
2901945254,Aleks_Kaye,36,1,3,4,0.489729,0.403909,0.001459,"#825403"
2902179771,UBUCultura,37,1,0,1,0.573433,0.363368,0,"#006032"
2902382314,MEFerF,3,0,1,1,0.489851,0.764831,0,"#ffb3ff"
2902944537,teresaga_,31,0,2,2,0.716862,0.464894,0.000486,"#3e93ff"
2902951037,Fdez_Ortiz_UO,37,3,3,6,0.614384,0.506938,0.002432,"#006032"
2903297604,LaEraMediatica,3,0,3,3,0.470808,0.696655,0.000973,"#ffb3ff"
2903380972,gitanillalunera,23,0,2,2,0.190224,0.506634,0.000486,"#005455"
2903567925,IUCEUAM,22,0,2,2,0.595033,0.546839,0.000486,"#00e8b2"
2903895297,revistaBiD,14,12,4,16,0.529472,0.605467,0.007296,"#00eeff"
2904620865,perotampoco,38,0,1,1,0.564142,0.374036,0,"#662859"
2904700968,ajalburaidi,36,0,1,1,0.529747,0.301055,0,"#825403"
2904865133,MCoeckelbergh,37,2,0,2,0.581738,0.557525,0.000486,"#006032"
2905286175,masterensevilla,1,1,0,1,0.383706,0.540361,0,"#b6cb00"
2905657426,memoriamalaga,19,2,0,2,0.642318,0.760551,0.000486,"#00d3ff"
2905788855,ntatianaramirez,3,0,1,1,0.440766,0.764719,0,"#ffb3ff"
2906555842,_ray_SA,13,0,5,5,0.451112,0.477583,0.001946,"#3bec00"
2906783536,m_ojanguren,18,0,2,2,0.732715,0.613077,0.000486,"#5456a6"
2907749986,eurogeography,30,1,0,1,0.527062,0.783952,0,"#ff77ff"
2908841007,CAA_Int,49,0,3,3,0.455062,0.553451,0.000973,"#ff7007"
2909386191,AHLiST_Congress,30,15,27,42,0.499189,0.517404,0.019942,"#ff77ff"
2909604240,focusif16,45,0,2,2,0.672509,0.183511,0.000486,"#00e8ff"
2911429647,CubaMES,43,1,0,1,0.73523,0.661445,0,"#fcae7e"
2911579378,hominidocar3015,38,0,1,1,0.423611,0.772418,0,"#662859"
2911606930,majemosaa17,19,0,3,3,0.657353,0.679935,0.000973,"#00d3ff"
2912062128,fifUAQ,13,1,0,1,0.368122,0.486933,0,"#3bec00"
2912802953,redesYciencia,49,1,0,1,0.394425,0.640154,0,"#ff7007"
2914099557,JesusgarridogJ,30,0,1,1,0.597054,0.681869,0,"#ff77ff"
2914479832,SenhorMatanza,3,0,1,1,0.482532,0.743374,0,"#ffb3ff"
2915582836,GoengeFubuki,36,0,1,1,0.501345,0.22851,0,"#825403"
2915849418,KelseyUtne,34,0,2,2,0.359832,0.435786,0.000486,"#ff0d69"
2916015406,cewebbr,36,3,2,5,0.473017,0.299563,0.001946,"#825403"
2917426475,sape_Udc,30,1,0,1,0.569867,0.583241,0,"#ff77ff"
2917551316,HyCmar,30,4,0,4,0.551116,0.623465,0.001459,"#ff77ff"
2917671960,ChelyVGA,3,0,1,1,0.450832,0.632898,0,"#ffb3ff"
2918474854,indiedestroyed,36,3,0,3,0.516655,0.365527,0.000973,"#825403"
2919386884,Iberarchivos,19,0,4,4,0.637184,0.535282,0.001459,"#00d3ff"
2919398071,dhumanities_rr,30,14,0,14,0.501566,0.544558,0.006323,"#ff77ff"
2920518059,rutassierra,1,1,4,5,0.543837,0.504882,0.001946,"#b6cb00"
2920664362,RdominguC,10,0,2,2,0.38075,0.446403,0.000486,"#52d7c0"
2921039178,Amaritiux,13,0,1,1,0.359017,0.50835,0,"#3bec00"
2921196239,JJLMDCLA,13,0,1,1,0.434422,0.503163,0,"#3bec00"
2921268484,mariviti1,30,0,1,1,0.592131,0.561083,0,"#ff77ff"
2922291253,QuinceAbril,49,1,0,1,0.351492,0.630896,0,"#ff7007"
2922606831,mgarciav66,49,2,1,3,0.486984,0.582821,0.000973,"#ff7007"
2922643935,UOCNews,14,0,2,2,0.659462,0.5041,0.000486,"#00eeff"
2923880452,ElviraCaneda,0,0,2,2,0.567952,0.649721,0.000486,"#8ecfec"
2924556373,CienciasENSE,13,0,1,1,0.585918,0.219837,0,"#3bec00"
2925182561,centri_fuga,31,0,1,1,0.634825,0.518389,0,"#3e93ff"
2925658156,javisanchez_ES,1,0,1,1,0.429845,0.709134,0,"#b6cb00"
2926538208,Skylly_w,22,0,2,2,0.496539,0.692815,0.000486,"#00e8b2"
2926552889,desbanda1937,19,4,0,4,0.638257,0.763246,0.001459,"#00d3ff"
2926739242,museorusomalaga,14,11,2,13,0.598049,0.50462,0.005837,"#00eeff"
2926756275,cimarron_films,49,1,0,1,0.353808,0.694187,0,"#ff7007"
2927689755,GeaPatrizia,34,1,0,1,0.417841,0.438106,0,"#ff0d69"
2929089986,ASECSWomen,36,0,1,1,0.437214,0.592973,0,"#825403"
2932195539,infolaasomada4,7,0,1,1,0.491392,0.697118,0,"#ffb800"
2932364086,flacsohn,7,0,1,1,0.421805,0.331039,0,"#ffb800"
2932426820,laguna_so,41,0,2,2,0.387177,0.407703,0.000486,"#697b00"
2933676574,parsanmart,0,0,1,1,0.36064,0.587058,0,"#8ecfec"
2933692635,dtdewar,34,23,0,23,0.474011,0.470043,0.0107,"#ff0d69"
2933785533,plax_gm,14,0,1,1,0.662304,0.404411,0,"#00eeff"
2933867680,sarahedwagner,22,0,1,1,0.580154,0.622843,0,"#00e8b2"
2934027616,lachulonaYeaO,13,0,1,1,0.434653,0.306218,0,"#3bec00"
2935573997,JoseLui76838429,3,0,1,1,0.466674,0.762478,0,"#ffb3ff"
2935982637,EcoMovistar,32,2,2,4,0.31705,0.458122,0.001459,"#00b1c7"
2936292323,MiguelHilargiak,31,0,2,2,0.585251,0.556312,0.000486,"#3e93ff"
2937216999,ARCIANasoc,19,1,1,2,0.556217,0.631756,0.000486,"#00d3ff"
2938160530,Sophia_Digital,14,3,0,3,0.613502,0.488269,0.000973,"#00eeff"
2938341550,_emapic,55,15,10,25,0.548972,0.498885,0.011673,"#cb3f32"
2940972837,REDBRAYN,49,1,0,1,0.299582,0.647925,0,"#ff7007"
2941204386,questionpro_es,49,4,0,4,0.45112,0.658794,0.001459,"#ff7007"
2942156829,CECUbogota,34,0,1,1,0.5571,0.227629,0,"#ff0d69"
2942287187,wxlcometonvrlnd,40,0,1,1,0.644827,0.040305,0,"#ff12a3"
2942715317,garciabolta,0,0,3,3,0.551517,0.638729,0.000973,"#8ecfec"
2942985635,alizia_luna,22,2,1,3,0.569411,0.687206,0.000973,"#00e8b2"
2943721114,3186Ricardo,30,6,0,6,0.562014,0.629477,0.002432,"#ff77ff"
2943780393,0chicote,13,0,1,1,0.428186,0.399744,0,"#3bec00"
2947970705,Javi_AlvaradoLl,0,0,2,2,0.434224,0.603798,0.000486,"#8ecfec"
2948808515,HeluaBilbo,49,1,0,1,0.391464,0.701312,0,"#ff7007"
2949196155,21acbc143c34413,1,0,2,2,0.664518,0.454718,0.000486,"#b6cb00"
2949637127,Asotrack,14,0,2,2,0.688496,0.737046,0.000486,"#00eeff"
2949718113,OCRMOLGA,21,0,1,1,0.041161,0.64713,0,"#c6cc85"
2950404406,ortizcastroq,34,0,6,6,0.517765,0.442035,0.002432,"#ff0d69"
2952030929,Ant_Rev1966,22,1,1,2,0.505889,0.649628,0.000486,"#00e8b2"
2952630395,tlacuacher88,35,0,1,1,0.574386,0.274777,0,"#00faff"
2952740590,lfp_56,15,0,1,1,0.551634,0.752843,0,"#008ebb"
2953056345,AdolfoSuarezI,19,1,0,1,0.647444,0.802024,0,"#00d3ff"
2954056833,Juanma_historia,58,0,2,2,0.505208,0.616801,0.000486,"#005076"
2955400255,MasiosareOliver,14,0,1,1,0.446386,0.72348,0,"#00eeff"
2956877427,miguelluis_2015,8,0,3,3,0.674343,0.281727,0.000973,"#00ed5d"
2957474806,pruedar,14,73,17,90,0.565541,0.549186,0.043288,"#00eeff"
2959500310,ElOtroRockRadio,40,0,1,1,0.669685,0.025777,0,"#ff12a3"
2959770455,Danialexmcm,3,0,1,1,0.532502,0.751145,0,"#ffb3ff"
2960854985,Ma_Canabes,21,0,1,1,0.251553,0.208732,0,"#c6cc85"
2961262078,Pattymartes,17,0,1,1,0.910746,0.376369,0,"#ff9cc7"
2961414461,LGosner,35,0,1,1,0.553316,0.423867,0,"#00faff"
2963035414,luisgastons,21,0,1,1,0.020857,0.628698,0,"#c6cc85"
2964933769,srodriguez65191,46,0,1,1,0.50183,0.142258,0,"#403538"
2965131027,AnaValtierraL,2,1,2,3,0.613305,0.650654,0.000973,"#ffa64e"
2966162805,AntonioRaasch,21,0,1,1,0.224159,0.227967,0,"#c6cc85"
2966360596,FloClavaud,49,0,1,1,0.347225,0.470657,0,"#ff7007"
2967719242,caminerocursos,30,0,1,1,0.523153,0.623889,0,"#ff77ff"
2968936137,cpepi_colsan,13,1,2,3,0.455892,0.405236,0.000973,"#3bec00"
2969645716,marcorospocher,14,0,1,1,0.601523,0.579274,0,"#00eeff"
2970440088,TinkeringHuman,13,2,2,4,0.444338,0.453447,0.001459,"#3bec00"
2970487507,maotv5,49,1,0,1,0.365341,0.630625,0,"#ff7007"
2970572259,lreynaldocorrea,14,0,2,2,0.579616,0.565103,0.000486,"#00eeff"
2971415799,clara_paolini,30,5,1,6,0.568794,0.612194,0.002432,"#ff77ff"
2971623556,uned_alzira_val,30,3,18,21,0.50661,0.54864,0.009728,"#ff77ff"
2971821921,antoniojaguiIar,16,0,3,3,0.926956,0.671278,0.000973,"#c42c63"
2972324885,jescourido,49,0,1,1,0.382495,0.536616,0,"#ff7007"
2973187882,espejonav,22,4,0,4,0.76502,0.368153,0.001459,"#00e8b2"
2973255304,filoloka18,14,0,2,2,0.544326,0.58334,0.000486,"#00eeff"
2973981797,j_becerra_a,7,0,2,2,0.380344,0.359232,0.000486,"#ffb800"
2974371167,montse_mcfr,15,0,1,1,0.556409,0.683496,0,"#008ebb"
2975028419,espacioletras,1,0,2,2,0.463605,0.651692,0.000486,"#b6cb00"
2975153835,LLHBC,38,0,1,1,0.804094,0.64145,0,"#662859"
2975339368,LaPeliagria,49,0,2,2,0.625819,0.489512,0.000486,"#ff7007"
2976381881,AnaBCasino,30,0,2,2,0.515315,0.614319,0.000486,"#ff77ff"
2976663832,Lia_livex,21,0,1,1,0.228106,0.213226,0,"#c6cc85"
2976762437,fundacionFESCOL,38,2,3,5,0.561819,0.477575,0.001946,"#662859"
2977375450,blillehaugen,13,4,12,16,0.467013,0.468236,0.007296,"#3bec00"
2977527809,wmnobrasil,36,3,3,6,0.464597,0.349765,0.002432,"#825403"
2977634679,HilarioM2000,49,1,0,1,0.321997,0.677874,0,"#ff7007"
2978312829,b_echaburu,49,3,0,3,0.449207,0.555364,0.000973,"#ff7007"
2978822476,hanna_a4007,13,0,3,3,0.45629,0.447793,0.000973,"#3bec00"
2978874587,DerekBCounts,34,0,1,1,0.336232,0.424412,0,"#ff0d69"
2979176331,voxboxmag,3,0,2,2,0.537747,0.600341,0.000486,"#ffb3ff"
2979280311,mariacerestrepo,49,0,1,1,0.459802,0.678994,0,"#ff7007"
2979537347,asantiagofaria,36,2,8,10,0.534035,0.442399,0.004377,"#825403"
2979938103,CE_Aguilera_A,21,0,1,1,0.206317,0.21849,0,"#c6cc85"
2980276696,libegzarranz,15,0,1,1,0.449281,0.664568,0,"#008ebb"
2981632084,cristianalborp,38,0,1,1,0.539494,0.317765,0,"#662859"
2982375287,cor_glez,37,0,2,2,0.660556,0.486685,0.000486,"#006032"
2982583924,linkbyuma,14,2,0,2,0.57511,0.520618,0.000486,"#00eeff"
2982644655,antoniovirgen4,49,0,1,1,0.541528,0.743332,0,"#ff7007"
2982670852,CulturacySL,14,2,3,5,0.568355,0.518932,0.001946,"#00eeff"
2982873873,czapatacar,38,0,7,7,0.548734,0.425893,0.002918,"#662859"
2983900498,_thalassocracy_,33,0,1,1,0.249125,0.616661,0,"#ff8c00"
2984351391,LaChicaOrtiga,0,0,1,1,0.425555,0.382849,0,"#8ecfec"
2984453005,mandarinaelect,34,0,1,1,0.471218,0.370312,0,"#ff0d69"
2984491582,juliocvaras,14,0,6,6,0.535635,0.564669,0.002432,"#00eeff"
2984501061,sebastian_miras,58,2,0,2,0.490025,0.649628,0.000486,"#005076"
2984543585,CarmenRGonzalo,15,1,0,1,0.510492,0.743627,0,"#008ebb"
2984742628,maureviv,37,0,1,1,0.562249,0.618279,0,"#006032"
2985856138,DollyMontoyaUN,38,3,0,3,0.546451,0.409226,0.000973,"#662859"
2985886996,FCEA_UdelaR,55,14,0,14,0.665011,0.650188,0.006323,"#cb3f32"
2986666096,florazuaje58,22,0,1,1,0.287809,0.664567,0,"#00e8b2"
2986845946,cidesantafe,4,0,2,2,0.629129,0.287382,0.000486,"#f4c8cf"
2987183079,RTVE_Com,19,1,0,1,0.675475,0.778032,0,"#00d3ff"
2987583095,ericweiskott,49,4,0,4,0.461778,0.55582,0.001459,"#ff7007"
2987664917,instclasstudies,14,0,2,2,0.559263,0.494477,0.000486,"#00eeff"
2988981655,martinmendezglz,4,0,5,5,0.880829,0.252972,0.001946,"#f4c8cf"
2990199861,OceanAZUL,37,0,1,1,0.724587,0.3501,0,"#006032"
2990442904,GtorresacTorres,22,0,3,3,0.589448,0.641684,0.000973,"#00e8b2"
2990668995,TiwoliChirp,30,0,1,1,0.51779,0.617261,0,"#ff77ff"
2991740553,martuchela2,22,0,2,2,0.578729,0.585412,0.000486,"#00e8b2"
2992544044,veronicaabdala,49,1,0,1,0.424652,0.653832,0,"#ff7007"
2993012784,carrilloabundis,13,0,1,1,0.429825,0.421731,0,"#3bec00"
2993664074,WafaIsfahany,36,0,4,4,0.448054,0.344169,0.001459,"#825403"
2994336675,MshBretagne,30,1,5,6,0.486656,0.508768,0.002432,"#ff77ff"
2994448780,MadRomaoMira,1,1,2,3,0.412915,0.62651,0.000973,"#b6cb00"
2994582401,criiasupr,13,8,1,9,0.424251,0.488446,0.003891,"#3bec00"
2994679252,BrehonyMargaret,30,0,1,1,0.609742,0.387828,0,"#ff77ff"
2994909239,YvanPozuelo,14,0,1,1,0.581768,0.589897,0,"#00eeff"
2994939977,MorganaleFay_,13,0,1,1,0.384107,0.365414,0,"#3bec00"
2995068936,dhatcc,36,0,1,1,0.40129,0.46778,0,"#825403"
2995751375,DigiHUBBRomania,30,0,4,4,0.480634,0.513181,0.001459,"#ff77ff"
2995868723,anacalvorevilla,2,4,16,20,0.520192,0.564564,0.009241,"#ffa64e"
2996469985,anacristiv,3,0,1,1,0.691857,0.650803,0,"#ffb3ff"
2997222911,Quetzalpurpura1,13,0,1,1,0.415785,0.343141,0,"#3bec00"
2997759634,mariajosefanv,16,0,2,2,0.939606,0.67154,0.000486,"#c42c63"
2999633549,lmmanjare,30,0,3,3,0.587872,0.597812,0.000973,"#ff77ff"
3000274797,CulturArk,19,0,6,6,0.499678,0.565723,0.002432,"#00d3ff"
3000375640,SMWMexico,49,2,0,2,0.408336,0.574548,0.000486,"#ff7007"
3001292229,EuropeDirectUS,1,1,0,1,0.245116,0.581835,0,"#b6cb00"
3001559279,ChantalCaballe1,19,0,2,2,0.633176,0.664075,0.000486,"#00d3ff"
3001564386,Draco_unam,13,0,1,1,0.44024,0.237972,0,"#3bec00"
3002718796,mxtalentum,13,1,1,2,0.400989,0.428419,0.000486,"#3bec00"
3003002860,ArxiuHFidelFita,19,0,1,1,0.653489,0.632833,0,"#00d3ff"
3003645287,diaz_durana,22,6,3,9,0.542637,0.575856,0.003891,"#00e8b2"
3003961739,hadaJazmine,41,0,2,2,0.350163,0.398528,0.000486,"#697b00"
3003995187,LibraryLivLab,14,1,1,2,0.616065,0.587423,0.000486,"#00eeff"
3004108061,MCPomarRossello,30,0,3,3,0.551599,0.596545,0.000973,"#ff77ff"
3004193357,viridislife,49,1,0,1,0.345369,0.685062,0,"#ff7007"
3004324330,Ed_Uniandes,13,9,2,11,0.520661,0.465209,0.004864,"#3bec00"
3005782515,NOVAIMS,36,3,0,3,0.513954,0.420721,0.000973,"#825403"
3006053506,Marta_MGabaldon,37,0,2,2,0.380128,0.382731,0.000486,"#006032"
3006192610,joeltheomar,38,0,1,1,0.413614,0.770648,0,"#662859"
3006301630,DeSantiagoCL,21,0,2,2,0.256767,0.246085,0.000486,"#c6cc85"
3006463365,ferran_jorba,14,0,1,1,0.647257,0.57681,0,"#00eeff"
3007331514,Asher_173,7,0,2,2,0.425129,0.37038,0.000486,"#ffb800"
3007814181,roserbb1,30,0,1,1,0.61073,0.445138,0,"#ff77ff"
3008727843,Martaconeando,21,0,2,2,0.244411,0.248264,0.000486,"#c6cc85"
3009572552,buhoalcatraz,13,0,6,6,0.503013,0.473146,0.002432,"#3bec00"
3009679910,goth_librarian,22,0,1,1,0.517994,0.747899,0,"#00e8b2"
3009956699,Krou12Firmino,36,0,3,3,0.51369,0.301792,0.000973,"#825403"
3010489697,ijgtrad,14,0,1,1,0.709798,0.511347,0,"#00eeff"
3010656380,LawrenceEvalyn,49,0,2,2,0.380371,0.462839,0.000486,"#ff7007"
3010737861,louise_tbr,9,0,2,2,0.737504,0.66915,0.000486,"#008f7b"
3011188258,_Nantu_,35,7,4,11,0.634301,0.448345,0.004864,"#00faff"
3011898538,revista_ijeri,58,2,1,3,0.451463,0.628739,0.000973,"#005076"
3012634431,archivoFPI,19,11,2,13,0.635176,0.71358,0.005837,"#00d3ff"
3013488287,frutivitaminas,2,0,3,3,0.489837,0.636567,0.000973,"#ffa64e"
3013561229,PalabraMaestra,49,2,0,2,0.321132,0.695161,0.000486,"#ff7007"
3014603495,HistoriaRep,38,6,5,11,0.533158,0.427484,0.004864,"#662859"
3014612084,EducaDisruptiva,3,9,0,9,0.481383,0.631095,0.003891,"#ffb3ff"
3014755882,MusaleUsal,58,0,2,2,0.484237,0.592516,0.000486,"#005076"
3015395122,AdpUned,30,0,1,1,0.516335,0.625276,0,"#ff77ff"
3015616245,insdertosa,8,0,1,1,0.679361,0.307806,0,"#00ed5d"
3015799709,estudiosindiano,58,4,0,4,0.466063,0.527178,0.001459,"#005076"
3016051375,MaryELennon,4,0,1,1,0.367581,0.439474,0,"#f4c8cf"
3016458196,RevistasEnLinea,7,0,3,3,0.543199,0.448451,0.000973,"#ffb800"
3016959235,frekorder,13,0,1,1,0.503849,0.365453,0,"#3bec00"
3017655772,Tayo2074,22,0,1,1,0.586852,0.621894,0,"#00e8b2"
3017762346,LuciaGR9,34,0,5,5,0.475585,0.438079,0.001946,"#ff0d69"
3017765687,pcarcedo22,30,4,29,33,0.52286,0.530764,0.015564,"#ff77ff"
3017865412,padrinopz,34,0,3,3,0.503499,0.428811,0.000973,"#ff0d69"
3018420683,Carnivorasblog,49,1,0,1,0.338091,0.634244,0,"#ff7007"
3019479279,ESphaera,58,0,2,2,0.475831,0.59421,0.000486,"#005076"
3019724440,Lanki_MU,18,0,2,2,0.69437,0.631876,0.000486,"#5456a6"
3020520436,purifn7,22,0,1,1,0.753411,0.478013,0,"#00e8b2"
3020807050,jcarlosamador1,19,0,3,3,0.538943,0.485714,0.000973,"#00d3ff"
3021069177,biouned,49,2,0,2,0.434241,0.537001,0.000486,"#ff7007"
3021322161,mrloizaga,2,0,4,4,0.536762,0.512536,0.001459,"#ffa64e"
3022033330,carrascolengua,49,1,0,1,0.384253,0.635194,0,"#ff7007"
3022554716,CecytemEcatepc3,17,0,1,1,0.942158,0.369538,0,"#ff9cc7"
3023518152,arielbrito82,49,1,0,1,0.457177,0.62522,0,"#ff7007"
3024197983,hacheteweb,22,3,0,3,0.568365,0.607077,0.000973,"#00e8b2"
3024920679,AlbertoEsVa,30,0,8,8,0.560468,0.483696,0.003405,"#ff77ff"
3026184405,TransReal360,0,0,1,1,0.383964,0.558921,0,"#8ecfec"
3026312742,trasegantes,14,12,7,19,0.548346,0.51675,0.008755,"#00eeff"
3026361807,sararembado,1,0,1,1,0.443529,0.641933,0,"#b6cb00"
3026855954,AtandoCabos,0,2,0,2,0.278259,0.5576,0.000486,"#8ecfec"
3028214026,8daysaweekSil,3,0,1,1,0.478299,0.771487,0,"#ffb3ff"
3028996889,juanpro62,22,0,4,4,0.580131,0.576868,0.001459,"#00e8b2"
3029027662,sbibliotecario,49,4,1,5,0.432354,0.575805,0.001946,"#ff7007"
3029302409,nomiriam3,7,0,1,1,0.352758,0.303411,0,"#ffb800"
3029537081,profesoraneon,3,3,3,6,0.536821,0.455637,0.002432,"#ffb3ff"
3030060712,ESUDH,49,5,3,8,0.444077,0.535584,0.003405,"#ff7007"
3030194963,mshstoulouse,22,0,2,2,0.496341,0.638244,0.000486,"#00e8b2"
3031743102,jovenescausa,13,0,1,1,0.510926,0.400487,0,"#3bec00"
3033117561,jrbsjrbs,55,5,1,6,0.61961,0.598511,0.002432,"#cb3f32"
3035004182,eLaboraHD,13,59,33,92,0.494386,0.478549,0.044261,"#3bec00"
3035014849,ariadnafilhd,30,0,2,2,0.585908,0.593264,0.000486,"#ff77ff"
3035192141,lucia_pdll,30,0,3,3,0.59139,0.651371,0.000973,"#ff77ff"
3035264968,humcommons,22,9,1,10,0.504388,0.546735,0.004377,"#00e8b2"
3035534607,jalfahern,30,0,1,1,0.689048,0.616268,0,"#ff77ff"
3036827188,TziteReyesVega,13,0,1,1,0.468922,0.393679,0,"#3bec00"
3037264229,autores_uy,55,25,7,32,0.619724,0.60277,0.015078,"#cb3f32"
3039123887,PCE_Vikalvaro,19,1,0,1,0.630026,0.788637,0,"#00d3ff"
3039929661,LoganAHeiman,13,0,1,1,0.37978,0.441708,0,"#3bec00"
3040566253,archilaud79,38,0,1,1,0.290415,0.187089,0,"#662859"
3040871649,hubofml,37,0,3,3,0.387744,0.500198,0.000973,"#006032"
3042022260,diegoaurbinam,21,0,1,1,0.237819,0.212919,0,"#c6cc85"
3042542153,BibianCardenas,37,0,2,2,0.525892,0.403825,0.000486,"#006032"
3042830021,Futuracultural,22,0,1,1,0.698405,0.592919,0,"#00e8b2"
3043120698,EurResearch,30,2,4,6,0.471687,0.556418,0.002432,"#ff77ff"
3043420187,quodnemonovit,13,0,1,1,0.398973,0.492285,0,"#3bec00"
3044281610,vQuark,17,0,1,1,0.819689,0.221458,0,"#ff9cc7"
3044530548,ibotezan,22,0,4,4,0.562835,0.604429,0.001459,"#00e8b2"
3044582153,deantofagasta1,21,0,1,1,0.245564,0.195304,0,"#c6cc85"
3044615854,SEHL_oficial,15,0,2,2,0.482568,0.644584,0.000486,"#008ebb"
3044694975,hagolorenadas,19,0,1,1,0.68344,0.833618,0,"#00d3ff"
3044764241,AdrianaRudling,34,0,1,1,0.554514,0.323617,0,"#ff0d69"
3044827841,south_summit,30,1,0,1,0.593013,0.595393,0,"#ff77ff"
3044898783,pmartin207,30,0,1,1,0.492185,0.628335,0,"#ff77ff"
3045308949,SLIS_FONTIBON,28,0,1,1,0.877124,0.397315,0,"#cd5700"
3046255084,f_indaprieto,19,1,0,1,0.658522,0.798245,0,"#00d3ff"
3046411539,DrissBouyema,16,0,2,2,0.925006,0.656441,0.000486,"#c42c63"
3046421205,AnaPj2014,8,0,1,1,0.260309,0.273008,0,"#00ed5d"
3047147759,HurtadoZaidaa,34,0,1,1,0.473351,0.305026,0,"#ff0d69"
3047173412,SallyEverson,13,0,3,3,0.487967,0.44202,0.000973,"#3bec00"
3049234889,nuno_anto,30,1,2,3,0.714999,0.639523,0.000973,"#ff77ff"
3050767250,anselmogomes534,36,0,1,1,0.455911,0.270005,0,"#825403"
3052964235,kirugamario,40,0,1,1,0.631883,0.007332,0,"#ff12a3"
3052992564,diego_familiar,22,0,3,3,0.587458,0.635414,0.000973,"#00e8b2"
3053100639,mlps_uc3m,30,0,1,1,0.630137,0.56347,0,"#ff77ff"
3053517210,lufil2c,30,0,1,1,0.522213,0.620192,0,"#ff77ff"
3053747944,Una_Quispe_mas,40,0,1,1,0.619578,0.035261,0,"#ff12a3"
3054638738,LyC_Triqui,34,1,1,2,0.434603,0.348078,0.000486,"#ff0d69"
3054866471,JAlexRoL,22,0,7,7,0.567276,0.489448,0.002918,"#00e8b2"
3055631451,PilarHylenna,30,0,2,2,0.547149,0.558115,0.000486,"#ff77ff"
3056200605,elepacas,1,0,4,4,0.471324,0.540753,0.001459,"#b6cb00"
3056492325,par_virtual,0,5,3,8,0.592128,0.502931,0.003405,"#8ecfec"
3056967532,barbaraffernand,48,0,1,1,0.203808,0.700951,0,"#ff7a78"
3058558104,dialogomedieval,30,14,10,24,0.479166,0.551162,0.011187,"#ff77ff"
3058567301,ideiainova,36,0,1,1,0.60787,0.402649,0,"#825403"
3060056609,pacho51950,8,0,1,1,0.79331,0.194863,0,"#00ed5d"
3060444101,SantchiWeb,38,0,4,4,0.510134,0.436777,0.001459,"#662859"
3060753787,EliSpears19,27,2,0,2,0.086931,0.682573,0.000486,"#7e8b76"
3060861718,RicardoDalFarra,49,3,1,4,0.427518,0.483867,0.001459,"#ff7007"
3061659068,cetis113mx,17,0,1,1,0.906536,0.37867,0,"#ff9cc7"
3061659548,RobrtDaleParker,34,0,2,2,0.369334,0.407623,0.000486,"#ff0d69"
3061690441,GuateSchNetwork,13,3,3,6,0.441024,0.36291,0.002432,"#3bec00"
3062282931,Populeiros,16,0,2,2,0.95427,0.672059,0.000486,"#c42c63"
3062439831,iflawlic,37,1,0,1,0.631295,0.266435,0,"#006032"
3062545421,PabloSuarezGar,30,0,5,5,0.492712,0.58458,0.001946,"#ff77ff"
3062955261,EmbSpainUK,30,0,1,1,0.626229,0.666147,0,"#ff77ff"
3062975189,aaerolito,37,1,0,1,0.544588,0.273261,0,"#006032"
3063897964,AC_ECarrere,58,0,1,1,0.651572,0.345737,0,"#005076"
3064036750,cfpshare,30,0,1,1,0.554063,0.647512,0,"#ff77ff"
3064247597,cleosagas1,40,0,1,1,0.608601,0.042958,0,"#ff12a3"
3064390925,alejandrogoalo,49,1,0,1,0.414709,0.639163,0,"#ff7007"
3064468246,VanesaHg81,1,0,1,1,0.410959,0.778753,0,"#b6cb00"
3064487572,MusicologyDaily,34,1,0,1,0.571265,0.349014,0,"#ff0d69"
3064749707,natsrojo,30,2,1,3,0.526616,0.562677,0.000973,"#ff77ff"
3067451565,diculther,14,1,2,3,0.541381,0.475913,0.000973,"#00eeff"
3067638777,Malagacc,14,0,4,4,0.597822,0.535168,0.001459,"#00eeff"
3067683237,mercedesglaseim,30,0,1,1,0.49768,0.616266,0,"#ff77ff"
3067691933,HumanOffOn,49,1,0,1,0.324156,0.610639,0,"#ff7007"
3067706337,ConsejoSocUVa,22,4,3,7,0.314852,0.562472,0.002918,"#00e8b2"
3067848886,HilarionHilario,0,0,2,2,0.645897,0.620694,0.000486,"#8ecfec"
3067926149,laura_tormo_,22,0,1,1,0.51952,0.81571,0,"#00e8b2"
3068624261,TuSocialMedia,31,67,19,86,0.557101,0.529743,0.041342,"#3e93ff"
3068863181,Sashlyr,38,0,2,2,0.685065,0.582713,0.000486,"#662859"
3069030862,CineLing,49,0,3,3,0.475432,0.564173,0.000973,"#ff7007"
3069040515,womenhistory15,19,1,0,1,0.603114,0.790295,0,"#00d3ff"
3069578187,luisgencinas,30,3,0,3,0.459115,0.574404,0.000973,"#ff77ff"
3069654820,escolaefpa,8,2,1,3,0.674463,0.3211,0.000973,"#00ed5d"
3070310959,ZazilPalma,3,2,1,3,0.494274,0.728406,0.000973,"#ffb3ff"
3071274351,migueldobrich,37,11,4,15,0.694982,0.388393,0.006809,"#006032"
3072110607,AulaCaceres,30,0,2,2,0.515457,0.605343,0.000486,"#ff77ff"
3074001219,ShoshFuku,37,0,3,3,0.673893,0.374081,0.000973,"#006032"
3074487922,vera_script,22,2,0,2,0.601827,0.632088,0.000486,"#00e8b2"
3074780609,GtorresRodolfo,21,0,1,1,0.258493,0.206515,0,"#c6cc85"
3075157341,MA_Sociodem_UPF,22,0,1,1,0.572523,0.307325,0,"#00e8b2"
3076083269,torres_rechy,13,1,6,7,0.446334,0.513233,0.002918,"#3bec00"
3076651541,lopezborgonoz,19,1,0,1,0.653239,0.773016,0,"#00d3ff"
3077888802,itcobena,30,0,1,1,0.619985,0.604203,0,"#ff77ff"
3078604382,anon_eramujer,58,0,1,1,0.557618,0.712923,0,"#005076"
3079906967,mmoliveras,8,0,5,5,0.672389,0.290029,0.001946,"#00ed5d"
3080916232,davidcrangel,30,1,8,9,0.492683,0.567711,0.003891,"#ff77ff"
3081269231,Pliegodigitaluc,14,25,20,45,0.529272,0.5243,0.021401,"#00eeff"
3081302315,riojaeducando,14,0,3,3,0.454915,0.54589,0.000973,"#00eeff"
3081324034,historiauex,49,1,0,1,0.462314,0.62941,0,"#ff7007"
3081378972,maria_mimia,34,1,0,1,0.599349,0.408954,0,"#ff0d69"
3081787995,IvanSenisse,31,0,1,1,0.6269,0.493899,0,"#3e93ff"
3082626070,madridnube,58,0,1,1,0.550234,0.178312,0,"#005076"
3082773732,pedromf67,40,0,1,1,0.59472,0.042984,0,"#ff12a3"
3084115463,CoalicionArico,49,1,0,1,0.409749,0.650366,0,"#ff7007"
3085292340,leescucho,38,0,2,2,0.559306,0.453205,0.000486,"#662859"
3086351276,maryferdiz19701,52,0,1,1,0.860607,0.67412,0,"#b56eed"
3086474291,bibliotecaUGR,31,7,3,10,0.635375,0.443088,0.004377,"#3e93ff"
3087224491,BrendaSaray_,10,0,2,2,0.325818,0.480786,0.000486,"#52d7c0"
3087685970,jarymorgado,27,2,0,2,0.26781,0.66295,0.000486,"#7e8b76"
3088306119,aimartinpuya,30,0,1,1,0.515703,0.618432,0,"#ff77ff"
3088796211,paolaguimerans,55,0,2,2,0.627559,0.557647,0.000486,"#cb3f32"
3089186002,DiarioCyLMundo,22,2,2,4,0.339729,0.563538,0.001459,"#00e8b2"
3089332090,frontespo,31,7,3,10,0.592521,0.568351,0.004377,"#3e93ff"
3090935074,Referencia_2,14,5,0,5,0.659608,0.69106,0.001946,"#00eeff"
3091241016,EdithRecoder,7,0,1,1,0.36117,0.358849,0,"#ffb800"
3091278735,MuseodeBogota,38,1,0,1,0.550361,0.37002,0,"#662859"
3091285859,agodidactica,30,0,1,1,0.664044,0.613466,0,"#ff77ff"
3091402006,RobEHoughton,36,0,1,1,0.551623,0.363139,0,"#825403"
3092110539,itziarlopez_,36,1,0,1,0.374486,0.334546,0,"#825403"
3092270259,carmen_bbtk,31,0,3,3,0.617174,0.555713,0.000973,"#3e93ff"
3092314617,danihuto,36,3,0,3,0.565052,0.302928,0.000973,"#825403"
3092326659,AppCitySounds,22,0,1,1,0.572948,0.683193,0,"#00e8b2"
3092353132,silcasarenas,38,0,1,1,0.731056,0.453094,0,"#662859"
3092358275,ejuarez2019,49,0,1,1,0.371808,0.707325,0,"#ff7007"
3092363416,BBFaktoria,18,5,0,5,0.732999,0.617736,0.001946,"#5456a6"
3092370569,LucentiaRG,34,0,2,2,0.515109,0.433053,0.000486,"#ff0d69"
3092475844,Ugo_LP,49,0,2,2,0.454516,0.526812,0.000486,"#ff7007"
3092625556,RutasConflicto,38,1,0,1,0.554792,0.377961,0,"#662859"
3092730550,craibellesarts,22,1,1,2,0.617391,0.51547,0.000486,"#00e8b2"
3093787653,_murilocalmon,36,0,2,2,0.435611,0.325945,0.000486,"#825403"
3094057402,laboescapes,35,0,2,2,0.515438,0.337201,0.000486,"#00faff"
3094448512,fontegaiablog,30,0,1,1,0.607723,0.568669,0,"#ff77ff"
3094874483,OIM_Argentina,49,1,0,1,0.361841,0.606558,0,"#ff7007"
3095030075,ORIENS_Cultura,37,1,2,3,0.632965,0.411248,0.000973,"#006032"
3096320050,_DanielMad_,37,0,1,1,0.685369,0.499153,0,"#006032"
3096330765,extradigital_es,22,1,1,2,0.683378,0.750498,0.000486,"#00e8b2"
3097902753,filoethics,0,0,1,1,0.378789,0.562448,0,"#8ecfec"
3098000297,belsaisalamanca,58,0,2,2,0.483918,0.596791,0.000486,"#005076"
3098808982,unedbizkaia,30,0,2,2,0.517894,0.604253,0.000486,"#ff77ff"
3099644601,rosagh55,58,0,2,2,0.496323,0.654961,0.000486,"#005076"
3100694827,ElaAgui,27,2,0,2,0.08613,0.680116,0.000486,"#7e8b76"
3101633938,garrilengua,58,0,2,2,0.51345,0.64869,0.000486,"#005076"
3102549544,requejo_alonso,22,1,4,5,0.502768,0.572878,0.001946,"#00e8b2"
3102896471,lu_munoz5,49,0,2,2,0.429606,0.540769,0.000486,"#ff7007"
3104468848,AVALEMeducacion,31,1,0,1,0.631561,0.483828,0,"#3e93ff"
3105932225,TransmediaTodo,3,0,1,1,0.469511,0.668476,0,"#ffb3ff"
3107240699,mrpl30,0,0,1,1,0.276524,0.497739,0,"#8ecfec"
3108587889,mcti,36,0,3,3,0.513591,0.353914,0.000973,"#825403"
3109331632,elfocoadn40,11,1,0,1,0.482905,0.030429,0,"#3a8724"
3110134010,slaboieserdtse,41,0,1,1,0.317763,0.397033,0,"#697b00"
3111348465,rawsonBPO,49,1,0,1,0.308617,0.654447,0,"#ff7007"
3111718693,Jorgenunezr_,49,0,1,1,0.361293,0.4665,0,"#ff7007"
3112987229,NodoRiesgo,21,0,1,1,0.789765,0.52558,0,"#c6cc85"
3115056317,urb_uc3m,13,1,0,1,0.391918,0.405336,0,"#3bec00"
3115223501,sofialomart,14,12,49,61,0.550941,0.526921,0.029183,"#00eeff"
3115572555,beatrizgonline,2,0,2,2,0.531353,0.60994,0.000486,"#ffa64e"
3115578750,a_laragranero,30,0,1,1,0.620186,0.610802,0,"#ff77ff"
3116898455,pazvilchezsm,21,0,2,2,0.239879,0.231122,0.000486,"#c6cc85"
3118068527,FCSIGLOXVIII,31,0,1,1,0.471134,0.646097,0,"#3e93ff"
3118119526,Oscar_Alb9,30,0,2,2,0.520432,0.642959,0.000486,"#ff77ff"
3118233023,emili0calder0n,13,6,4,10,0.551971,0.431492,0.004377,"#3bec00"
3120794157,formacionUSAL,58,2,1,3,0.52422,0.598815,0.000973,"#005076"
3121232152,CaypmMoscone,30,0,1,1,0.483673,0.630638,0,"#ff77ff"
3121939925,Ronin_del_ayer,31,0,1,1,0.3987,0.302785,0,"#3e93ff"
3122003590,FuensantaMaximo,22,0,2,2,0.679907,0.733363,0.000486,"#00e8b2"
3122283251,bezdiario,0,11,2,13,0.610614,0.603174,0.005837,"#8ecfec"
3123752994,eltraderTristan,1,0,1,1,0.412453,0.618449,0,"#b6cb00"
3126132934,CursoFarmacia,30,0,1,1,0.527014,0.644259,0,"#ff77ff"
3127146880,jpmcsherry,49,1,0,1,0.31099,0.624159,0,"#ff7007"
3128435892,etnoceno,41,0,1,1,0.333827,0.373014,0,"#697b00"
3128714193,JFI_UR,30,2,7,9,0.522937,0.571537,0.003891,"#ff77ff"
3128867417,GIPES_UAM,37,1,0,1,0.657978,0.499234,0,"#006032"
3129768538,Tele13_Radio,21,13,2,15,0.306235,0.323828,0.006809,"#c6cc85"
3129904239,xwangfra,49,1,0,1,0.380379,0.653733,0,"#ff7007"
3130628020,sksarqueopatri,2,0,2,2,0.688749,0.666251,0.000486,"#ffa64e"
3130806099,FestivalArtTec,34,1,2,3,0.546858,0.341672,0.000973,"#ff0d69"
3131067772,babel_imago,42,3,1,4,0.710408,0.523962,0.001459,"#66e087"
3131157772,WazoMagazine,42,0,3,3,0.69453,0.517594,0.000973,"#66e087"
3131166940,EHRC_Centre,1,0,2,2,0.455112,0.705646,0.000486,"#b6cb00"
3131330961,HenryLiu_FIT,36,0,1,1,0.571371,0.397541,0,"#825403"
3131646275,sepidehabl,38,1,0,1,0.692744,0.47945,0,"#662859"
3132054384,1stworldchicano,34,0,1,1,0.309627,0.421526,0,"#ff0d69"
3133107355,iadigbridge,49,0,1,1,0.391598,0.528424,0,"#ff7007"
3133737930,monicatrece13,13,0,2,2,0.457061,0.358903,0.000486,"#3bec00"
3135482320,WStrohmacher,14,0,1,1,0.466384,0.731244,0,"#00eeff"
3138515648,eandresot,49,0,1,1,0.394187,0.412163,0,"#ff7007"
3141030833,TrainerParalimp,0,0,1,1,0.371004,0.549598,0,"#8ecfec"
3141896201,clasicasmc,22,0,1,1,0.519749,0.674349,0,"#00e8b2"
3143096086,UGRinvestiga,31,11,5,16,0.569286,0.53918,0.007296,"#3e93ff"
3147288755,antropobattist,0,0,2,2,0.448031,0.388111,0.000486,"#8ecfec"
3147338408,Ipatrimoni,30,0,1,1,0.516534,0.622053,0,"#ff77ff"
3148168101,MJorgeCP,37,0,1,1,0.376412,0.318312,0,"#006032"
3149339158,almamay107,3,0,1,1,0.698636,0.659372,0,"#ffb3ff"
3149439049,ehe_csf,10,0,2,2,0.370883,0.521567,0.000486,"#52d7c0"
3150179949,Physalisperuvi,38,0,2,2,0.491181,0.38273,0.000486,"#662859"
3151634639,lasinsombrero,31,0,7,7,0.590021,0.537432,0.002918,"#3e93ff"
3151876308,HostosBot,34,3,0,3,0.319115,0.474283,0.000973,"#ff0d69"
3152005939,EzerMay,34,0,7,7,0.580482,0.395777,0.002918,"#ff0d69"
3152875756,Javi_Aceituno,30,0,2,2,0.526719,0.601982,0.000486,"#ff77ff"
3153423232,TradElena,13,0,1,1,0.387257,0.496082,0,"#3bec00"
3153514524,PalaciosMox,7,0,2,2,0.413899,0.36309,0.000486,"#ffb800"
3153574948,claraimcanton,13,98,21,119,0.481053,0.51689,0.057393,"#3bec00"
3156746541,VekaDuncan,37,0,1,1,0.46469,0.201224,0,"#006032"
3157193939,carmen30627207,49,2,0,2,0.399568,0.56871,0.000486,"#ff7007"
3157316962,JorgeRiechmann,37,0,1,1,0.689013,0.49824,0,"#006032"
3158113427,MVDNOpod,37,0,2,2,0.667853,0.370703,0.000486,"#006032"
3158210782,dobcast,37,1,4,5,0.685661,0.386159,0.001946,"#006032"
3159127752,XVilaltaV,8,1,0,1,0.664008,0.241643,0,"#00ed5d"
3159411629,S_Pardini,58,0,2,2,0.612589,0.305611,0.000486,"#005076"
3159593327,FPF_Granada,30,0,1,1,0.632733,0.60575,0,"#ff77ff"
3163357546,ImaginarqGC,30,0,1,1,0.5849,0.655305,0,"#ff77ff"
3164635119,edsonaplim,36,0,1,1,0.492562,0.215857,0,"#825403"
3164649537,EcoSyllaba,13,2,0,2,0.411606,0.31805,0.000486,"#3bec00"
3165549027,Laurairiarte11,8,0,2,2,0.465125,0.494483,0.000486,"#00ed5d"
3167046794,corderodaniel7,13,0,7,7,0.51326,0.495096,0.002918,"#3bec00"
3168670271,maguiar_aguiar,14,0,2,2,0.620873,0.679801,0.000486,"#00eeff"
3169246399,litexperimenta,42,0,2,2,0.691361,0.433729,0.000486,"#66e087"
3169395075,guiagoleon,37,0,3,3,0.560333,0.669861,0.000973,"#006032"
3169618368,jefvelmen,38,0,1,1,0.437649,0.759717,0,"#662859"
3170472916,nicogorellana,31,0,5,5,0.605863,0.536921,0.001946,"#3e93ff"
3170717075,veronica_IamVR,14,4,2,6,0.447281,0.561986,0.002432,"#00eeff"
3171179267,PersDig_UMD,36,0,1,1,0.382892,0.484606,0,"#825403"
3171889221,GuerraParaguay,49,2,0,2,0.335203,0.53044,0.000486,"#ff7007"
3172430465,Papel_EM,30,1,0,1,0.530099,0.69169,0,"#ff77ff"
3175561288,gregoriorohe,30,12,21,33,0.563065,0.56843,0.015564,"#ff77ff"
3176158997,segui_virginia,8,0,1,1,0.295216,0.259765,0,"#00ed5d"
3176932746,ChicanosUEdCtte,34,0,2,2,0.34662,0.396769,0.000486,"#ff0d69"
3177611242,InnoYachayTech,37,0,1,1,0.619446,0.436812,0,"#006032"
3178140916,CORE_Ciutats,14,0,1,1,0.531431,0.666605,0,"#00eeff"
3180697091,eltrinodeemiro,38,0,1,1,0.698438,0.397183,0,"#662859"
3180752696,LatinosCasa,41,0,1,1,0.368297,0.398385,0,"#697b00"
3181066736,ColoquioAD,14,0,1,1,0.583708,0.486533,0,"#00eeff"
3181305728,justin08lg2,7,0,2,2,0.423891,0.358267,0.000486,"#ffb800"
3182238212,CnbcharlysNarbo,49,1,0,1,0.35558,0.646928,0,"#ff7007"
3183228267,paramnesico,13,0,2,2,0.487856,0.417128,0.000486,"#3bec00"
3183323531,amandamarque_,36,1,1,2,0.497469,0.3431,0.000486,"#825403"
3183776206,mohe_juda,34,0,2,2,0.555304,0.397128,0.000486,"#ff0d69"
3184782281,bifzag,49,0,1,1,0.316484,0.298973,0,"#ff7007"
3186901951,StanfordCIDR,34,0,2,2,0.366276,0.407534,0.000486,"#ff0d69"
3189996368,Mazzu_MG,22,0,2,2,0.558545,0.513097,0.000486,"#00e8b2"
3192299411,FulviaReyes,13,0,4,4,0.522983,0.48581,0.001459,"#3bec00"
3192995555,Wind_Federick,38,0,1,1,0.40724,0.76571,0,"#662859"
3193000491,revistaassequor,13,0,2,2,0.463657,0.422144,0.000486,"#3bec00"
3193155035,miltonbarraza7,21,0,2,2,0.283933,0.238015,0.000486,"#c6cc85"
3193749349,cesar_macotela,14,0,2,2,0.56541,0.604603,0.000486,"#00eeff"
3193853016,roma_vaga,7,0,4,4,0.430425,0.400031,0.001459,"#ffb800"
3194022651,dariahTeach,36,1,2,3,0.428175,0.525783,0.000973,"#825403"
3194863402,digimaps,35,0,4,4,0.570706,0.460104,0.001459,"#00faff"
3195485187,UnivRoma3,14,14,0,14,0.53521,0.493932,0.006323,"#00eeff"
3196757360,LihitVeLo,13,0,3,3,0.561944,0.466747,0.000973,"#3bec00"
3196824540,aizpuru5,30,0,2,2,0.621689,0.667131,0.000486,"#ff77ff"
3197567868,soy_retuitero,46,0,1,1,0.503944,0.145527,0,"#403538"
3197569084,Hispana_roai,22,2,1,3,0.580753,0.549413,0.000973,"#00e8b2"
3198095872,AntjeTheise,36,0,1,1,0.438953,0.591035,0,"#825403"
3198162717,elbe67,21,0,2,2,0.251149,0.221699,0.000486,"#c6cc85"
3198848272,DroneSavannah,3,0,1,1,0.515198,0.76724,0,"#ffb3ff"
3202239393,MDoloresLG,31,0,3,3,0.591513,0.549653,0.000973,"#3e93ff"
3207220095,editorialpdp,49,1,0,1,0.400858,0.674811,0,"#ff7007"
3207614674,liliabarraganm1,7,0,1,1,0.35339,0.357417,0,"#ffb800"
3209949862,AprilHathcock,49,9,4,13,0.471555,0.512638,0.005837,"#ff7007"
3210554255,Papasquiaro,21,0,2,2,0.245958,0.243743,0.000486,"#c6cc85"
3213604691,ibelmontemarti1,8,0,1,1,0.297306,0.252111,0,"#00ed5d"
3214325267,CuartoReal,14,0,1,1,0.68084,0.576475,0,"#00eeff"
3214390049,SORAAADWorkshop,36,0,1,1,0.393261,0.467117,0,"#825403"
3214454176,CienciasUAM,22,2,1,3,0.627854,0.475354,0.000973,"#00e8b2"
3214518333,Editorial_UdeC,9,10,11,21,0.6606,0.582747,0.009728,"#008f7b"
3214673157,teresasantama19,14,9,0,9,0.512533,0.497632,0.003891,"#00eeff"
3215296155,LoveRescueMe_,13,0,1,1,0.408445,0.347086,0,"#3bec00"
3217750588,closacon,30,0,6,6,0.541098,0.566791,0.002432,"#ff77ff"
3220309544,LMaedas,17,0,1,1,0.726034,0.811949,0,"#ff9cc7"
3220839277,abiskzt,41,0,2,2,0.387716,0.398999,0.000486,"#697b00"
3221290599,IberianBooks,14,1,8,9,0.5094,0.549715,0.003891,"#00eeff"
3221369231,cveladelfa,30,4,2,6,0.473155,0.573863,0.002432,"#ff77ff"
3221374863,Lara_Anes,31,8,7,15,0.574393,0.544364,0.006809,"#3e93ff"
3221730864,SamuraiGlam,13,1,3,4,0.467157,0.443913,0.001459,"#3bec00"
3222208545,ErasmusPlus_pro,15,1,1,2,0.716589,0.621437,0.000486,"#008ebb"
3222572460,angelpazoslopez,30,0,2,2,0.561616,0.704229,0.000486,"#ff77ff"
3222850370,AI_Scientist,14,0,1,1,0.677553,0.514783,0,"#00eeff"
3223966961,magnet_es,30,9,0,9,0.521189,0.61207,0.003891,"#ff77ff"
3223970653,VazroMar,7,0,2,2,0.740936,0.346441,0.000486,"#ffb800"
3224523978,Constantinormzr,13,0,1,1,0.428838,0.346475,0,"#3bec00"
3225703616,rfchimal,13,3,24,27,0.484213,0.468887,0.012646,"#3bec00"
3226835529,YaleDHLab,36,0,2,2,0.465057,0.497831,0.000486,"#825403"
3226849096,Anamaortizvel,0,0,1,1,0.85521,0.444257,0,"#8ecfec"
3227166102,marioponcesv,7,1,0,1,0.786743,0.611998,0,"#ffb800"
3227700578,elsa_basurto,3,0,2,2,0.53088,0.597683,0.000486,"#ffb3ff"
3227761834,fernandapeset,37,1,0,1,0.37319,0.48427,0,"#006032"
3228994401,Karlarkhal,30,0,1,1,0.539012,0.717602,0,"#ff77ff"
3230839875,AiNogalesBocio,14,0,2,2,0.589145,0.594543,0.000486,"#00eeff"
3230916462,REHMLAC,7,1,1,2,0.493516,0.095066,0.000486,"#ffb800"
3230973777,Carla_Reigada,1,0,2,2,0.648352,0.449432,0.000486,"#b6cb00"
3231234658,MarinhaColorado,22,0,3,3,0.478031,0.594798,0.000973,"#00e8b2"
3232765964,htcvive,2,1,0,1,0.665101,0.4371,0,"#ffa64e"
3232991534,ontempomx,13,2,0,2,0.393447,0.328774,0.000486,"#3bec00"
3233517681,culturaresiste,3,0,1,1,0.292208,0.612931,0,"#ffb3ff"
3233658547,Podemos_DV,49,1,0,1,0.382223,0.681609,0,"#ff7007"
3233684702,Facultad_Artes,38,1,0,1,0.393841,0.362639,0,"#662859"
3233822067,majocerber,31,0,1,1,0.604434,0.727873,0,"#3e93ff"
3234065882,vergara240,49,1,0,1,0.373718,0.698933,0,"#ff7007"
3234331806,Naanadr,36,1,0,1,0.501761,0.247219,0,"#825403"
3235376655,silviarca15,19,0,1,1,0.735653,0.649908,0,"#00d3ff"
3235856481,CintiaLesc,49,1,0,1,0.383357,0.648707,0,"#ff7007"
3235937813,KFostano,34,0,2,2,0.486173,0.4103,0.000486,"#ff0d69"
3236329508,ritice,36,1,0,1,0.464831,0.335223,0,"#825403"
3236447207,lucho_van,34,0,1,1,0.326933,0.279175,0,"#ff0d69"
3237026549,LuzHunR,49,0,2,2,0.387298,0.377903,0.000486,"#ff7007"
3238235276,intsexual,27,0,2,2,0.264782,0.657307,0.000486,"#7e8b76"
3238306519,ProfEBH,14,1,0,1,0.423469,0.529827,0,"#00eeff"
3238712181,Silvia_Mendoza_,49,1,0,1,0.418895,0.668773,0,"#ff7007"
3238845820,SaletaSouto,14,0,5,5,0.503865,0.558645,0.001946,"#00eeff"
3238982254,almujime64,49,0,1,1,0.386522,0.613034,0,"#ff7007"
3239101852,TaniaFabrega,2,0,2,2,0.676638,0.66556,0.000486,"#ffa64e"
3239280275,elkioskolibros,34,0,1,1,0.580073,0.31066,0,"#ff0d69"
3239297787,EspanolAmerica,1,38,18,56,0.463742,0.567713,0.026751,"#b6cb00"
3239538556,CBuenafuentes,14,0,6,6,0.448046,0.60864,0.002432,"#00eeff"
3240194903,CiberiaProject,30,4,3,7,0.524076,0.559386,0.002918,"#ff77ff"
3240214492,pastorj68,0,0,1,1,0.430301,0.392218,0,"#8ecfec"
3240478252,iiif_io,36,8,0,8,0.470475,0.398546,0.003405,"#825403"
3241012517,boriarchivista,34,1,0,1,0.315094,0.375306,0,"#ff0d69"
3241416917,NSG148,49,0,7,7,0.43364,0.630349,0.002918,"#ff7007"
3242214569,MJ_Busta,34,1,0,1,0.481709,0.188418,0,"#ff0d69"
3242319882,RuizM_Giovanni,13,0,1,1,0.500307,0.312567,0,"#3bec00"
3242530032,1974RKAL,37,0,1,1,0.317084,0.312362,0,"#006032"
3242983998,socialistfactor,22,1,0,1,0.740301,0.207088,0,"#00e8b2"
3244101453,tcornejoc,30,0,1,1,0.485903,0.630086,0,"#ff77ff"
3245070616,angel_vinu,1,0,2,2,0.733133,0.56916,0.000486,"#b6cb00"
3245142196,GoogleNewsInit,36,4,0,4,0.772777,0.664954,0.001459,"#825403"
3245478089,andrecarneiro73,35,1,2,3,0.574243,0.456212,0.000973,"#00faff"
3245509360,mulet_csm,49,1,0,1,0.344406,0.695444,0,"#ff7007"
3245573235,ZarrMaria,49,1,0,1,0.37178,0.670905,0,"#ff7007"
3246159962,NoticiasEntreA,49,1,0,1,0.33356,0.663527,0,"#ff7007"
3246397575,s_biagetti,22,0,4,4,0.597749,0.616352,0.001459,"#00e8b2"
3247216894,tradubras,49,0,2,2,0.460376,0.590746,0.000486,"#ff7007"
3247802770,almaluzhb,49,0,2,2,0.45924,0.594483,0.000486,"#ff7007"
3248225023,BarreraArmand,7,0,2,2,0.425026,0.362849,0.000486,"#ffb800"
3248502827,bibliocasapatin,30,0,1,1,0.883376,0.535542,0,"#ff77ff"
3248699741,bibliodominica,21,0,2,2,0.215456,0.264969,0.000486,"#c6cc85"
3248867849,elbarroquista,14,2,3,5,0.55,0.553828,0.001946,"#00eeff"
3251191977,MLAUIBARRA,49,0,1,1,0.439561,0.690094,0,"#ff7007"
3251788049,FacuNicolelli,49,1,0,1,0.405701,0.694115,0,"#ff7007"
3252782303,LizNor71,3,0,1,1,0.451253,0.661885,0,"#ffb3ff"
3252915245,BibliotecaUNLZ,49,0,3,3,0.41888,0.595669,0.000973,"#ff7007"
3253573432,HPoeticus,30,0,2,2,0.547075,0.598309,0.000486,"#ff77ff"
3254146311,PacoEscobar10,1,0,2,2,0.45534,0.61025,0.000486,"#b6cb00"
3254236435,larochecarmen,42,0,2,2,0.680535,0.434996,0.000486,"#66e087"
3254959285,JrLoCo29,13,0,1,1,0.39205,0.337379,0,"#3bec00"
3256115432,FrJuHeAl,4,0,1,1,0.856667,0.245166,0,"#f4c8cf"
3256156266,ayayax_,13,0,1,1,0.398051,0.420385,0,"#3bec00"
3257383873,Emilfz6r,30,0,4,4,0.522294,0.588095,0.001459,"#ff77ff"
3258350090,danibojorges,7,0,1,1,0.375374,0.297385,0,"#ffb800"
3260593633,LibsDH,13,0,4,4,0.439044,0.451203,0.001459,"#3bec00"
3261814737,RarasReales,49,1,0,1,0.375831,0.622145,0,"#ff7007"
3262311862,Legatus_XVIII,2,0,1,1,0.669435,0.38094,0,"#ffa64e"
3262774291,ViazcanV,7,0,7,7,0.450673,0.455156,0.002918,"#ffb800"
3263495716,aimeretmourir,14,0,9,9,0.400261,0.459354,0.003891,"#00eeff"
3264537088,rpalmodovar,40,0,1,1,0.627133,0.025802,0,"#ff12a3"
3266136757,Ale_Pensado,10,0,2,2,0.314115,0.479085,0.000486,"#52d7c0"
3267404466,SolucionNarus,49,1,0,1,0.344904,0.655082,0,"#ff7007"
3268435037,IHTP_CNRS,22,0,3,3,0.57851,0.528032,0.000973,"#00e8b2"
3268617852,TarikhAlMashriq,34,0,1,1,0.321867,0.431321,0,"#ff0d69"
3270876877,Topical_hq,49,1,0,1,0.45393,0.589898,0,"#ff7007"
3271549219,CPeriferia,13,2,0,2,0.426002,0.440095,0.000486,"#3bec00"
3272014476,silviamoraf56,49,1,0,1,0.331708,0.640144,0,"#ff7007"
3274634774,NallelyColin2,7,0,2,2,0.574062,0.400249,0.000486,"#ffb800"
3278787810,IieducaMid,7,10,5,15,0.510777,0.507841,0.006809,"#ffb800"
3280014502,hou2zi0,34,0,9,9,0.507296,0.498386,0.003891,"#ff0d69"
3280960146,TecReview,10,2,0,2,0.348295,0.578619,0.000486,"#52d7c0"
3286913882,R_interruptus,7,1,3,4,0.450835,0.387624,0.001459,"#ffb800"
3287093124,pulido_amalia,7,8,3,11,0.425727,0.371349,0.004864,"#ffb800"
3287817972,OlgaSaRa2003,7,0,1,1,0.818513,0.567796,0,"#ffb800"
3288131603,SemantiaLab,30,0,2,2,0.502861,0.599803,0.000486,"#ff77ff"
3288838071,69Lurdita,44,0,1,1,0.956326,0.626676,0,"#6c241e"
3290153999,andresagudelo00,13,0,3,3,0.510278,0.379958,0.000973,"#3bec00"
3290201727,fundacionceibal,31,3,1,4,0.628466,0.493111,0.001459,"#3e93ff"
3290276245,Betterplaceapp,49,1,0,1,0.417847,0.640191,0,"#ff7007"
3291340790,des_exilio,19,1,0,1,0.639637,0.767011,0,"#00d3ff"
3292765589,EduardAibar,1,1,1,2,0.49581,0.714527,0.000486,"#b6cb00"
3293011503,jana_malandra,7,0,2,2,0.426834,0.312857,0.000486,"#ffb800"
3293154697,caninomag,49,1,0,1,0.321386,0.624481,0,"#ff7007"
3293238906,PlumasDeSimurgh,22,0,1,1,0.572375,0.641555,0,"#00e8b2"
3294298223,ymassomebory,48,0,1,1,0.209561,0.709028,0,"#ff7a78"
3294307516,tlopezmelendez,49,3,0,3,0.286959,0.671405,0.000973,"#ff7007"
3295025194,CreandoIdeasMKT,49,1,0,1,0.354438,0.661948,0,"#ff7007"
3295656388,Rancagua_DGT,21,0,1,1,0.189257,0.227316,0,"#c6cc85"
3295669448,Arjuna57ypico,49,1,0,1,0.413548,0.657283,0,"#ff7007"
3297006959,edyestudioslite,14,6,5,11,0.536383,0.49629,0.004864,"#00eeff"
3297158122,GSindical,49,1,0,1,0.320538,0.647708,0,"#ff7007"
3297224112,FPsicologiaUAB,14,4,0,4,0.52821,0.484699,0.001459,"#00eeff"
3297670678,StefanoCartabia,49,1,0,1,0.35478,0.67035,0,"#ff7007"
3298047677,grupo_ned,49,1,0,1,0.304136,0.609303,0,"#ff7007"
3298782190,BeybiRomero,34,0,1,1,0.629771,0.326386,0,"#ff0d69"
3298973009,ArchivoUCLM,22,0,1,1,0.543187,0.792206,0,"#00e8b2"
3299157081,AMST_UNC,34,0,5,5,0.388469,0.433648,0.001946,"#ff0d69"
3299191719,ArchPabloromero,14,0,2,2,0.519226,0.484193,0.000486,"#00eeff"
3299683695,DavidOjedaJ,49,1,0,1,0.332213,0.65932,0,"#ff7007"
3299985153,MarioFloresRock,42,0,1,1,0.831497,0.463018,0,"#66e087"
3300370120,BibliotecaCAR,22,0,2,2,0.549302,0.629853,0.000486,"#00e8b2"
3300459346,Parthenos_EU,14,4,1,5,0.529104,0.617881,0.001946,"#00eeff"
3300501683,DefensoriaCba,49,1,0,1,0.328687,0.657708,0,"#ff7007"
3300836915,MariaNavarroVi,16,0,2,2,0.948949,0.674278,0.000486,"#c42c63"
3300842100,HistoriaFFyL,13,2,8,10,0.482576,0.443628,0.004377,"#3bec00"
3301020198,PSU_Ciencias,2,1,0,1,0.709565,0.679162,0,"#ffa64e"
3301761341,arobles1980,30,4,11,15,0.52784,0.558614,0.006809,"#ff77ff"
3301768225,CaliopeSrbhp,58,1,3,4,0.43845,0.546748,0.001459,"#005076"
3302209115,jramongh65,58,0,1,1,0.26143,0.567119,0,"#005076"
3302940479,CeipPepeDamaso,49,1,0,1,0.416948,0.678345,0,"#ff7007"
3302949690,PrismaSolCR,49,1,0,1,0.365951,0.642659,0,"#ff7007"
3303048915,DanielVissi,49,1,0,1,0.363408,0.6358,0,"#ff7007"
3303534884,socindiana,34,0,1,1,0.484159,0.372627,0,"#ff0d69"
3305040863,BibliosDigital,36,5,6,11,0.520806,0.537518,0.004864,"#825403"
3305361375,UNEDGirona,30,0,2,2,0.516314,0.605195,0.000486,"#ff77ff"
3305455523,ugtactivabcn,19,3,3,6,0.623692,0.748814,0.002432,"#00d3ff"
3305544495,AEUP_info,49,0,1,1,0.374084,0.524307,0,"#ff7007"
3305589582,Remembrance1974,41,0,1,1,0.346513,0.349671,0,"#697b00"
3305640970,Kalaidea,14,0,1,1,0.682026,0.512897,0,"#00eeff"
3306201767,YorkUComCult,13,0,3,3,0.434638,0.419292,0.000973,"#3bec00"
3306755548,OskarHermelo,40,0,1,1,0.584909,0.005452,0,"#ff12a3"
3307584629,MitzyQuinto,37,6,1,7,0.540851,0.37642,0.002918,"#006032"
3308329977,MTeatroAplicado,14,0,1,1,0.398437,0.536541,0,"#00eeff"
3309752983,7saltamontes,34,1,0,1,0.385113,0.31208,0,"#ff0d69"
3311790924,horizontesufrgs,36,1,1,2,0.528528,0.435739,0.000486,"#825403"
3312045686,sombrabarroca,14,0,2,2,0.511364,0.447589,0.000486,"#00eeff"
3312199949,mdportorequejo,0,0,1,1,0.391131,0.561892,0,"#8ecfec"
3313134689,javierrcasado,2,0,1,1,0.73768,0.521442,0,"#ffa64e"
3313646689,dvrv_unam,2,0,1,1,0.682999,0.676627,0,"#ffa64e"
3313756415,upsouniversidad,49,1,0,1,0.365592,0.667635,0,"#ff7007"
3313961901,Fcakeller,22,10,0,10,0.595008,0.558554,0.004377,"#00e8b2"
3314237314,caesarologia,7,0,2,2,0.39546,0.449603,0.000486,"#ffb800"
3314501024,PoetasHispanos,19,1,0,1,0.649372,0.767771,0,"#00d3ff"
3314690324,ValPulido,13,0,1,1,0.45293,0.376352,0,"#3bec00"
3315618027,CIALCUNAM,34,18,0,18,0.490051,0.348698,0.008268,"#ff0d69"
3315637402,SF78gogoan,19,0,1,1,0.631599,0.791241,0,"#00d3ff"
3315925439,UNIVERSIDAD_PMA,49,7,0,7,0.128757,0.627978,0.002918,"#ff7007"
3316000343,mariahecoz,7,0,1,1,0.846042,0.549108,0,"#ffb800"
3316332683,JesusPakomagis,38,0,2,2,0.569042,0.435988,0.000486,"#662859"
3316385312,PresentHistoria,19,2,0,2,0.543088,0.602074,0.000486,"#00d3ff"
3317040702,designthinkbot,38,0,1,1,0.54912,0.402452,0,"#662859"
3317061802,sscollantes,19,1,0,1,0.614492,0.779793,0,"#00d3ff"
3317407390,caroblanco658,3,2,0,2,0.440358,0.657467,0.000486,"#ffb3ff"
3317512822,ESFRI_eu,30,1,0,1,0.506323,0.65443,0,"#ff77ff"
3318679971,RedAlfaNeuro,49,1,0,1,0.374559,0.66921,0,"#ff7007"
3318757372,PalmeiroRicardo,0,0,8,8,0.504827,0.512234,0.003405,"#8ecfec"
3319485920,VicioNez,34,0,5,5,0.51594,0.398135,0.001946,"#ff0d69"
3320615490,adncentella,7,0,3,3,0.441794,0.374702,0.000973,"#ffb800"
3321274065,adelaidaavilac,35,0,1,1,0.557027,0.258507,0,"#00faff"
3321403144,IrisJhoselin,7,0,1,1,0.426048,0.324092,0,"#ffb800"
3321630349,AMDETIC,17,0,1,1,0.621876,0.270458,0,"#ff9cc7"
3321682751,mara_fuertes_,1,1,2,3,0.411577,0.704893,0.000973,"#b6cb00"
3322310926,patriciaslisboa,48,0,1,1,0.272707,0.531551,0,"#ff7a78"
3322779765,evanlitsa,30,0,1,1,0.498307,0.634529,0,"#ff77ff"
3323617918,Denes_Harai,30,0,2,2,0.667702,0.61411,0.000486,"#ff77ff"
3324076575,Corvinusmathias,30,0,1,1,0.530396,0.626581,0,"#ff77ff"
3326046591,RepFederalChile,49,0,1,1,0.30357,0.752688,0,"#ff7007"
3326420129,CARTIFCT,0,0,2,2,0.304993,0.577327,0.000486,"#8ecfec"
3327211619,mnievesggz,8,0,1,1,0.245904,0.269342,0,"#00ed5d"
3327394725,jivan_rodri,30,0,9,9,0.547829,0.585349,0.003891,"#ff77ff"
3327800003,ORioAntigo,36,0,1,1,0.565781,0.285074,0,"#825403"
3329407864,PhilobiblionUAM,14,0,2,2,0.537876,0.545729,0.000486,"#00eeff"
3329463143,tonino_collado,38,0,1,1,0.116078,0.43346,0,"#662859"
3330050537,SorianoCarotM,49,1,1,2,0.293814,0.421102,0.000486,"#ff7007"
3330258670,ThisIsAsun,40,0,1,1,0.594533,0.023194,0,"#ff12a3"
3330790222,salmo126sion,38,0,1,1,0.46831,0.79181,0,"#662859"
3331240983,PennPriceLab,36,2,0,2,0.470305,0.405192,0.000486,"#825403"
3331544885,ohjojbb,40,0,1,1,0.634562,0.021274,0,"#ff12a3"
3331795989,aurosgart,22,0,5,5,0.635689,0.606852,0.001946,"#00e8b2"
3332321476,roboteducativa,30,0,1,1,0.489418,0.628814,0,"#ff77ff"
3332397178,mundobtc,49,1,0,1,0.335983,0.6285,0,"#ff7007"
3332893276,edufern1,7,0,2,2,0.525873,0.583577,0.000486,"#ffb800"
3333464687,OEA_parlamentos,49,1,0,1,0.372719,0.624609,0,"#ff7007"
3333781205,Marcelagp2,21,0,3,3,0.310977,0.346803,0.000973,"#c6cc85"
3335748125,galodeluta,36,2,0,2,0.465878,0.297204,0.000486,"#825403"
3338545589,hiberniansoldir,30,0,2,2,0.574689,0.654688,0.000486,"#ff77ff"
3339525730,encompaniaradio,49,1,0,1,0.349908,0.667303,0,"#ff7007"
3339672256,Silvia_Senz,30,0,1,1,0.537506,0.734404,0,"#ff77ff"
3340162413,ffierrosilva,21,0,1,1,0.213657,0.226455,0,"#c6cc85"
3340226068,maltonaga9,22,0,1,1,0.385485,0.587744,0,"#00e8b2"
3340469944,equilateral_es,49,2,0,2,0.439375,0.586049,0.000486,"#ff7007"
3341067341,Nova_Ciencia,31,11,0,11,0.523708,0.527811,0.004864,"#3e93ff"
3341654205,Xose_rm,8,0,19,19,0.587201,0.440872,0.008755,"#00ed5d"
3341942717,R_vanGrieken,2,0,2,2,0.654326,0.716969,0.000486,"#ffa64e"
3342588845,jmlegorburu,2,0,7,7,0.492545,0.559221,0.002918,"#ffa64e"
3343087815,Exploratoriomde,9,0,1,1,0.733295,0.631771,0,"#008f7b"
3343464916,Laura_cruzd,40,1,1,2,0.369254,0.222963,0.000486,"#ff12a3"
3343584833,AndiherrerS,38,0,1,1,0.328751,0.191745,0,"#662859"
3344032798,nataliacosan,38,0,1,1,0.357157,0.188275,0,"#662859"
3345174567,icreacommunity,14,1,0,1,0.729069,0.484906,0,"#00eeff"
3345762833,TechGuerrero,13,0,1,1,0.584492,0.407988,0,"#3bec00"
3345826191,Chilescucha,21,0,2,2,0.231177,0.241944,0.000486,"#c6cc85"
3345915310,templedsc,34,0,2,2,0.382588,0.460422,0.000486,"#ff0d69"
3346480329,VLIRUOS,15,1,0,1,0.556986,0.647802,0,"#008ebb"
3347317054,masonantioquia,49,1,0,1,0.438355,0.681385,0,"#ff7007"
3347390745,Ladeira_Atios,30,0,1,1,0.483856,0.645656,0,"#ff77ff"
3351601533,Ponferradahoy,37,1,0,1,0.512838,0.743048,0,"#006032"
3352484765,Puro_Management,49,1,0,1,0.412227,0.633432,0,"#ff7007"
3353413523,SLISPuenteAN,28,0,1,1,0.890373,0.397895,0,"#cd5700"
3355209873,PadresLatinosUS,3,0,1,1,0.693446,0.645702,0,"#ffb3ff"
3355295909,adri_grr11,37,0,2,2,0.380066,0.412244,0.000486,"#006032"
3355305490,CreaDigitalCo,38,1,1,2,0.598102,0.382169,0.000486,"#662859"
3355322663,ursulaeggers,21,0,1,1,0.21518,0.201527,0,"#c6cc85"
3356052532,BigDataTweetBot,14,0,5,5,0.596614,0.522262,0.001946,"#00eeff"
3357835006,grupo9dhum,14,0,3,3,0.469875,0.503801,0.000973,"#00eeff"
3358047899,CarmenMPeinado,35,0,3,3,0.686024,0.425163,0.000973,"#00faff"
3359473612,generaltachin,24,0,2,2,0.283215,0.610734,0.000486,"#ff9b8f"
3360069226,madueno_juan,49,0,1,1,0.323114,0.767412,0,"#ff7007"
3360347807,bch_cl,21,0,2,2,0.217089,0.230588,0.000486,"#c6cc85"
3362419253,Galieno_Augusto,30,1,0,1,0.576474,0.645457,0,"#ff77ff"
3362653582,ChanoHernandez5,30,0,3,3,0.543807,0.6281,0.000973,"#ff77ff"
3363722367,rebracweb,36,0,7,7,0.508416,0.444121,0.002918,"#825403"
3364030991,MuseuDeLaFesta,30,0,1,1,0.466693,0.650766,0,"#ff77ff"
3364718511,SantiagoEximeno,38,0,1,1,0.822743,0.649099,0,"#662859"
3365598592,JornadasdeDoc,19,11,11,22,0.576792,0.601542,0.010214,"#00d3ff"
3366253096,dfarranz,0,7,5,12,0.52398,0.549769,0.00535,"#8ecfec"
3366489963,mab_us,34,0,1,1,0.477122,0.379271,0,"#ff0d69"
3366743860,dilee_lf,30,0,1,1,0.604069,0.675121,0,"#ff77ff"
3368506558,criticavulgar,37,1,1,2,0.619506,0.374823,0.000486,"#006032"
3369086680,susanahdezr,15,3,3,6,0.502821,0.585872,0.002432,"#008ebb"
3369928678,antorodrial,58,0,2,2,0.470408,0.596501,0.000486,"#005076"
3370861935,Macrespopz,8,1,1,2,0.801234,0.197309,0.000486,"#00ed5d"
3371648573,Neogranadina_es,34,102,16,118,0.518003,0.421525,0.056907,"#ff0d69"
3373608604,fdebasa,14,0,2,2,0.622232,0.630651,0.000486,"#00eeff"
3373689513,DataBeersMLG,14,5,6,11,0.564495,0.538639,0.004864,"#00eeff"
3376793387,p3palazzo,36,0,9,9,0.509547,0.440326,0.003891,"#825403"
3377452318,bigdata_uned,30,0,9,9,0.501758,0.534177,0.003891,"#ff77ff"
3377459009,ibis_sevilla,22,0,1,1,0.660332,0.475643,0,"#00e8b2"
3378848170,LorenaLpzMdz,31,1,3,4,0.606089,0.485744,0.001459,"#3e93ff"
3379046265,PedagogyAmLitSt,34,0,5,5,0.443491,0.439061,0.001946,"#ff0d69"
3379532115,BrianJanchez,49,1,0,1,0.35973,0.62623,0,"#ff7007"
3379571247,mlazzaro57,22,0,1,1,0.67806,0.571163,0,"#00e8b2"
3380204009,CONICETMendoza,49,1,0,1,0.380241,0.64553,0,"#ff7007"
3380611577,JMonkeyMind,30,0,1,1,0.586777,0.597965,0,"#ff77ff"
3380641875,MyLMadrid,19,2,0,2,0.641446,0.749371,0.000486,"#00d3ff"
3381546131,momentoDG,49,1,0,1,0.381355,0.649231,0,"#ff7007"
3382006113,LolaOrtizSanch2,49,1,0,1,0.370422,0.675331,0,"#ff7007"
3382715824,investigarCUC,7,0,4,4,0.415949,0.403709,0.001459,"#ffb800"
3382958831,eva_daskala,31,0,1,1,0.63476,0.589007,0,"#3e93ff"
3383146937,gunde_bravo,19,2,5,7,0.567217,0.620191,0.002918,"#00d3ff"
3384401735,masterhccc,55,0,1,1,0.656264,0.673061,0,"#cb3f32"
3384804742,ohara_j,36,0,5,5,0.524647,0.400655,0.001946,"#825403"
3387195124,JohnEmprende,37,0,2,2,0.578679,0.337178,0.000486,"#006032"
3388784469,lingwars,37,25,11,36,0.474643,0.548015,0.017023,"#006032"
3388805573,dh2016krakow,2,20,0,20,0.480968,0.562529,0.009241,"#ffa64e"
3389486200,FundacionBBVA,22,207,24,231,0.588961,0.494688,0.111868,"#00e8b2"
3389659401,LuijeFdezGda,31,0,1,1,0.784671,0.281869,0,"#3e93ff"
3389943340,ScbtDat,49,1,0,1,0.377883,0.659222,0,"#ff7007"
3391643320,EtrapGoettingen,30,0,2,2,0.508151,0.595252,0.000486,"#ff77ff"
3391897030,promocionLibros,30,3,0,3,0.672395,0.615955,0.000973,"#ff77ff"
3393048155,MarcoRojasA,49,1,0,1,0.321573,0.616144,0,"#ff7007"
3393719411,KNAWHuC,49,1,0,1,0.362668,0.567691,0,"#ff7007"
3394968922,dianazabalap,38,0,1,1,0.337767,0.182957,0,"#662859"
3395795027,SDocumentalista,22,7,12,19,0.555885,0.575506,0.008755,"#00e8b2"
3396160997,NexoJornal,36,2,0,2,0.472184,0.404539,0.000486,"#825403"
3396866199,fdnc_es,30,1,0,1,0.543032,0.627103,0,"#ff77ff"
3396966214,La_CriCri_Ashe,31,0,2,2,0.721407,0.467277,0.000486,"#3e93ff"
3397100459,learnRDM,13,1,0,1,0.404572,0.405233,0,"#3bec00"
3398586134,facaravantes,38,0,1,1,0.550305,0.402233,0,"#662859"
3398737661,muysccubun,13,1,0,1,0.425795,0.495304,0,"#3bec00"
3398901891,Exhibitium1,14,45,88,133,0.524929,0.536248,0.064202,"#00eeff"
3399251104,SuWayar,49,0,3,3,0.442266,0.609976,0.000973,"#ff7007"
3399366412,rafacamu,31,0,2,2,0.602605,0.500147,0.000486,"#3e93ff"
3399901059,teorhistoria,49,0,2,2,0.518125,0.654116,0.000486,"#ff7007"
3400844255,jorgeasuarezz,37,1,0,1,0.565205,0.369672,0,"#006032"
3402616210,AGCinformatica,30,0,3,3,0.554872,0.562246,0.000973,"#ff77ff"
3404899019,encuentrmemoria,19,1,0,1,0.600758,0.778269,0,"#00d3ff"
3405054083,jortamasan,38,0,1,1,0.670324,0.456282,0,"#662859"
3405454101,DataAndAnalytic,3,0,1,1,0.596321,0.72053,0,"#ffb3ff"
3406936972,AraMtnezEsteban,15,0,1,1,0.599311,0.633063,0,"#008ebb"
3407124952,t_s_institute,36,1,0,1,0.581292,0.428334,0,"#825403"
3409150158,PoliticasUAEMex,41,3,0,3,0.352542,0.372698,0.000973,"#697b00"
3409233591,scolopendragon,38,0,2,2,0.700751,0.577499,0.000486,"#662859"
3409501311,TheRealKonradix,21,0,1,1,0.210421,0.227137,0,"#c6cc85"
3410059392,upn211,27,1,4,5,0.118348,0.677221,0.001946,"#7e8b76"
3411453291,FranciscoUrdin,37,1,0,1,0.410709,0.260162,0,"#006032"
3412844729,eneroman_nora,49,0,2,2,0.452452,0.685646,0.000486,"#ff7007"
3412900990,westernuModLang,13,1,0,1,0.709012,0.506191,0,"#3bec00"
3415634967,ivan_epm,49,1,0,1,0.402777,0.648234,0,"#ff7007"
3415787175,_digitalhouse,49,1,0,1,0.392862,0.527043,0,"#ff7007"
3421199380,FranchescaKlase,0,0,1,1,0.537902,0.403973,0,"#8ecfec"
3421467329,cam_g02,38,0,1,1,0.67422,0.466235,0,"#662859"
3422205286,OrgIrf,36,0,1,1,0.435813,0.588339,0,"#825403"
3422883623,_n4rr34n6_,37,0,1,1,0.493943,0.707685,0,"#006032"
3423248579,furtadomarialau,49,0,2,2,0.375543,0.598001,0.000486,"#ff7007"
3426101044,dparejo_,40,0,2,2,0.087836,0.406897,0.000486,"#ff12a3"
3427927397,elgallonostrum,30,0,1,1,0.498396,0.626008,0,"#ff77ff"
3428278995,Thiago27daCosta,34,0,3,3,0.502736,0.392399,0.000973,"#ff0d69"
3430521951,bahia_esperanza,49,1,0,1,0.315084,0.616418,0,"#ff7007"
3430736811,lanzavicosa,36,0,2,2,0.507342,0.249082,0.000486,"#825403"
3431005967,caicyt,49,85,49,134,0.448092,0.545076,0.064689,"#ff7007"
3432241037,habemuseos,14,0,2,2,0.571937,0.57113,0.000486,"#00eeff"
3432611499,MujeresTech,30,3,3,6,0.56089,0.629693,0.002432,"#ff77ff"
3433127842,JohisRamirez10,29,0,1,1,0.348418,0.156925,0,"#1fab00"
3434373933,LizbethDresden,13,0,1,1,0.461838,0.392209,0,"#3bec00"
3435049343,kingmob84,49,0,1,1,0.292148,0.591257,0,"#ff7007"
3436070188,csdhschn,36,4,2,6,0.493568,0.456175,0.002432,"#825403"
3436673703,epalacios_cobos,13,0,1,1,0.408531,0.430774,0,"#3bec00"
3437078145,MarielaAsnes,41,0,1,1,0.335578,0.380193,0,"#697b00"
3437217881,yeneration360,14,1,0,1,0.676226,0.528595,0,"#00eeff"
3437797828,bequiztest,30,0,1,1,0.516862,0.630534,0,"#ff77ff"
3437798182,henar_leon_,49,1,1,2,0.482089,0.601453,0.000486,"#ff7007"
3438092417,mrtcaro,14,0,1,1,0.563775,0.450522,0,"#00eeff"
3439069241,vidaenportadas,21,0,2,2,0.225999,0.240039,0.000486,"#c6cc85"
3445868115,Vicomtech,0,1,1,2,0.452491,0.600893,0.000486,"#8ecfec"
3452208673,litElat,34,2,0,2,0.440828,0.517591,0.000486,"#ff0d69"
3452549602,LorenaJiles,21,0,1,1,0.235717,0.205497,0,"#c6cc85"
3452624963,juanumbarila1,38,0,5,5,0.493644,0.463463,0.001946,"#662859"
3452948117,karl_jacoby,34,0,8,8,0.429083,0.466578,0.003405,"#ff0d69"
3456843617,QualitySC,49,1,0,1,0.31522,0.658879,0,"#ff7007"
3457257616,lorena_martin_c,49,1,0,1,0.385152,0.694361,0,"#ff7007"
3458422768,sergiocorchetee,40,0,1,1,0.577899,0.053171,0,"#ff12a3"
3462619217,Paz76Karola,56,0,1,1,0.372908,0.090925,0,"#384205"
3464490497,danielajaimesbo,42,1,0,1,0.784909,0.413872,0,"#66e087"
3475489514,Ssaucedo5050,7,19,7,26,0.435224,0.356967,0.01216,"#ffb800"
3482463675,CouplesTattos,49,1,0,1,0.28086,0.647632,0,"#ff7007"
3491862916,rutxigarcia,38,0,3,3,0.626396,0.585686,0.000973,"#662859"
3497018006,afsfolklorists,34,0,2,2,0.386945,0.448765,0.000486,"#ff0d69"
3498015324,Encuentro_Paz,13,0,1,1,0.416792,0.395866,0,"#3bec00"
3501494962,CLMpresDigital,15,0,2,2,0.603208,0.701812,0.000486,"#008ebb"
3502238717,PalabrasRevist,49,2,3,5,0.426449,0.520495,0.001946,"#ff7007"
3503016755,rdiaz2016,9,0,5,5,0.691583,0.663962,0.001946,"#008f7b"
3508896378,AlessaKirchhoff,13,1,4,5,0.525135,0.459822,0.001946,"#3bec00"
3510193694,SIPINNA_MX,7,0,1,1,0.407691,0.72769,0,"#ffb800"
3510957673,enderton_justin,49,0,1,1,0.33464,0.328261,0,"#ff7007"
3511992874,ViaTempli,22,0,2,2,0.54424,0.71097,0.000486,"#00e8b2"
3514008917,filosvarela,30,1,0,1,0.707739,0.645945,0,"#ff77ff"
3515138115,PoliticaUR,37,1,1,2,0.590509,0.396071,0.000486,"#006032"
3515642655,alvarezaldf,14,0,2,2,0.637739,0.533279,0.000486,"#00eeff"
3526131617,Conxiddom,30,0,1,1,0.500303,0.630088,0,"#ff77ff"
3531681023,ManuelO94119778,49,1,0,1,0.339338,0.679047,0,"#ff7007"
3534774975,KettyCardenas,49,1,0,1,0.386912,0.684796,0,"#ff7007"
3535637368,UnedSegovia,30,0,4,4,0.539919,0.575543,0.001459,"#ff77ff"
3536189356,_IUPLR,34,0,2,2,0.375327,0.400389,0.000486,"#ff0d69"
3541836257,Paula_Goros,14,0,1,1,0.679829,0.512658,0,"#00eeff"
3543038356,CUID_UNED,30,0,1,1,0.530395,0.622222,0,"#ff77ff"
3544856416,desafioSTEM,49,1,0,1,0.334542,0.659541,0,"#ff7007"
3544995912,geo_ggeeoo,17,0,1,1,0.842091,0.255074,0,"#ff9cc7"
3545755580,blue_suspire,37,0,1,1,0.44355,0.21493,0,"#006032"
3561415156,staticum,32,2,2,4,0.359568,0.462844,0.001459,"#00b1c7"
3567337655,DrPJLennon,30,0,1,1,0.622109,0.607539,0,"#ff77ff"
3568118183,UMinho_Oficial,55,17,0,17,0.547671,0.496174,0.007782,"#cb3f32"
3569477719,FCA_UAEMex,41,3,0,3,0.377617,0.405346,0.000973,"#697b00"
3574654576,GEFES_RSEF,22,0,1,1,0.656096,0.471618,0,"#00e8b2"
3575039713,Yaizaarturo1720,22,0,3,3,0.573266,0.54047,0.000973,"#00e8b2"
3579242183,FundConEspEEUU,19,1,0,1,0.63099,0.702351,0,"#00d3ff"
3584837897,monicanienor,37,0,1,1,0.710124,0.36882,0,"#006032"
3585759137,academiaplay,2,8,0,8,0.5213,0.531172,0.003405,"#ffa64e"
3586372212,bibnewsbr,36,0,4,4,0.587074,0.388848,0.001459,"#825403"
3588291557,mnievesvas,21,0,2,2,0.246249,0.238257,0.000486,"#c6cc85"
3588788961,CFCJournal,34,0,3,3,0.437225,0.248655,0.000973,"#ff0d69"
3589750635,cibarrachile,38,1,0,1,0.25637,0.107382,0,"#662859"
3593226981,jmalaia,13,0,1,1,0.497383,0.390008,0,"#3bec00"
3598102516,Dignitas_Vitae_,49,1,0,1,0.282844,0.624543,0,"#ff7007"
3598403055,Lutraepicurea,13,0,1,1,0.409277,0.48608,0,"#3bec00"
3598791503,rafahohr,0,0,3,3,0.448516,0.573379,0.000973,"#8ecfec"
3599065155,JoshuaEnslen,36,1,1,2,0.577491,0.413985,0.000486,"#825403"
3600594623,AlbaBachiller,30,0,3,3,0.553904,0.627514,0.000973,"#ff77ff"
3600750743,GobAbiertoLocal,49,0,3,3,0.438989,0.571429,0.000973,"#ff7007"
3606382284,adrianaXIX_XXI,41,0,1,1,0.260624,0.332883,0,"#697b00"
3607328361,sergimatse,8,0,1,1,0.736738,0.303005,0,"#00ed5d"
3608233993,SolDeZamora,49,1,0,1,0.351002,0.677514,0,"#ff7007"
3611174652,nenanikita,17,0,2,2,0.850511,0.313208,0.000486,"#ff9cc7"
3619228156,_KNHG,36,0,1,1,0.444024,0.598156,0,"#825403"
3630322344,EUxiyanglou,1,1,0,1,0.411391,0.606236,0,"#b6cb00"
3633272415,GsrobOficial,14,0,1,1,0.578375,0.588655,0,"#00eeff"
3639184992,SantiagoVicSaa,3,0,2,2,0.480244,0.59769,0.000486,"#ffb3ff"
3641785521,protoeuskaldun,22,0,3,3,0.559101,0.617909,0.000973,"#00e8b2"
3644026876,serlosan,33,12,0,12,0.310412,0.590205,0.00535,"#ff8c00"
3660076333,LupicatVega,7,0,3,3,0.438844,0.362136,0.000973,"#ffb800"
3662843174,HSufilon,19,0,1,1,0.665605,0.717644,0,"#00d3ff"
3662923709,sumaro76,1,0,2,2,0.470483,0.570308,0.000486,"#b6cb00"
3663176842,deustoNeuroLab,22,0,2,2,0.624096,0.395671,0.000486,"#00e8b2"
3665087116,_jojocchi,38,0,1,1,0.805035,0.643933,0,"#662859"
3665461755,unedlarioja,30,0,2,2,0.499423,0.605037,0.000486,"#ff77ff"
3666400636,rugamarspr,34,0,5,5,0.393509,0.433254,0.001946,"#ff0d69"
3667153643,IEPOA_UAB,37,1,0,1,0.626833,0.334802,0,"#006032"
3677120116,laraalonsosimon,30,0,1,1,0.609347,0.473861,0,"#ff77ff"
3677577617,mentoresftf,1,0,1,1,0.487644,0.610971,0,"#b6cb00"
3683793076,SocHistBlog,19,1,0,1,0.667678,0.761819,0,"#00d3ff"
3696703036,jcalvozaragoza,22,0,2,2,0.513609,0.686381,0.000486,"#00e8b2"
3697257017,silverpcweb,30,0,1,1,0.484715,0.637748,0,"#ff77ff"
3699733173,M_T_Miller,36,0,5,5,0.468625,0.447328,0.001946,"#825403"
3708281837,celesgalan64,30,0,2,2,0.601842,0.6368,0.000486,"#ff77ff"
3711209363,flavio52047265,49,1,0,1,0.376661,0.678656,0,"#ff7007"
3716202794,esauHV,13,0,1,1,0.398685,0.413826,0,"#3bec00"
3716729837,CarlosP_Casas,49,1,0,1,0.425405,0.657696,0,"#ff7007"
3727478476,diniekes,38,0,1,1,0.723353,0.521005,0,"#662859"
3731236215,Totestaagafat,49,1,0,1,0.379155,0.658652,0,"#ff7007"
3731574142,nucleoREA,55,1,3,4,0.61114,0.629178,0.001459,"#cb3f32"
3731741356,gayssss,49,1,0,1,0.376133,0.627634,0,"#ff7007"
3737540126,evillegasme,13,3,1,4,0.431349,0.283047,0.001459,"#3bec00"
3740455694,JavierM82514042,13,0,2,2,0.598996,0.483841,0.000486,"#3bec00"
3740754315,MediaLabUTPL,20,3,3,6,0.431033,0.19016,0.002432,"#f0be45"
3750559277,Estudiar_en_ES,31,0,2,2,0.641833,0.549832,0.000486,"#3e93ff"
3757185622,AAS_Sociologia,22,0,2,2,0.542033,0.3514,0.000486,"#00e8b2"
3759433037,BenjaminGalacho,14,7,3,10,0.60943,0.520573,0.004377,"#00eeff"
3759680835,bibrioja,30,0,2,2,0.522908,0.681254,0.000486,"#ff77ff"
3763750523,AmeGarces,7,0,2,2,0.423173,0.318077,0.000486,"#ffb800"
3763757255,MariaLuisaLoba1,14,3,0,3,0.487319,0.518337,0.000973,"#00eeff"
3769308447,Abulens_es,49,3,0,3,0.433285,0.548453,0.000973,"#ff7007"
3771789579,cientopolis,49,1,1,2,0.41413,0.529291,0.000486,"#ff7007"
3773726002,tarushijio,36,13,0,13,0.479098,0.202525,0.005837,"#825403"
3783241096,calvolandrea,31,0,1,1,0.59472,0.466056,0,"#3e93ff"
3783820877,yutkeej,13,0,2,2,0.464381,0.416056,0.000486,"#3bec00"
3784265182,yezidalejandro,34,0,7,7,0.49373,0.433237,0.002918,"#ff0d69"
3793875087,frankdegerton,30,0,1,1,0.525108,0.61956,0,"#ff77ff"
3794908993,ContrapuntoN,49,1,0,1,0.369487,0.661817,0,"#ff7007"
3801151648,CementerioLibro,19,4,47,51,0.639473,0.698634,0.024319,"#00d3ff"
3805130777,brillomucho2004,22,0,1,1,0.610391,0.593078,0,"#00e8b2"
3805608629,LeraKormysh,36,0,2,2,0.824375,0.285292,0.000486,"#825403"
3808295716,As94Dani,30,0,7,7,0.544617,0.602147,0.002918,"#ff77ff"
3813872296,Filosocine,49,2,0,2,0.410551,0.574709,0.000486,"#ff7007"
3814439483,nuriapolocano,30,0,3,3,0.505434,0.633034,0.000973,"#ff77ff"
3815616209,hpmacd,0,1,0,1,0.531286,0.405536,0,"#8ecfec"
3817111573,BTKUH,22,0,1,1,0.588856,0.627537,0,"#00e8b2"
3818107401,AnuarioHistoria,38,0,2,2,0.5902,0.380112,0.000486,"#662859"
3818802317,BeatrizGdelcamp,49,3,0,3,0.441515,0.577919,0.000973,"#ff7007"
3819123380,netgov_mx,13,0,2,2,0.487161,0.389589,0.000486,"#3bec00"
3820089015,wtflmjauregui,49,0,1,1,0.622954,0.281656,0,"#ff7007"
3821606537,ImagesEchappees,30,0,1,1,0.589504,0.675387,0,"#ff77ff"
3823025987,PolitikaEHU,37,0,2,2,0.683746,0.510065,0.000486,"#006032"
3825053357,UGR_Igualdad,31,0,4,4,0.620602,0.544049,0.001459,"#3e93ff"
3832026569,marcbeldata,30,1,0,1,0.614316,0.438305,0,"#ff77ff"
3832226723,AtlasLitterae,31,4,0,4,0.602969,0.505306,0.001459,"#3e93ff"
3832738877,ALUMNI_FGH,30,0,3,3,0.554151,0.606762,0.000973,"#ff77ff"
3837147923,ortografia_la,2,0,2,2,0.555706,0.644787,0.000486,"#ffa64e"
3837784072,antorcharadioad,49,1,0,1,0.337142,0.624718,0,"#ff7007"
3841365562,PedroUrbano79,36,2,2,4,0.538293,0.455999,0.001459,"#825403"
3841576157,carga_viral,22,0,4,4,0.611657,0.423494,0.001459,"#00e8b2"
3842408127,Jurymed_Gr,31,0,1,1,0.662205,0.551765,0,"#3e93ff"
3846121810,encuentrosucm,22,1,1,2,0.48698,0.633366,0.000486,"#00e8b2"
3853619363,maytebaixeras,45,0,2,2,0.670367,0.190309,0.000486,"#00e8ff"
3854625568,sonia_montecino,21,0,1,1,0.054284,0.646681,0,"#c6cc85"
3869175569,carolinatorrebl,16,0,3,3,0.91993,0.658831,0.000973,"#c42c63"
3871329195,CeliaDescalzo,58,0,1,1,0.605592,0.275182,0,"#005076"
3871826339,CokoFoundation,49,1,0,1,0.371087,0.531613,0,"#ff7007"
3872785545,pipedrive75,21,0,2,2,0.273998,0.230185,0.000486,"#c6cc85"
3873033027,VARjournal,30,0,1,1,0.299664,0.549973,0,"#ff77ff"
3873406753,Cris_qpro,49,0,1,1,0.422268,0.738981,0,"#ff7007"
3873471269,WikimediaEdu,31,0,1,1,0.633312,0.528227,0,"#3e93ff"
3873761177,spanportuoft,36,0,1,1,0.68624,0.442308,0,"#825403"
3873869717,pdanimalista,49,1,0,1,0.378433,0.673096,0,"#ff7007"
3874106183,majodominguez13,55,3,9,12,0.606748,0.452254,0.00535,"#cb3f32"
3874571656,LSE_LACC,34,0,1,1,0.559464,0.230111,0,"#ff0d69"
3879371157,peregrina_babel,30,1,14,15,0.45368,0.538578,0.006809,"#ff77ff"
3879544719,DisenoAna,49,1,0,1,0.346224,0.668512,0,"#ff7007"
3883068573,ArcheoAndrea,42,19,6,25,0.671172,0.503729,0.011673,"#66e087"
3883188614,hvrodo,17,0,1,1,0.718667,0.809907,0,"#ff9cc7"
3884697563,Fidescba,49,1,0,1,0.386718,0.702647,0,"#ff7007"
3888891988,ArquimAcademia,30,0,1,1,0.543352,0.640479,0,"#ff77ff"
3891160775,Equipe_ObTIC,30,0,3,3,0.463236,0.54709,0.000973,"#ff77ff"
3898454296,enetreseles,34,1,5,6,0.466356,0.459884,0.002432,"#ff0d69"
3901301121,bepadgil,30,0,1,1,0.57502,0.537472,0,"#ff77ff"
3904253233,BlanquernaFPCEE,49,1,0,1,0.33924,0.622328,0,"#ff7007"
3904262846,karbartolome,37,0,1,1,0.240729,0.425813,0,"#006032"
3905595133,archachiqui2,30,0,2,2,0.596814,0.633983,0.000486,"#ff77ff"
3908222476,PCEGuadalajara,19,1,0,1,0.690375,0.758111,0,"#00d3ff"
3908791276,paulammartinez2,49,0,1,1,0.349008,0.490548,0,"#ff7007"
3909522742,Catedra_CYDR,15,0,2,2,0.568861,0.565718,0.000486,"#008ebb"
3912294916,gmbastos_br,36,0,1,1,0.592001,0.282742,0,"#825403"
3913833678,yohannis_marti,31,3,0,3,0.553952,0.459944,0.000973,"#3e93ff"
3915404299,marika_louise,13,0,1,1,0.35628,0.44592,0,"#3bec00"
3920089714,ocbrid,49,0,1,1,0.339853,0.462523,0,"#ff7007"
3923998883,dianaca91628885,30,0,1,1,0.581312,0.469307,0,"#ff77ff"
3924085823,mcjuancito,34,0,2,2,0.359769,0.421385,0.000486,"#ff0d69"
3926999354,abogadhillo,0,0,2,2,0.454419,0.385575,0.000486,"#8ecfec"
3933956068,golondrinazul03,40,0,1,1,0.59367,0.026462,0,"#ff12a3"
3935729837,IEMYRhd,58,38,13,51,0.483804,0.565657,0.024319,"#005076"
3940349189,HdelArteUMA,14,1,5,6,0.567681,0.51478,0.002432,"#00eeff"
3944820472,elisabetperez12,22,0,2,2,0.560598,0.682373,0.000486,"#00e8b2"
3947661327,CSollaG15,49,1,0,1,0.415581,0.674714,0,"#ff7007"
3948385336,invest_ull,22,6,1,7,0.632723,0.661262,0.002918,"#00e8b2"
3949248376,Lilibeni1,49,0,1,1,0.375853,0.576928,0,"#ff7007"
3954561383,PalabraDeRana,22,0,1,1,0.406526,0.607199,0,"#00e8b2"
3954714135,GuadamillasG,15,8,7,15,0.571964,0.605588,0.006809,"#008ebb"
3957672539,ConsejoEFFYL,14,1,3,4,0.589871,0.533792,0.001459,"#00eeff"
3961232536,Jarluziaherqui,36,0,1,1,0.564569,0.296353,0,"#825403"
3973735283,dgburgher,34,0,1,1,0.318421,0.404087,0,"#ff0d69"
3980710997,GardeJulian,15,4,7,11,0.566013,0.596104,0.004864,"#008ebb"
3981630441,noestanasi00,37,1,0,1,0.555218,0.367808,0,"#006032"
3982698389,projeto_enders,36,17,54,71,0.49848,0.413326,0.034047,"#825403"
3984260897,vaneceia,7,0,1,1,0.788116,0.311864,0,"#ffb800"
3986025035,sabriis_b,40,0,1,1,0.569652,0.032991,0,"#ff12a3"
3986669476,MartaSinH83,49,0,2,2,0.403767,0.612764,0.000486,"#ff7007"
3987472858,FloraBenasco,31,0,2,2,0.595692,0.510811,0.000486,"#3e93ff"
3988905682,franzj03,30,0,1,1,0.594061,0.657391,0,"#ff77ff"
3989743882,musicaugr,31,1,0,1,0.671767,0.611331,0,"#3e93ff"
3993008607,LuisGethsemani,35,4,0,4,0.56023,0.464701,0.001459,"#00faff"
3993191961,IEAL_US,1,9,11,20,0.465095,0.58039,0.009241,"#b6cb00"
3995456566,MaseleUS,1,1,7,8,0.478296,0.612146,0.003405,"#b6cb00"
3995546506,AulaMagna2_0,1,0,1,1,0.478763,0.620122,0,"#b6cb00"
3995614756,platoonthebeach,14,0,1,1,0.657108,0.576949,0,"#00eeff"
3997219839,yasmincurzi,36,0,2,2,0.487209,0.250184,0.000486,"#825403"
4001600841,CoCaIAsociacion,22,0,2,2,0.683269,0.639487,0.000486,"#00e8b2"
4003308496,OElwes,15,0,4,4,0.530272,0.595686,0.001459,"#008ebb"
4004109868,bravo_bander,58,0,2,2,0.68741,0.643704,0.000486,"#005076"
4004802413,BonytaFer,37,0,1,1,0.447713,0.674559,0,"#006032"
4008445576,DHiNorden,36,2,3,5,0.442183,0.431948,0.001946,"#825403"
4009999396,CecilyRaynor,13,14,8,22,0.459701,0.470777,0.010214,"#3bec00"
4010332275,trinidad_arcos,30,0,7,7,0.592654,0.58517,0.002918,"#ff77ff"
4015528061,rikrdo99sinco,40,0,1,1,0.595533,0.018864,0,"#ff12a3"
4015992587,javiersevillap,35,0,3,3,0.356516,0.464784,0.000973,"#00faff"
4016928321,sarasmith24feb,43,0,1,1,0.871962,0.543947,0,"#fcae7e"
4017887925,becalpy,37,50,7,57,0.26684,0.483257,0.027237,"#006032"
4029695596,EBiblicosOnline,22,0,1,1,0.592538,0.614847,0,"#00e8b2"
4036239193,patrimonio_cl,21,1,2,3,0.275816,0.236004,0.000973,"#c6cc85"
4038339969,alandav_,1,0,2,2,0.452462,0.608051,0.000486,"#b6cb00"
4039316087,Silvia25763,3,0,2,2,0.653597,0.365685,0.000486,"#ffb3ff"
4039770029,VamosalcineRC,34,0,2,2,0.279206,0.587282,0.000486,"#ff0d69"
4039936467,ArelyIreta,31,0,2,2,0.587481,0.508843,0.000486,"#3e93ff"
4040430623,elgrifoinfo,49,1,0,1,0.335525,0.643984,0,"#ff7007"
4045839879,BUVaSalud,22,0,1,1,0.617149,0.620755,0,"#00e8b2"
4048650860,HdigitalesAL,13,278,183,461,0.497043,0.503345,0.223735,"#3bec00"
4048684288,Udelaruy,55,22,5,27,0.629827,0.646942,0.012646,"#cb3f32"
4048787009,MellonFdn,34,111,2,113,0.397676,0.435264,0.054475,"#ff0d69"
4051889169,mendibe_mar,22,0,1,1,0.617632,0.722751,0,"#00e8b2"
4053496954,universidad_si,37,3,3,6,0.617934,0.430539,0.002432,"#006032"
4053513263,ACC_assoc,14,2,0,2,0.60066,0.441013,0.000486,"#00eeff"
4053540016,filosofiavs,49,1,0,1,0.394555,0.692403,0,"#ff7007"
4055088443,adelcampogarcia,22,0,1,1,0.591483,0.622392,0,"#00e8b2"
4055799736,Elocutio_ES,15,0,2,2,0.535467,0.615748,0.000486,"#008ebb"
4056843911,StevensonU_HIST,36,0,1,1,0.396259,0.467224,0,"#825403"
4060539015,smallmaria15,49,1,0,1,0.390234,0.67931,0,"#ff7007"
4062465010,IFTS13,49,0,7,7,0.454079,0.550816,0.002918,"#ff7007"
4066580014,CompostelaNegro,22,0,2,2,0.61481,0.640906,0.000486,"#00e8b2"
4069219258,EMSaD_Abasolo,17,0,1,1,0.929055,0.367071,0,"#ff9cc7"
4072313002,Marcela51206720,21,0,1,1,0,0.632206,0,"#c6cc85"
4073771777,blocdelletres,1,1,0,1,0.551387,0.67693,0,"#b6cb00"
4074414145,ssofttaco,3,0,1,1,0.602621,0.408574,0,"#ffb3ff"
4075020382,UsachIngenieria,21,0,1,1,0.337194,0.448814,0,"#c6cc85"
4081939833,Nadsfp,1,0,2,2,0.466853,0.577479,0.000486,"#b6cb00"
4086821594,palsape,10,0,1,1,0.667188,0.801171,0,"#52d7c0"
4093922777,pilarmonelia69,21,0,2,2,0.208718,0.244066,0.000486,"#c6cc85"
4096775056,beadiezconde,30,0,1,1,0.460263,0.624986,0,"#ff77ff"
4098707716,tiburcio_teresa,30,0,2,2,0.539003,0.638894,0.000486,"#ff77ff"
4099455657,JustSAOM,38,0,1,1,0.290035,0.176454,0,"#662859"
4099878027,BlogNubeDeOort,49,1,0,1,0.393977,0.615588,0,"#ff7007"
4100309811,MaiteHuguet,30,0,1,1,0.517508,0.626023,0,"#ff77ff"
4103765812,SussexHumsLab,13,0,1,1,0.418575,0.498689,0,"#3bec00"
4104843070,RocioCastrilloC,30,0,2,2,0.614845,0.586383,0.000486,"#ff77ff"
4107241000,ActLenguas,51,9,0,9,0.385986,0.251026,0.003891,"#c44aac"
4110594934,RemediosZafra,31,2,0,2,0.618312,0.528821,0.000486,"#3e93ff"
4112927662,Mioo_es,49,1,0,1,0.368541,0.625408,0,"#ff7007"
4114798294,anjailustra,36,0,1,1,0.48902,0.229614,0,"#825403"
4118412513,oeduardovictor,36,0,2,2,0.459564,0.161553,0.000486,"#825403"
4119003677,noticiacoahuila,49,1,0,1,0.303626,0.656563,0,"#ff7007"
4119351137,EstrellaDist,22,0,8,8,0.56313,0.531984,0.003405,"#00e8b2"
4119599163,EniCobo,8,0,1,1,0.280811,0.255624,0,"#00ed5d"
4126322681,odi_madrid,22,1,3,4,0.570584,0.631113,0.001459,"#00e8b2"
4126834348,nuriaancillo,15,0,1,1,0.521872,0.745607,0,"#008ebb"
4127364567,CaveroNuria,0,1,0,1,0.838628,0.449162,0,"#8ecfec"
4135430074,LauraJCleaver,36,0,1,1,0.462715,0.28027,0,"#825403"
4136598983,pabblo_h,37,3,6,9,0.27962,0.477926,0.003891,"#006032"
4137707172,VocesValle,13,0,2,2,0.420714,0.441515,0.000486,"#3bec00"
4143350903,lanene54ok,49,1,0,1,0.338247,0.6181,0,"#ff7007"
4143603249,DafcarDavid,34,0,1,1,0.572506,0.351283,0,"#ff0d69"
4144540937,abrahammontene5,38,0,1,1,0.542282,0.32141,0,"#662859"
4146900434,erikammari,30,0,1,1,0.607919,0.67336,0,"#ff77ff"
4150705751,ClauAvaCed,7,0,1,1,0.360613,0.334404,0,"#ffb800"
4150922420,iberriak,30,0,1,1,0.457302,0.596003,0,"#ff77ff"
4152771843,_cocomaya,34,0,4,4,0.492068,0.434169,0.001459,"#ff0d69"
4154162238,PaulinaAMtzMtz1,17,0,1,1,0.81789,0.219337,0,"#ff9cc7"
4156808247,pedrebano,38,0,1,1,0.084395,0.433431,0,"#662859"
4157462356,GICIDUZ,22,1,0,1,0.559057,0.696533,0,"#00e8b2"
4158725537,MesoArgentina,22,1,2,3,0.575304,0.460829,0.000973,"#00e8b2"
4159060101,chumbolinho,36,0,2,2,0.531001,0.256253,0.000486,"#825403"
4159474219,lupy0653,30,0,1,1,0.597144,0.654941,0,"#ff77ff"
4160045615,dahiana_1186,38,0,1,1,0.589947,0.353573,0,"#662859"
4160274844,CyrilPedia,36,0,1,1,0.793009,0.783834,0,"#825403"
4162410142,anwagnerdreas,34,3,29,32,0.481321,0.503875,0.015078,"#ff0d69"
4163113992,La_Mascarada,13,0,1,1,0.488831,0.311772,0,"#3bec00"
4175382335,geniomalignocc,3,3,0,3,0.434454,0.675959,0.000973,"#ffb3ff"
4177466183,emisoraUAL,49,3,0,3,0.421205,0.599875,0.000973,"#ff7007"
4180048486,pensarinfog,36,0,1,1,0.464365,0.292364,0,"#825403"
4180929853,FundacionColmex,7,0,4,4,0.434501,0.36489,0.001459,"#ffb800"
4185743326,AmrieDitras,49,0,2,2,0.426376,0.466067,0.000486,"#ff7007"
4189856115,IntentoDArtista,42,0,1,1,0.713529,0.421413,0,"#66e087"
4197106439,AuroraAyciriex,8,0,1,1,0.518696,0.79303,0,"#00ed5d"
4198141247,concha_lilia,21,0,1,1,0.014114,0.631173,0,"#c6cc85"
4201464556,mariaJ2312,2,0,2,2,0.679469,0.662693,0.000486,"#ffa64e"
4205050932,MELALibs,13,0,1,1,0.351794,0.440515,0,"#3bec00"
4217486014,MFontquerni1,14,0,1,1,0.674731,0.40748,0,"#00eeff"
4218004414,rita_malano,34,1,0,1,0.370327,0.478251,0,"#ff0d69"
4218197638,daidiario,49,1,0,1,0.416632,0.69458,0,"#ff7007"
4219421915,tanakaken14,14,0,4,4,0.525043,0.474761,0.001459,"#00eeff"
4220074768,PilarArrabal4,1,7,4,11,0.514696,0.578784,0.004864,"#b6cb00"
4226369129,eliasfromspain,49,1,0,1,0.31411,0.640447,0,"#ff7007"
4226545156,jpgcrowley,3,0,3,3,0.322188,0.521067,0.000973,"#ffb3ff"
4227263615,DadesiServeis,49,1,0,1,0.358693,0.685002,0,"#ff7007"
4227295983,wrmly,34,0,2,2,0.373236,0.433969,0.000486,"#ff0d69"
4228013007,SalcesViky,22,0,1,1,0.601767,0.62774,0,"#00e8b2"
4228040548,yeny36973940,13,0,1,1,0.488698,0.36609,0,"#3bec00"
4228089793,lauradenoves1,34,0,1,1,0.480834,0.372297,0,"#ff0d69"
4228308581,JoseanDuran45,49,1,0,1,0.329244,0.648839,0,"#ff7007"
4228522393,QuelenIngrid,36,0,1,1,0.497822,0.238228,0,"#825403"
4234102996,MolpeceresAna,30,0,2,2,0.68427,0.634868,0.000486,"#ff77ff"
4235558654,SindicatoItq,34,0,1,1,0.535811,0.330207,0,"#ff0d69"
4235703731,BmeuVallori,4,1,0,1,0.499878,0.254898,0,"#f4c8cf"
4236115258,RicardoR_Usal,58,1,0,1,0.457968,0.653116,0,"#005076"
4236674193,gabra_lopes,36,0,6,6,0.505151,0.348687,0.002432,"#825403"
4237442542,crtorreblanca,30,0,1,1,0.602286,0.679566,0,"#ff77ff"
4242608658,RichFokalot,0,0,2,2,0.287171,0.542983,0.000486,"#8ecfec"
4243473723,circe1939,1,0,1,1,0.70577,0.48453,0,"#b6cb00"
4244791053,NNithaell,48,0,1,1,0.209681,0.702936,0,"#ff7a78"
4248110352,jaross77,22,0,3,3,0.674981,0.344397,0.000973,"#00e8b2"
4256249057,GeoPolitikon,15,0,1,1,0.536866,0.686977,0,"#008ebb"
4257474076,Venezuela3017,49,1,0,1,0.359242,0.6223,0,"#ff7007"
4257902229,EncarnaGutierr5,37,0,2,2,0.624573,0.463068,0.000486,"#006032"
4258094120,chileanista,36,1,0,1,0.556495,0.382099,0,"#825403"
4262015955,ruizluisalejan1,7,0,1,1,0.790507,0.637478,0,"#ffb800"
4265010023,IndigitalA,49,1,0,1,0.328635,0.683779,0,"#ff7007"
4270523294,eugenia0864,41,0,1,1,0.252459,0.348589,0,"#697b00"
4274796317,MDupps,49,1,0,1,0.35367,0.650323,0,"#ff7007"
4274809275,develtricks,49,1,0,1,0.376053,0.678622,0,"#ff7007"
4275923118,Oducal,37,2,0,2,0.390957,0.577138,0.000486,"#006032"
4276053147,ShaxWorld,1,1,0,1,0.516111,0.781927,0,"#b6cb00"
4281376332,davidallynbliss,34,1,0,1,0.385612,0.45604,0,"#ff0d69"
4284614116,inmaviu,14,0,3,3,0.697422,0.537458,0.000973,"#00eeff"
4286670267,ErendiTitita,30,0,2,2,0.571318,0.594248,0.000486,"#ff77ff"
4289146648,TaniaSordoRuz,40,0,1,1,0.654039,0.032448,0,"#ff12a3"
877077240613359617,Hismedi,19,110,221,331,0.614077,0.708682,0.160506,"#00d3ff"
882649993013800963,MESA_MH_LATINA,19,4,1,5,0.66367,0.730874,0.001946,"#00d3ff"
826102642002817025,APPRecovery,34,270,77,347,0.397685,0.442587,0.168288,"#ff0d69"
967503330066010112,Real_Person_DH,13,0,164,164,0.484792,0.468441,0.07928,"#3bec00"
1488651319959330819,AdelheidSudibyo,15,0,1,1,0.552625,0.65329,0,"#008ebb"
1353711333951344640,DigiPhiLit,15,19,24,43,0.529257,0.566134,0.020428,"#008ebb"
987712090071814144,DigtalHumanatee,34,0,443,443,0.495071,0.473755,0.214981,"#ff0d69"
1445694375573348357,Dynatinc,35,25,17,42,0.552364,0.477332,0.019942,"#00faff"
4866400552,glaincorona,15,3,26,29,0.512763,0.551133,0.013619,"#008ebb"
979085614686629895,tthubio,49,12,5,17,0.459467,0.492433,0.007782,"#ff7007"
940970240279801861,revista_hd,13,423,106,529,0.478063,0.497091,0.256809,"#3bec00"
733704319833346050,HDCAICYT,49,238,1819,2057,0.415474,0.597011,1,"#ff7007"
830233215050928128,RevistaAcervo,36,31,4,35,0.514027,0.385042,0.016537,"#825403"
1432168801655734275,Redlatdigital,35,4,0,4,0.510205,0.463875,0.001459,"#00faff"
1318992064168722435,MSUGlobalDH,13,8,8,16,0.519112,0.493385,0.007296,"#3bec00"
750996397684617218,floresbenat,18,3,5,8,0.575803,0.533596,0.003405,"#5456a6"
1168169867482226696,martalecturas,1,4,8,12,0.500405,0.578814,0.00535,"#b6cb00"
1400540513766412288,AntropologaL,13,1,0,1,0.432361,0.367788,0,"#3bec00"
4369581861,937908Mcm,19,0,2,2,0.667963,0.7537,0.000486,"#00d3ff"
869673002765623297,AlmudenaVido,14,6,19,25,0.473248,0.538196,0.011673,"#00eeff"
1227326334386540544,dxvidmr,14,41,61,102,0.48435,0.516566,0.049125,"#00eeff"
4893661588,luispcordero,1,5,2,7,0.428431,0.529354,0.002918,"#b6cb00"
916343337438892033,edwardss38,1,0,1,1,0.425536,0.71831,0,"#b6cb00"
1306286577820327937,catalogocuento,3,21,1,22,0.367249,0.561039,0.010214,"#ffb3ff"
837213971744702464,fjimcal,1,0,6,6,0.489427,0.660425,0.002432,"#b6cb00"
1089215646020313090,Veristonelli,36,0,6,6,0.510715,0.39715,0.002432,"#825403"
1011605022084345861,mariia_soteelo,1,0,1,1,0.349678,0.537483,0,"#b6cb00"
706852789792710656,Transkribus,36,7,2,9,0.550716,0.464909,0.003891,"#825403"
1098705214545240064,Alpes_Alianza,7,0,1,1,0.407212,0.357124,0,"#ffb800"
1109478080400293888,alharaca_sv,3,2,0,2,0.540602,0.444332,0.000486,"#ffb3ff"
718699558243405824,VidaInmanente,13,8,54,62,0.473534,0.497105,0.029669,"#3bec00"
1452361182791311364,LeshePepe,19,0,4,4,0.650345,0.76293,0.001459,"#00d3ff"
732901190397251584,Memoria_Publica,19,4,0,4,0.660278,0.760442,0.001459,"#00d3ff"
898610394385743872,LADESBANDA,19,5,4,9,0.648291,0.753678,0.003891,"#00d3ff"
978228278493401088,CORTdMUSCLO,19,0,4,4,0.644291,0.763126,0.001459,"#00d3ff"
735059281494544384,hilame_info,22,75,68,143,0.522468,0.568631,0.069066,"#00e8b2"
1388835468574347264,UnasLetras3,3,0,1,1,0.306811,0.600539,0,"#ffb3ff"
931553177157230592,HumanitiesGU,13,6,0,6,0.491036,0.483179,0.002432,"#3bec00"
1308167816160346113,laverdaderaglow,3,0,1,1,0.288315,0.603795,0,"#ffb3ff"
1483254128142864386,LaSunamita_,3,0,1,1,0.316755,0.588021,0,"#ffb3ff"
1193108620256456704,ProfesanRoqueBa,30,0,1,1,0.400045,0.776272,0,"#ff77ff"
1036325562271322118,IesSanRoque,30,2,3,5,0.444639,0.70786,0.001946,"#ff77ff"
1032947615414067200,ltiufpb,36,12,0,12,0.527399,0.378725,0.00535,"#825403"
875906660480544768,SergioMarentes,3,0,1,1,0.284185,0.606275,0,"#ffb3ff"
1234195404125691905,Rosario7525,3,0,1,1,0.29449,0.60712,0,"#ffb3ff"
1109542019884634112,HTarancon,19,1,0,1,0.651526,0.768037,0,"#00d3ff"
949283920222281728,ClioVis,13,0,72,72,0.46443,0.454305,0.034533,"#3bec00"
751405862820802560,gbaezaventura,34,34,11,45,0.432681,0.452674,0.021401,"#ff0d69"
1089942577476968450,fabiane_2019,36,0,1,1,0.56903,0.29399,0,"#825403"
1377296194070798338,ProyectoLitPR,34,23,6,29,0.388426,0.419102,0.013619,"#ff0d69"
1060827280455413760,AHPHuesca,19,1,0,1,0.625716,0.779921,0,"#00d3ff"
831165079164960768,ibero_historia,13,62,8,70,0.462138,0.388191,0.03356,"#3bec00"
1248387098585051136,0jonjo,36,22,41,63,0.476545,0.407174,0.030156,"#825403"
1122329101472292864,Karen_Fabian1,13,1,1,2,0.491296,0.420583,0.000486,"#3bec00"
1376203606106456068,julio_dsky,13,0,2,2,0.451806,0.398044,0.000486,"#3bec00"
825500194842275844,gnrdias,36,0,1,1,0.538725,0.335186,0,"#825403"
1141364337065582593,CentroCham,36,31,6,37,0.511098,0.413934,0.01751,"#825403"
1176406930031595520,comcomunes,1,21,10,31,0.461746,0.632431,0.014591,"#b6cb00"
920940212452319232,edu_deu,1,0,2,2,0.456302,0.713895,0.000486,"#b6cb00"
1032572338435448832,Journal_Iti,1,8,0,8,0.481557,0.532515,0.003405,"#b6cb00"
1093891536415277056,DarkPostinho,36,0,1,1,0.483394,0.137442,0,"#825403"
1226533604878102528,OdraudeIzrets,36,2,0,2,0.501428,0.215622,0.000486,"#825403"
1086963733597949952,miresegom,1,0,3,3,0.450496,0.711488,0.000973,"#b6cb00"
1393251606179745794,BotUFBA,36,0,6,6,0.496347,0.322055,0.002432,"#825403"
737142202481016832,chidambara09,22,0,24,24,0.465657,0.487759,0.011187,"#00e8b2"
1147108534850658304,techie_wiz,0,0,5,5,0.455972,0.508356,0.001946,"#8ecfec"
1221817337441148928,ComExternado,38,1,0,1,0.667946,0.63524,0,"#662859"
1394301754716692481,iaquinoc,36,1,1,2,0.448345,0.395265,0.000486,"#825403"
822902501645041664,sferna109,41,64,64,128,0.419979,0.440926,0.06177,"#697b00"
1483145763614040064,acastillomuz,34,0,2,2,0.353109,0.398787,0.000486,"#ff0d69"
1400173944712351747,Alexand04132949,36,3,6,9,0.485043,0.33862,0.003891,"#825403"
1162440116981370880,MegaphoneTexas,34,0,1,1,0.295889,0.412977,0,"#ff0d69"
1122758227496787969,miguel28758101,19,0,2,2,0.617131,0.766975,0.000486,"#00d3ff"
1249741114103549952,HomenajeREP,19,3,2,5,0.627703,0.752983,0.001946,"#00d3ff"
1256994286698184704,jesusangeljim,15,2,0,2,0.576025,0.830019,0.000486,"#008ebb"
1340369822765477893,AgoraColectivo,37,0,4,4,0.476423,0.44594,0.001459,"#006032"
705358078779199488,mhhdUPO,1,7,71,78,0.46677,0.522654,0.037451,"#b6cb00"
1001455394168983552,molina_itziar,15,0,2,2,0.56888,0.731574,0.000486,"#008ebb"
992658996409655296,delasheras_usal,15,0,1,1,0.581264,0.900973,0,"#008ebb"
1372845194647904258,MaraJosCasaus1,58,0,3,3,0.535419,0.581538,0.000973,"#005076"
787603018086805504,LaSemyr,58,76,29,105,0.51086,0.538652,0.050584,"#005076"
1298687874112671751,BotLabhd,36,6,557,563,0.491058,0.412414,0.273346,"#825403"
1096754682356219904,CLIO_Uva,58,0,3,3,0.531904,0.585466,0.000973,"#005076"
1047876707246592000,reseau_EFE,35,0,4,4,0.61288,0.475424,0.001459,"#00faff"
4443585197,clairedjimenez,34,0,9,9,0.407291,0.437896,0.003891,"#ff0d69"
1456597855293120518,paquigomezbis,58,0,3,3,0.541449,0.583549,0.000973,"#005076"
1403483518001422340,carmeenrevuelta,37,0,1,1,0.332305,0.357132,0,"#006032"
1492273678880493569,HumanidadesC,37,3,0,3,0.408156,0.375175,0.000973,"#006032"
916778990609797120,maria_yod,13,1,0,1,0.470347,0.397373,0,"#3bec00"
1295715136141963267,education_24x7,36,0,1,1,0.427136,0.301549,0,"#825403"
1383238671411793920,JackiePedota,34,0,1,1,0.335005,0.4056,0,"#ff0d69"
925190804930547713,StMUPublicHist,4,0,2,2,0.374776,0.440466,0.000486,"#f4c8cf"
1171191157407342592,AmPeriodicals,34,0,3,3,0.374545,0.434867,0.000973,"#ff0d69"
1196167915864776704,VanguardiaVirt1,18,0,9,9,0.458953,0.606962,0.003891,"#5456a6"
4603820789,muyfandel36,19,4,0,4,0.650085,0.733341,0.001459,"#00d3ff"
1095706641910190080,ArcaFFYL,13,1,0,1,0.526505,0.291987,0,"#3bec00"
1479091184215760902,educaclio,35,2,2,4,0.574757,0.456858,0.001459,"#00faff"
1072791998103543810,ArqueoURJC,35,1,3,4,0.569038,0.451236,0.001459,"#00faff"
1409898130313822219,Memorizate_,19,3,2,5,0.572364,0.636486,0.001946,"#00d3ff"
1161330486846709760,ChesnuttArchive,34,0,2,2,0.363784,0.426685,0.000486,"#ff0d69"
765190598085185536,UofTDHN,13,7,4,11,0.498627,0.465587,0.004864,"#3bec00"
879388492580745217,Christy_SpaceHW,34,0,1,1,0.310023,0.401683,0,"#ff0d69"
883479820117651456,LGauth19,34,80,38,118,0.406004,0.452353,0.056907,"#ff0d69"
1365614484291784704,MariaIvorraPer1,58,2,0,2,0.481177,0.545396,0.000486,"#005076"
1280957126031138816,BBF_DIPFBerlin,49,0,2,2,0.415615,0.45428,0.000486,"#ff7007"
1442828690174398470,exiliados_stan,19,1,0,1,0.630904,0.771089,0,"#00d3ff"
1496168021521539077,mandorla_,58,1,1,2,0.493401,0.647875,0.000486,"#005076"
968994901508665346,UniandesIELE,38,1,0,1,0.681713,0.484728,0,"#662859"
1494298675606171653,iehm_uib,58,3,4,7,0.410229,0.559325,0.002918,"#005076"
1454555426549288963,ElenaTruan,58,4,1,5,0.390015,0.542553,0.001946,"#005076"
1141620167287410688,r_massanet,58,0,3,3,0.410867,0.54285,0.000973,"#005076"
1431256545795379200,AAA9177036827,43,0,2,2,0.731324,0.634152,0.000486,"#fcae7e"
1328450174688038915,uhcuba,43,4,0,4,0.681791,0.599163,0.001459,"#fcae7e"
1340312202159542274,ufscbot,49,0,4,4,0.497536,0.384407,0.001459,"#ff7007"
725445697382809600,knowmetrics,31,222,109,331,0.533146,0.504682,0.160506,"#3e93ff"
1367533292547891204,DianaRosaLpez2,43,0,2,2,0.720679,0.636394,0.000486,"#fcae7e"
1380487097711259650,Mariola07431020,30,0,4,4,0.545416,0.547523,0.001459,"#ff77ff"
1242734018166165506,yosigopublican2,31,1,0,1,0.642511,0.524807,0,"#3e93ff"
1387863260481867777,CreaTICIcesi,13,0,1,1,0.426479,0.409277,0,"#3bec00"
753531336816730112,UNEDBruselas,30,2,2,4,0.523982,0.65785,0.001459,"#ff77ff"
1097580840685658114,PaisPti,14,0,8,8,0.542858,0.491351,0.003405,"#00eeff"
1010327421420277760,CarlosRoldn20,49,1,0,1,0.330659,0.512645,0,"#ff7007"
1088862455474851842,PDejanon,49,1,1,2,0.360403,0.514439,0.000486,"#ff7007"
4923600039,FilologiaUsal,58,12,6,18,0.489914,0.537766,0.008268,"#005076"
948178046045032448,kr_wittmann,14,9,12,21,0.573698,0.602203,0.009728,"#00eeff"
968267480002121729,EHEITESM,10,24,11,35,0.3893,0.490699,0.016537,"#52d7c0"
1030179869244764161,hangryhistorian,34,1,6,7,0.382521,0.428258,0.002918,"#ff0d69"
1243236136765489152,CateAgostini,36,45,19,64,0.473476,0.361146,0.030642,"#825403"
1324278660111753218,hdh2021,14,80,17,97,0.520782,0.52005,0.046693,"#00eeff"
1252313225011449856,OpenSciTalk,22,0,19,19,0.523179,0.522153,0.008755,"#00e8b2"
1488416600516608001,san_sanchezg,14,0,1,1,0.471517,0.657844,0,"#00eeff"
794497864827359233,lupefrutos,14,0,19,19,0.467957,0.519524,0.008755,"#00eeff"
1493140343335923718,Humd2122B,13,3,3,6,0.474834,0.470493,0.002432,"#3bec00"
1251632436506755076,AbecinOficial,36,2,0,2,0.479308,0.379808,0.000486,"#825403"
828663319254953984,FMemoriaSegovia,19,2,0,2,0.656761,0.74935,0.000486,"#00d3ff"
1296232128619913216,ChadiCongreso,13,0,2,2,0.44068,0.455008,0.000486,"#3bec00"
977081431833894912,gus_candela,34,8,26,34,0.499386,0.492548,0.016051,"#ff0d69"
1159474474745565186,felipe_lamarca,36,1,2,3,0.514853,0.345654,0.000973,"#825403"
1409638219264692224,Luca_Cechs,36,0,1,1,0.522671,0.325064,0,"#825403"
1320672323612090368,sistema_arText,30,1,2,3,0.462705,0.517533,0.000973,"#ff77ff"
837025047369945101,literatricia,30,0,31,31,0.511299,0.566348,0.014591,"#ff77ff"
1176555493545971714,GrupoKollontai,19,1,0,1,0.655314,0.79158,0,"#00d3ff"
854108123170254848,Noticias_Aemic,19,1,0,1,0.598474,0.775075,0,"#00d3ff"
1257488000318976000,digihis,13,1,68,69,0.492122,0.508154,0.033074,"#3bec00"
1397937477286088704,arte_vir,30,0,1,1,0.505367,0.62685,0,"#ff77ff"
1323025564396113921,tekoaunila,35,10,3,13,0.540055,0.456173,0.005837,"#00faff"
1292538421815193601,AgenciasH,34,28,15,43,0.556461,0.433087,0.020428,"#ff0d69"
1383372332362731526,ArqueoBarros,35,4,0,4,0.559763,0.469081,0.001459,"#00faff"
1387594329330442240,srtapinkcat,37,2,1,3,0.527377,0.371966,0.000973,"#006032"
1285122141390856195,SE_MemoDemo,19,2,0,2,0.66041,0.742844,0.000486,"#00d3ff"
1148918384807096321,izzzetan,58,0,6,6,0.502834,0.540029,0.002432,"#005076"
801145340757966851,ObscuraProsa,58,0,3,3,0.534209,0.573344,0.000973,"#005076"
1450805981341011980,IAM_CSIC,35,0,4,4,0.585219,0.455403,0.001459,"#00faff"
1168059166071623680,geovacui,30,1,0,1,0.490806,0.780601,0,"#ff77ff"
1468602631115665408,ArchaeoFer,19,2,2,4,0.563681,0.549278,0.001459,"#00d3ff"
894565735938355200,mog_moggie,34,0,2,2,0.553692,0.467706,0.000486,"#ff0d69"
877193871612137472,romanceiropt,36,2,2,4,0.54755,0.454142,0.001459,"#825403"
1500392029225996288,HistoricalSound,22,2,0,2,0.434068,0.736148,0.000486,"#00e8b2"
1471981382704549893,JamesQuipile,35,0,1,1,0.479066,0.69012,0,"#00faff"
1394432849332211713,NewBooksNenesp,35,4,3,7,0.485427,0.60453,0.002918,"#00faff"
1492571809476227072,AMontea85,10,0,1,1,0.278293,0.535582,0,"#52d7c0"
1065266673563967488,ehuprest,37,5,0,5,0.579723,0.46189,0.001946,"#006032"
1114561228041486336,map_usp,48,7,6,13,0.342303,0.523975,0.005837,"#ff7a78"
766230286535430144,ETSIIUNED,30,16,25,41,0.535026,0.544673,0.019455,"#ff77ff"
1437867934710386697,ethicsBot_,36,1,0,1,0.472652,0.334709,0,"#825403"
923887168187191296,luisgmerida,13,0,1,1,0.507671,0.396006,0,"#3bec00"
1354776515473530888,humanidadesual,37,4,0,4,0.449419,0.452191,0.001459,"#006032"
1260629589346463744,_TFbot,13,0,7,7,0.446761,0.461093,0.002918,"#3bec00"
709810797115912192,LeoLopezLujan,4,1,0,1,0.41982,0.280302,0,"#f4c8cf"
1280921401248137218,MM_DeAndaRogel,4,1,0,1,0.430159,0.277843,0,"#f4c8cf"
977151787345072128,ana_codesido,14,0,1,1,0.364341,0.578722,0,"#00eeff"
1392410868613328896,SINCRISIS1,14,3,3,6,0.446065,0.552242,0.002432,"#00eeff"
1324738005274447874,facultadeXH,14,0,1,1,0.372087,0.576505,0,"#00eeff"
704613732614344704,uSIG_CCHS_CSIC,22,209,64,273,0.544941,0.550304,0.132296,"#00e8b2"
1356355818757742592,iskra1794,19,1,0,1,0.605498,0.883016,0,"#00d3ff"
1496612258528608259,ucemich_edu,37,0,1,1,0.703843,0.390851,0,"#006032"
1344587828924178434,jlgoldfarb,36,1,1,2,0.502043,0.32749,0.000486,"#825403"
1398514088645480448,pavaobot,37,5,389,394,0.522135,0.440072,0.191148,"#006032"
1130490122917617666,LudiCagliari,34,0,2,2,0.489926,0.395152,0.000486,"#ff0d69"
801119508161236992,LibretaNegraMx,37,8,4,12,0.532821,0.397775,0.00535,"#006032"
1306626901432324097,rstats_tweets,34,0,4,4,0.5208,0.445481,0.001459,"#ff0d69"
1011817655957893120,rstatstweet,13,0,16,16,0.479125,0.487392,0.007296,"#3bec00"
1476556200032538636,VHistoryLab,19,1,0,1,0.629272,0.775329,0,"#00d3ff"
1219950181808070656,humboldtdigital,49,25,23,48,0.467185,0.495023,0.02286,"#ff7007"
1102266894634098688,MariaLujanMedi8,13,0,1,1,0.391655,0.500818,0,"#3bec00"
1272656470782423040,CfpSpanish,14,0,7,7,0.495112,0.541538,0.002918,"#00eeff"
724702270890323968,dhd2022,49,5,2,7,0.486666,0.453854,0.002918,"#ff7007"
1300386336214577153,GarrochoS,37,12,1,13,0.693138,0.501816,0.005837,"#006032"
716685660199993344,mjsolanofranco,37,0,1,1,0.756939,0.496747,0,"#006032"
751092352320667649,ReHDi_Co,38,234,55,289,0.5091,0.46684,0.140078,"#662859"
1368927705044033538,PartoutProf,36,0,1,1,0.476849,0.28333,0,"#825403"
850337570412257280,YisethJimnez1,38,1,2,3,0.59817,0.522764,0.000973,"#662859"
1156901455376392192,LauraCasman,38,1,0,1,0.673415,0.626383,0,"#662859"
1269226915610664960,CMedievales,22,0,3,3,0.514837,0.539781,0.000973,"#00e8b2"
922964946463416320,PUEC_UNAM,37,5,0,5,0.602067,0.278128,0.001946,"#006032"
1046760290170359810,mangelesguzm_13,37,0,2,2,0.376999,0.416099,0.000486,"#006032"
1076885700073668610,humanistasual,37,4,2,6,0.428992,0.439092,0.002432,"#006032"
1468328965903368193,UAL_RacingTeam,37,5,0,5,0.415668,0.410907,0.001946,"#006032"
1100981879673667584,DeuscIgg,37,0,1,1,0.628818,0.212302,0,"#006032"
4918282330,gamedinafrias,34,1,4,5,0.576728,0.405595,0.001946,"#ff0d69"
719275934000484354,Aflorezdeandrad,34,2,0,2,0.566116,0.378895,0.000486,"#ff0d69"
1394656221517463553,iseteh,36,2,0,2,0.529664,0.382379,0.000486,"#825403"
1259878565946023937,FactorData,37,23,3,26,0.287271,0.441297,0.01216,"#006032"
1463791691316535301,mariamchaveshum,35,3,0,3,0.582667,0.446774,0.000973,"#00faff"
835239883857936386,B_GarridoRamos,49,18,36,54,0.497411,0.52986,0.025778,"#ff7007"
1484978715721445378,Cripto_B_Art,37,3,1,4,0.538563,0.478248,0.001459,"#006032"
1227633827356520452,feralgarra,13,0,2,2,0.4301,0.466432,0.000486,"#3bec00"
708324971475542016,PosgradosUCES,49,24,0,24,0.45948,0.511028,0.011187,"#ff7007"
1319336780060151809,EcosPatrimonial,37,2,2,4,0.528096,0.413745,0.001459,"#006032"
4369790956,Martxoak3,37,9,1,10,0.602378,0.650659,0.004377,"#006032"
1126575028852744193,AlcantaraPla,37,43,31,74,0.538284,0.533818,0.035506,"#006032"
1196725273498136576,uamhispanicas,37,0,3,3,0.493872,0.532021,0.000973,"#006032"
1418572460048494593,AnrVismin,35,4,4,8,0.531223,0.494,0.003405,"#00faff"
735482871754969088,psigehess,35,3,4,7,0.536338,0.526653,0.002918,"#00faff"
951399642817851392,SanzParatcha,22,0,1,1,0.676991,0.684105,0,"#00e8b2"
1379360130131693569,ESCiencia_CSIC,22,3,5,8,0.510014,0.535915,0.003405,"#00e8b2"
1396503997570293765,Hugo61719845,49,0,2,2,0.420195,0.52319,0.000486,"#ff7007"
1361796898772963328,Profe_EmeGe,13,0,5,5,0.543301,0.422645,0.001946,"#3bec00"
1042858258975875073,dgbsdiuaq,13,29,15,44,0.470247,0.456665,0.020914,"#3bec00"
1392777598799949825,BeatrizBustosM,19,0,2,2,0.627498,0.769265,0.000486,"#00d3ff"
1392379879375712256,ArchivoUA,19,2,1,3,0.626281,0.755891,0.000973,"#00d3ff"
1225159200013156352,ricnomah,49,0,15,15,0.445608,0.499582,0.006809,"#ff7007"
992943418052460544,ricardo_ik_ahau,13,0,22,22,0.519931,0.437703,0.010214,"#3bec00"
1110451174413611008,Aldonza_Ruiz,37,0,1,1,0.757923,0.489644,0,"#006032"
1069549662422663168,MarcLuqueSAB,37,0,1,1,0.749244,0.492059,0,"#006032"
1415252910972231684,HumanidadesUPV,3,4,0,4,0.496765,0.496242,0.001459,"#ffb3ff"
908709861755641857,AlavaMedieval,22,1,8,9,0.547001,0.54439,0.003891,"#00e8b2"
1259217597503090694,munarqas,14,0,2,2,0.544193,0.578141,0.000486,"#00eeff"
865014834143928322,Scripta_,22,59,73,132,0.541123,0.551235,0.063716,"#00e8b2"
848222675227070464,medievalitis,22,47,10,57,0.538997,0.562835,0.027237,"#00e8b2"
1378984636546682882,PMedhis,22,13,13,26,0.525959,0.521818,0.01216,"#00e8b2"
861502060646346752,CongHDOlladasIM,22,19,19,38,0.502112,0.548923,0.017996,"#00e8b2"
1405828293358727170,IsaMellen,35,1,1,2,0.481105,0.612987,0.000486,"#00faff"
1070257033847472128,PetrifyingW,22,7,2,9,0.525528,0.558415,0.003891,"#00e8b2"
912350773480214533,montse_esquerda,37,0,1,1,0.677992,0.318578,0,"#006032"
1022060769536552960,annapagess,37,2,0,2,0.612095,0.372896,0.000486,"#006032"
1194379900339269632,HD_TecMonterrey,13,16,21,37,0.452859,0.514376,0.01751,"#3bec00"
1493156495843856390,DHum2122S,36,7,4,11,0.523873,0.429289,0.004864,"#825403"
1267475661280677888,libromedieval,22,14,10,24,0.536297,0.557309,0.011187,"#00e8b2"
1269150523787280384,GabeBM2588,37,0,1,1,0.233673,0.430243,0,"#006032"
4493774475,lephcero,37,0,1,1,0.229277,0.426006,0,"#006032"
1044257319616483328,gazuaga1,37,0,1,1,0.230577,0.420688,0,"#006032"
998511141964873728,Diego_Koz,37,0,2,2,0.28358,0.454948,0.000486,"#006032"
1102652174641872898,SEHISP_UCLM,22,0,2,2,0.539996,0.606683,0.000486,"#00e8b2"
1008527767636533249,MaxiEstravis,37,0,1,1,0.23275,0.434221,0,"#006032"
1098244539825958916,Marc_wv,37,0,3,3,0.260512,0.477233,0.000973,"#006032"
1379925507551158273,Ageum5,19,1,0,1,0.657898,0.76209,0,"#00d3ff"
948256418901131264,AlgoHelen,19,1,0,1,0.652845,0.787317,0,"#00d3ff"
1146194147679907840,Antipopo1,19,1,0,1,0.669576,0.782189,0,"#00d3ff"
1421884147736457218,Barbara08857749,36,0,1,1,0.384289,0.344727,0,"#825403"
1205585252263092224,Humanidades_UCA,37,0,1,1,0.668878,0.316059,0,"#006032"
1378036119032508416,ArreParienteKun,37,0,1,1,0.608285,0.259068,0,"#006032"
1414752983183728644,Delfos_FA,37,2,0,2,0.582749,0.330638,0.000486,"#006032"
775503871045210112,AgrupPGrajero,37,0,3,3,0.625386,0.652012,0.000973,"#006032"
1356182762718449664,MujeresExilio,19,1,0,1,0.624357,0.773422,0,"#00d3ff"
1107372878813687810,FranjaviColR,37,0,1,1,0.211187,0.484394,0,"#006032"
1252569953351487488,MarlonCAlcanta1,36,0,1,1,0.362839,0.35296,0,"#825403"
1257122912894672896,AndreaMPicaso,37,11,3,14,0.330721,0.473848,0.006323,"#006032"
1479533658931347456,K_AntifaMemoria,37,0,2,2,0.633013,0.631588,0.000486,"#006032"
1407585123956973572,nemo_ffffffffff,13,0,1,1,0.424153,0.412819,0,"#3bec00"
1270257442396372992,mapagraph,13,0,1,1,0.428672,0.400604,0,"#3bec00"
1420464728195862529,bnmx_,13,5,2,7,0.441731,0.417249,0.002918,"#3bec00"
906023803624374278,Alejan7103,13,1,0,1,0.378701,0.350708,0,"#3bec00"
1251435078200242176,ana_mlag,35,0,1,1,0.557071,0.425114,0,"#00faff"
1459486155418882053,AliciaAlvaradoE,13,0,1,1,0.45182,0.398537,0,"#3bec00"
1333914724841394178,IberoPuebla_Inv,13,2,0,2,0.374048,0.304828,0.000486,"#3bec00"
1028282454640144384,QuasarSure,13,0,1,1,0.410198,0.409253,0,"#3bec00"
1133663771866685444,quentinmouchet,35,5,2,7,0.540548,0.459807,0.002918,"#00faff"
980191735757377536,alandio_,35,4,4,8,0.586663,0.486786,0.003405,"#00faff"
853294583450673152,Xmpolitik,40,0,2,2,0.62067,0.395542,0.000486,"#ff12a3"
1490988288638861313,Dhum2122B,36,0,1,1,0.537985,0.350117,0,"#825403"
1493519197867061248,Dhum2122H,34,0,5,5,0.364665,0.503234,0.001946,"#ff0d69"
1272335080070033408,LivroBot,36,0,1,1,0.515907,0.29798,0,"#825403"
1064229467516747776,elMUELLEdelaSAL,0,4,12,16,0.466101,0.517211,0.007296,"#8ecfec"
956187441857290242,revistatelos,0,123,25,148,0.464561,0.536596,0.071498,"#8ecfec"
1377810525845880840,PequeninWarrior,0,0,16,16,0.449242,0.463675,0.007296,"#8ecfec"
1365033972217036801,DirInves_FULL,3,0,1,1,0.485541,0.774049,0,"#ffb3ff"
1222693378384592896,CataTrine,3,0,1,1,0.483536,0.782595,0,"#ffb3ff"
1253497061376430082,JulianZM9,3,0,1,1,0.467575,0.78255,0,"#ffb3ff"
1067443972023468033,gotaceite,3,0,1,1,0.470546,0.75592,0,"#ffb3ff"
899308739068665856,MarianitoMaria1,3,0,1,1,0.516936,0.771503,0,"#ffb3ff"
1172522167801655297,GokuSaiyajin_7,3,0,1,1,0.47133,0.759409,0,"#ffb3ff"
1483628098474192897,susanveinte,3,0,1,1,0.492421,0.753302,0,"#ffb3ff"
1326031175807275010,IvnNuez89215459,3,0,1,1,0.474847,0.776221,0,"#ffb3ff"
1179591545349124096,AndresApunta,3,0,1,1,0.450393,0.759815,0,"#ffb3ff"
1374186520052183046,Brandon29062547,3,0,1,1,0.521663,0.754942,0,"#ffb3ff"
1151498038533394432,MontufarHarold,3,0,1,1,0.458541,0.757386,0,"#ffb3ff"
1249485951539150848,labinnovaso,31,0,6,6,0.510195,0.54543,0.002432,"#3e93ff"
1396953490044379139,Colombi46296576,3,0,1,1,0.420503,0.743674,0,"#ffb3ff"
1110980966594633731,Laura3_6_,3,0,1,1,0.481248,0.762659,0,"#ffb3ff"
1485064162162233347,remolacho22,3,0,1,1,0.497833,0.766837,0,"#ffb3ff"
734862146195034113,Luismar48429334,3,0,1,1,0.428614,0.747883,0,"#ffb3ff"
1434296603284852738,AlfonsoTobon4,3,0,1,1,0.523948,0.77354,0,"#ffb3ff"
802571244474396672,mvar1982,3,0,1,1,0.492132,0.767347,0,"#ffb3ff"
1253365605954129925,luisalb21370462,3,0,1,1,0.497326,0.743279,0,"#ffb3ff"
1011412452695830529,Rupesiempre,3,0,1,1,0.503402,0.769071,0,"#ffb3ff"
1457101298185211908,emomedu2022,3,0,1,1,0.511301,0.750902,0,"#ffb3ff"
1287824630430879744,maurici54093538,3,0,1,1,0.46187,0.769517,0,"#ffb3ff"
754450438716428289,lumaina37,3,0,1,1,0.507313,0.748409,0,"#ffb3ff"
970801814395383808,wilmarveraza1,3,0,1,1,0.432228,0.745603,0,"#ffb3ff"
1358588759680368641,colecci61695577,3,0,1,1,0.505843,0.773133,0,"#ffb3ff"
980642537579966464,SammyCoral,3,0,1,1,0.498542,0.762543,0,"#ffb3ff"
1139215434547376131,ClaudyC2019,3,0,1,1,0.486732,0.762031,0,"#ffb3ff"
1438531319244414983,HaroldAntonioC5,3,0,1,1,0.446322,0.740229,0,"#ffb3ff"
788434901905313792,annydiazgrana,3,0,1,1,0.521484,0.775602,0,"#ffb3ff"
1324034618283220997,liliorza,3,0,1,1,0.446646,0.753422,0,"#ffb3ff"
1154505097596035073,CiudadanoArist1,3,0,1,1,0.439239,0.753357,0,"#ffb3ff"
976315265842647040,UeaVain,3,0,1,1,0.499733,0.760391,0,"#ffb3ff"
835549234640400384,pedritoYWX,3,0,1,1,0.47196,0.777846,0,"#ffb3ff"
1191343553487818753,ProfeSimpatico,3,0,1,1,0.488063,0.759572,0,"#ffb3ff"
1291041012543115264,MamerOrgulloso,3,0,1,1,0.502711,0.755559,0,"#ffb3ff"
1275235447170641920,chavanestor1,3,0,1,1,0.504411,0.755077,0,"#ffb3ff"
988087695535681536,ganjah_lady,3,0,1,1,0.510079,0.768293,0,"#ffb3ff"
1178438317374889985,JECastellanos2,3,0,1,1,0.476926,0.757376,0,"#ffb3ff"
930160492097736710,HadaCharada,3,0,1,1,0.482885,0.747657,0,"#ffb3ff"
1451988365314871303,AlvaroM27793711,3,0,1,1,0.460133,0.764965,0,"#ffb3ff"
1037489845311090690,patricializca10,3,0,1,1,0.463064,0.743016,0,"#ffb3ff"
909652769346408449,Karina52201055,3,0,1,1,0.45364,0.75146,0,"#ffb3ff"
699429862277300224,gjgrodriguez,3,0,1,1,0.474881,0.742642,0,"#ffb3ff"
1394846189984571392,Piquia18,3,0,1,1,0.509855,0.762346,0,"#ffb3ff"
983684775603994624,TatianaPamela15,3,0,1,1,0.512375,0.757826,0,"#ffb3ff"
1479228528184938499,Mujermoderna3,3,0,1,1,0.477828,0.766556,0,"#ffb3ff"
1282140397964341248,Jess29162758,3,0,1,1,0.44008,0.738004,0,"#ffb3ff"
1456637407936274433,VeladiaKaliche,3,0,1,1,0.49732,0.762861,0,"#ffb3ff"
1434598950003171329,RoloFalla1,3,0,1,1,0.455385,0.763384,0,"#ffb3ff"
1021730307777744896,NidiaGonzlez13,3,0,1,1,0.473688,0.741518,0,"#ffb3ff"
1252101163522174979,JavierLeuro2,3,0,1,1,0.44877,0.765941,0,"#ffb3ff"
1262110779156967428,Almafuerteyvino,3,0,1,1,0.480984,0.751335,0,"#ffb3ff"
953104032037507072,scientilatina,3,0,1,1,0.497687,0.747298,0,"#ffb3ff"
1430948335976951827,OscarAMontoyaJ,3,0,1,1,0.456739,0.760192,0,"#ffb3ff"
1413599094984122374,sonnyraymondn,3,0,1,1,0.446124,0.757629,0,"#ffb3ff"
1056940916123025409,Totalalex1,35,1,1,2,0.32879,0.46068,0.000486,"#00faff"
1296579486721474560,SusanaRuthAran1,3,0,1,1,0.493854,0.77976,0,"#ffb3ff"
1310352782424264710,albayromero,3,0,1,1,0.472644,0.750352,0,"#ffb3ff"
1416207209105608705,nicovel98,3,0,1,1,0.481028,0.782852,0,"#ffb3ff"
1214745504741023744,MoomKeith,3,0,1,1,0.476466,0.780588,0,"#ffb3ff"
1272925680708304897,Miss_Downey_,3,0,1,1,0.477946,0.737337,0,"#ffb3ff"
792458315938791424,JairoGarciaXXI,3,0,1,1,0.50411,0.777461,0,"#ffb3ff"
758835996167331840,WifemaQ,38,0,2,2,0.451631,0.558221,0.000486,"#662859"
999914824095027200,AlirioJhonatan2,3,0,1,1,0.499511,0.766574,0,"#ffb3ff"
1140224625894416384,LinaMercedesGu1,3,0,1,1,0.456392,0.783473,0,"#ffb3ff"
1412196902125326339,TestAccountDev4,3,0,1,1,0.498988,0.743724,0,"#ffb3ff"
1419704061142646788,PaolaMu33003089,3,0,1,1,0.503817,0.749411,0,"#ffb3ff"
710827419394043904,MariePuren,36,1,4,5,0.443798,0.457673,0.001946,"#825403"
1392309512409812992,dh_japan,36,19,8,27,0.462586,0.470447,0.012646,"#825403"
735929506897235968,DigitalHumASA,36,14,0,14,0.462432,0.462436,0.006323,"#825403"
4327889474,aaDHumanities,36,15,3,18,0.467812,0.468647,0.008268,"#825403"
788574397896482816,MarianaSSABA,36,2,0,2,0.455927,0.331163,0.000486,"#825403"
1434992701582217220,dannavenezolana,3,0,1,1,0.48517,0.744925,0,"#ffb3ff"
1402451298121916417,OwsdColombia,3,0,1,1,0.450713,0.748776,0,"#ffb3ff"
1192798817713831937,PipeRom28063919,3,0,1,1,0.486534,0.765084,0,"#ffb3ff"
1239169956660592640,gorpeten,3,0,1,1,0.480024,0.752846,0,"#ffb3ff"
767745379957747712,luzmagcruz,3,1,10,11,0.509438,0.55425,0.004864,"#ffb3ff"
957205791173414912,Javi_Fdez_,22,0,10,10,0.535882,0.50778,0.004377,"#00e8b2"
749138439061274624,lsorianorobles,22,0,4,4,0.559622,0.584188,0.001459,"#00e8b2"
1082399728850124802,GUILLEMEMORIA,37,0,18,18,0.535955,0.486038,0.008268,"#006032"
978453592561672192,larhud1,49,95,23,118,0.489846,0.433899,0.056907,"#ff7007"
701832220089126912,coleman_kevin_p,34,9,0,9,0.36639,0.330303,0.003891,"#ff0d69"
1284915604198240257,Silviags19,34,0,1,1,0.318856,0.286205,0,"#ff0d69"
806423833397854208,datalabx,22,0,1,1,0.598318,0.598032,0,"#00e8b2"
1316651076762963971,avhr_bbaw,49,0,1,1,0.337371,0.472767,0,"#ff7007"
1397130908474527751,FiloClasicas,22,0,3,3,0.574061,0.516851,0.000973,"#00e8b2"
1032526967613087745,MAasxt,13,0,1,1,0.39961,0.500666,0,"#3bec00"
783376447964676096,amoterocleves,38,1,6,7,0.513852,0.43307,0.002918,"#662859"
977247348970676225,brie_marina,34,0,1,1,0.316799,0.281669,0,"#ff0d69"
1075908195460243471,JuanCarlosMezo,34,0,1,1,0.328341,0.283905,0,"#ff0d69"
1410357787272617985,ArtesUniandes,38,62,7,69,0.505135,0.449667,0.033074,"#662859"
906917734700679173,LoveALinguist,1,0,5,5,0.463156,0.584361,0.001946,"#b6cb00"
1187396533446217729,IreneLapuerta,22,0,1,1,0.610803,0.589425,0,"#00e8b2"
871666417065709568,Archivoz_es,1,0,2,2,0.456214,0.694408,0.000486,"#b6cb00"
978080298964602880,danilopenagosj,34,3,7,10,0.422928,0.430911,0.004377,"#ff0d69"
1176841765518790656,CanabarroRonald,49,5,0,5,0.456733,0.442441,0.001946,"#ff7007"
1158293563383275527,VRKingxyz,36,0,1,1,0.43091,0.300384,0,"#825403"
794193309220605953,ScholaCantorumB,30,1,0,1,0.727094,0.647936,0,"#ff77ff"
794593414763450368,11defebreroES,30,1,0,1,0.700082,0.640872,0,"#ff77ff"
815908947181916160,LHFC_UNED,30,1,5,6,0.599015,0.582819,0.002432,"#ff77ff"
1331949447178309641,women_legacy,22,0,1,1,0.608117,0.59104,0,"#00e8b2"
1317849861543333888,angelramireztro,22,0,1,1,0.606085,0.595323,0,"#00e8b2"
1464147760148811777,PortalEDIRED,22,21,3,24,0.56182,0.614016,0.011187,"#00e8b2"
1363423957349720065,reina_planeta,22,0,2,2,0.581994,0.603637,0.000486,"#00e8b2"
1447258474782642180,BerniTerenzi,36,0,1,1,0.512141,0.291685,0,"#825403"
1186504068954497025,Nanny89497957,22,0,9,9,0.537335,0.586382,0.003891,"#00e8b2"
1476322403802402816,kortegamelian,22,0,1,1,0.623102,0.590823,0,"#00e8b2"
1302536658995290114,RKeydar,36,0,2,2,0.467904,0.316337,0.000486,"#825403"
1455788696163258371,ArchHubCSIC,22,0,1,1,0.622805,0.589122,0,"#00e8b2"
1179812896378953728,AKebnekajse,35,0,1,1,0.413014,0.609097,0,"#00faff"
1181275002987073536,BelenLiedo,22,0,1,1,0.602067,0.597714,0,"#00e8b2"
1479190236546674698,TemploHera,35,0,1,1,0.403377,0.617522,0,"#00faff"
1058438436057726976,achatenetc,35,0,1,1,0.40809,0.615962,0,"#00faff"
1000829045293142021,Hael41965800,58,0,1,1,0.56844,0.178374,0,"#005076"
1071235686978609156,dhuppsala,34,6,1,7,0.488928,0.446197,0.002918,"#ff0d69"
956511810630422531,PatrimonioCM,58,0,3,3,0.594,0.288512,0.000973,"#005076"
792658087228366853,fiz_de_cotovelo,58,0,1,1,0.566384,0.168803,0,"#005076"
1109389796399550464,Aortalc1,15,0,3,3,0.505524,0.577334,0.000973,"#008ebb"
715553633337737216,Master_HD_UAB,14,77,60,137,0.530638,0.52038,0.066148,"#00eeff"
1088829885546668032,CIRGEN1,36,2,1,3,0.623314,0.457232,0.000973,"#825403"
711880656394043392,ToulouseUni,36,3,0,3,0.626183,0.453249,0.000973,"#825403"
971829971663622144,kstatespanish,0,3,0,3,0.92189,0.709082,0.000973,"#8ecfec"
1144248394208223234,pilar_molero,0,3,0,3,0.921907,0.714098,0.000973,"#8ecfec"
1155016546005258240,MCBouju,0,0,7,7,0.510933,0.455865,0.002918,"#8ecfec"
1082826724935696386,liteharto,13,68,39,107,0.471883,0.475877,0.051556,"#3bec00"
1274971877316997121,HiddenValencia,36,3,2,5,0.706278,0.495651,0.001946,"#825403"
1048767035298205696,RedArchivos,13,13,28,41,0.499543,0.4992,0.019455,"#3bec00"
994132204186988544,PColombineRM,0,1,0,1,0.919709,0.700076,0,"#8ecfec"
969924499830386688,apfeministas,0,1,0,1,0.906771,0.70908,0,"#8ecfec"
1191725643932848130,saberfuturo,21,18,0,18,0.214936,0.60612,0.008268,"#c6cc85"
781829562858663936,PoloDigitalMLG,14,31,4,35,0.619858,0.536771,0.016537,"#00eeff"
1455392005404647429,ValleImu,13,0,7,7,0.362066,0.382007,0.002918,"#3bec00"
4784430938,ITAMuniversity,13,1,0,1,0.316193,0.319535,0,"#3bec00"
966810100961824768,AnahuacMX,13,1,0,1,0.323664,0.317374,0,"#3bec00"
1130511651533393920,UPN_MX,13,1,0,1,0.316207,0.326265,0,"#3bec00"
1142058589747589120,Barbaracamilo6,21,0,1,1,0.15599,0.616487,0,"#c6cc85"
1115248963035238402,aprocyt,21,0,2,2,0.291369,0.530932,0.000486,"#c6cc85"
1235940353435369475,VerdeDeSperanza,21,0,1,1,0.165534,0.621762,0,"#c6cc85"
1307060231898312704,AntoBeingAnto,21,0,1,1,0.140899,0.603267,0,"#c6cc85"
809846413983092736,AlexArriazaM,21,0,1,1,0.162217,0.618497,0,"#c6cc85"
910572234166751235,LegadoBachelet,21,0,2,2,0.115654,0.625134,0.000486,"#c6cc85"
1245114389344198658,ferarriagadad,21,0,1,1,0.142023,0.610862,0,"#c6cc85"
1050470446687244289,_amayamendiko,37,1,6,7,0.532909,0.556756,0.002918,"#006032"
901764250351362048,gorgi_24,37,0,1,1,0.750805,0.64945,0,"#006032"
1459974034985299970,Adesvergonzadas,37,5,3,8,0.690545,0.6029,0.003405,"#006032"
1280593550250577922,Mirellarore,37,1,1,2,0.739211,0.628785,0.000486,"#006032"
1279134345828216834,ripomphei,37,1,0,1,0.756025,0.646995,0,"#006032"
1020295818144776192,AAlvarezOssorio,35,1,6,7,0.634227,0.481733,0.002918,"#00faff"
851072804552396800,fpsilva12,36,0,1,1,0.47566,0.251227,0,"#825403"
992605586931027968,carvlucas,36,1,1,2,0.486003,0.288922,0.000486,"#825403"
1448184128403394560,CsicLifehub,22,0,1,1,0.606471,0.59039,0,"#00e8b2"
1087045603178283011,languageinnova,37,0,1,1,0.21774,0.490907,0,"#006032"
1014966076084490240,_wepm,34,0,1,1,0.388235,0.458122,0,"#ff0d69"
1182676934842564609,Lab_HDig,36,52,34,86,0.511529,0.432794,0.041342,"#825403"
1066624777807429632,money_personal,37,1,0,1,0.583635,0.375147,0,"#006032"
1239277391656235013,MBelenBoned,1,0,6,6,0.503978,0.604125,0.002432,"#b6cb00"
850329407986249729,StuTS_official,35,4,0,4,0.48063,0.44465,0.001459,"#00faff"
1343516679893094400,Barbararomf,22,0,4,4,0.523011,0.526555,0.001459,"#00e8b2"
964273201323872257,SilviaMonMar,31,4,3,7,0.689552,0.562342,0.002918,"#3e93ff"
772534043745329153,piosdafabi,36,0,2,2,0.550409,0.399567,0.000486,"#825403"
996761785523982337,solaportillo,30,0,2,2,0.580965,0.577736,0.000486,"#ff77ff"
1169664354163335169,LnaSan1,30,0,1,1,0.652697,0.538375,0,"#ff77ff"
1231952570412867585,luppa_ufrgs,36,14,0,14,0.518958,0.300322,0.006323,"#825403"
801575992724783105,visusal,14,0,2,2,0.457039,0.662453,0.000486,"#00eeff"
1326221116474609666,MigSebastianMar,13,0,1,1,0.436763,0.40188,0,"#3bec00"
1317793943782887424,jrglmn,34,0,3,3,0.477519,0.45479,0.000973,"#ff0d69"
1126277650211905536,DeniseFrigo2,13,2,61,63,0.490337,0.466614,0.030156,"#3bec00"
1239920618323271688,rodrigo_turin,36,0,1,1,0.582276,0.29048,0,"#825403"
1357158375075815424,NMarxista13,36,0,1,1,0.581096,0.281048,0,"#825403"
1170963542243196928,OrrequiaAroa,13,4,10,14,0.467791,0.531327,0.006323,"#3bec00"
1104444221778550786,EEsp01,37,0,4,4,0.314404,0.496394,0.001459,"#006032"
1349415055931170817,cespeparaguay,37,0,4,4,0.310427,0.490649,0.001459,"#006032"
769942694735085568,Beatriz20D,37,0,3,3,0.319333,0.50108,0.000973,"#006032"
1405115612372914179,valentina_nesi,13,0,1,1,0.391942,0.486904,0,"#3bec00"
862992197507055616,CompDigitalUV,31,0,1,1,0.647568,0.514976,0,"#3e93ff"
1109452906028240896,enfanthese,34,0,12,12,0.509231,0.482536,0.00535,"#ff0d69"
790724351976931328,LFBSRJ,36,0,1,1,0.572003,0.287252,0,"#825403"
1159395633318547456,AndugarPaula,1,0,2,2,0.466215,0.703224,0.000486,"#b6cb00"
937515526628274177,RamonJacquet,37,0,1,1,0.182052,0.484812,0,"#006032"
1185529394296754178,lizMazacot,37,0,1,1,0.204437,0.469537,0,"#006032"
911193053641273344,openmethods_dh,49,29,4,33,0.44691,0.482315,0.015564,"#ff7007"
1065392962975264768,filologicos,1,0,10,10,0.478805,0.530087,0.004377,"#b6cb00"
1246855928449769475,JazzminRosa,37,0,1,1,0.205768,0.478015,0,"#006032"
1475203380855377927,FatimaPetters,37,0,1,1,0.206338,0.495349,0,"#006032"
4821514037,BlogAhoraELE,1,0,4,4,0.448081,0.687804,0.001459,"#b6cb00"
1158520085528506368,GaleLATAM,49,8,5,13,0.45153,0.40214,0.005837,"#ff7007"
704300151423242240,Actres_ule,1,0,4,4,0.468924,0.560429,0.001459,"#b6cb00"
1109082720418914305,mlochoafer,1,0,4,4,0.48897,0.656493,0.001459,"#b6cb00"
780760636493959169,marsosinski,1,0,5,5,0.488635,0.629496,0.001946,"#b6cb00"
1372566239126695942,MusivariaHD,30,5,4,9,0.550884,0.507552,0.003891,"#ff77ff"
935975151438585856,SolerMontes,1,0,3,3,0.449506,0.687278,0.000973,"#b6cb00"
792690756045725696,LINGDIG,1,0,3,3,0.456363,0.685287,0.000973,"#b6cb00"
1384830514108977159,museosdemadrid,58,0,1,1,0.601418,0.273482,0,"#005076"
1278023503804018690,CAMMARQ_MX,37,1,0,1,0.580307,0.377889,0,"#006032"
831564825914400768,swagunke,36,0,3,3,0.452784,0.432795,0.000973,"#825403"
1113905922697510918,prof_luighi,14,0,1,1,0.556509,0.584101,0,"#00eeff"
1184863774081241088,CinemahMov,31,11,1,12,0.665947,0.323268,0.00535,"#3e93ff"
1098294086853906438,AndreaConsalvi,13,0,5,5,0.497836,0.47807,0.001946,"#3bec00"
1466045589314015236,C21editions,49,0,4,4,0.433841,0.499516,0.001459,"#ff7007"
742376828111884291,kissimagarcia,36,0,2,2,0.561298,0.327575,0.000486,"#825403"
4843715943,ingdesoftware,14,1,1,2,0.554432,0.502976,0.000486,"#00eeff"
815181741472235520,PatriaGuarani_d,37,1,0,1,0.557211,0.367598,0,"#006032"
860156616271949824,ihrim_umr,37,2,0,2,0.587801,0.339456,0.000486,"#006032"
828863719434235904,RadioLabUGR,31,11,8,19,0.567358,0.510224,0.008755,"#3e93ff"
1122623101194383362,maria_galvan17,37,0,2,2,0.254196,0.467132,0.000486,"#006032"
1478467014738034688,PrazerLustosa,35,1,0,1,0.425187,0.481555,0,"#00faff"
1237515474755375104,labhdufba,36,106,22,128,0.506559,0.40303,0.06177,"#825403"
1299419197181693955,mavoparanhos,36,0,3,3,0.531445,0.349944,0.000973,"#825403"
1112882621338533889,GisellaGill,37,0,1,1,0.195467,0.484422,0,"#006032"
736674662277582853,silvi_brizuela,37,0,1,1,0.193726,0.493621,0,"#006032"
4335076636,mariapepamv,37,1,2,3,0.577823,0.34627,0.000973,"#006032"
1211341725374926848,SalimKhanAnmol1,36,0,1,1,0.504314,0.289165,0,"#825403"
1295849721257504769,redeh_moderna,36,0,3,3,0.544228,0.405678,0.000973,"#825403"
1202753815130394624,lf_slima,36,7,9,16,0.521891,0.329331,0.007296,"#825403"
1455953483891359745,historiapucrio,36,0,1,1,0.526157,0.240948,0,"#825403"
853214807826325508,chronohh,36,2,0,2,0.453819,0.344411,0.000486,"#825403"
1051987905877397505,IJIDI1,13,11,2,13,0.470954,0.486131,0.005837,"#3bec00"
1449125291641692160,sansalido,37,1,0,1,0.561988,0.362875,0,"#006032"
1200701274393628674,PauloAguiardos1,36,0,1,1,0.52922,0.327153,0,"#825403"
1236105601614299136,sarahmcoutinho,36,0,1,1,0.515437,0.327258,0,"#825403"
1030554999221313536,ratofebril,36,0,1,1,0.510562,0.329129,0,"#825403"
860697332828045312,techpearce,36,0,1,1,0.517233,0.293892,0,"#825403"
1224122905753088000,m_h_ramirez,34,0,5,5,0.421638,0.451637,0.001946,"#ff0d69"
1223742737222029312,osunile,13,0,2,2,0.431309,0.455772,0.000486,"#3bec00"
1370244144816349187,herdado,13,54,11,65,0.476432,0.480484,0.031128,"#3bec00"
995935159139610625,StanglWerner,34,0,2,2,0.438294,0.49516,0.000486,"#ff0d69"
1270516534348300288,Castordebiblio,13,0,8,8,0.4936,0.506295,0.003405,"#3bec00"
1377359761272897540,todoxnada2,37,2,0,2,0.596124,0.370658,0.000486,"#006032"
1326154999873892352,Teacher1Rosy,37,2,0,2,0.590063,0.374259,0.000486,"#006032"
1290455576800002049,amezaga_blanca,37,2,0,2,0.59375,0.373386,0.000486,"#006032"
1337258017016963073,GV5020,37,2,0,2,0.593604,0.365404,0.000486,"#006032"
1349526834480869378,AdrianaLpezSan4,37,2,0,2,0.587711,0.370982,0.000486,"#006032"
1381481296409423872,ClauVar73378515,37,2,0,2,0.591451,0.376572,0.000486,"#006032"
907672528851574784,RoFo2021,37,2,0,2,0.590991,0.369757,0.000486,"#006032"
1408433446205243400,ALUPIN49611638,37,1,0,1,0.703299,0.305108,0,"#006032"
1354623252031811584,AngryCuac72,37,1,0,1,0.696573,0.307414,0,"#006032"
822841304367464448,PutoMikel,35,3,0,3,0.4803,0.398747,0.000973,"#00faff"
991771874488147968,RaquelLiceras,4,12,11,23,0.488621,0.480219,0.0107,"#f4c8cf"
727614583922397185,f_humanidades,1,14,15,29,0.492819,0.539808,0.013619,"#b6cb00"
738094354045210625,Cdosvecesdom,13,2,10,12,0.519423,0.445883,0.00535,"#3bec00"
1415635407946100736,FormacionP_UNED,30,8,4,12,0.511597,0.60208,0.00535,"#ff77ff"
1435426234058616832,el_iva_n,35,1,0,1,0.43085,0.476649,0,"#00faff"
1443165058553499653,Miryam57690462,19,0,1,1,0.667494,0.775628,0,"#00d3ff"
1270721102789009409,critica_revista,36,0,1,1,0.536387,0.303942,0,"#825403"
885944535766978560,FabioMinervini,36,7,23,30,0.512659,0.401066,0.014105,"#825403"
1321167701075808257,padredemiranda,37,2,2,4,0.702998,0.282463,0.001459,"#006032"
1104108075387179013,MiguelAntonioG_,37,5,2,7,0.664688,0.319483,0.002918,"#006032"
1278472300967399426,ComeniusTri,22,1,0,1,0.496825,0.67871,0,"#00e8b2"
1224045314627325953,JR48237144,13,0,1,1,0.427541,0.516053,0,"#3bec00"
1145249481144881152,a_winkler3,13,0,1,1,0.439702,0.514453,0,"#3bec00"
1151132371632058375,VerbalHornung,13,0,3,3,0.444864,0.487156,0.000973,"#3bec00"
717623923668623360,textos_info,14,1,1,2,0.377506,0.5565,0.000486,"#00eeff"
1175227764703711234,ericfcarvalho,36,0,1,1,0.499454,0.240303,0,"#825403"
891804290737737728,EdgardoTempore1,49,4,15,19,0.476935,0.524792,0.008755,"#ff7007"
927647719782539265,IvonneSosaSanM1,4,0,4,4,0.943797,0.24461,0.001459,"#f4c8cf"
714783444757254150,cazadorcerebros,4,27,4,31,0.901551,0.257596,0.014591,"#f4c8cf"
902243707403063297,JesSalasAlvarez,35,0,4,4,0.533118,0.489391,0.001459,"#00faff"
1079492621452615682,JuanAnt54437386,43,2,0,2,0.835699,0.529586,0.000486,"#fcae7e"
899712531534671874,estudiodamiana,58,0,3,3,0.478756,0.566446,0.000973,"#005076"
1179753971659001857,GermanciuTW,58,0,2,2,0.516791,0.645706,0.000486,"#005076"
1462886193608069120,Bolcheviking,36,1,0,1,0.464035,0.339371,0,"#825403"
899851612138737665,bazang85,49,0,1,1,0.41233,0.514293,0,"#ff7007"
828453387234578440,YeOldePics,36,1,0,1,0.458726,0.33725,0,"#825403"
1350912817331908612,feipoll,37,1,0,1,0.720326,0.271497,0,"#006032"
1296115598653562884,LuisEUlangs,36,0,1,1,0.561231,0.314511,0,"#825403"
992427392802197504,joshua_w_d,36,0,1,1,0.555753,0.311476,0,"#825403"
1107398002828853253,RSprugnoli,36,0,3,3,0.492824,0.415777,0.000973,"#825403"
1142407026032562177,LoveYouVJAnna,30,0,1,1,0.510299,0.631425,0,"#ff77ff"
822406859571204096,uned_filologia,30,45,13,58,0.518596,0.573321,0.027724,"#ff77ff"
758507413494378496,oliviaUCSD,34,0,3,3,0.397928,0.427509,0.000973,"#ff0d69"
1187326637983055873,LeidyJTorresC,38,0,5,5,0.501311,0.4502,0.001946,"#662859"
1127630178644054018,stem_ai,0,0,8,8,0.443935,0.520667,0.003405,"#8ecfec"
1150757308802244609,CIGET_LasTunas,22,0,1,1,0.611835,0.615665,0,"#00e8b2"
1154746676294422529,AnaDiamond16,4,0,4,4,0.932006,0.255565,0.001459,"#f4c8cf"
1158580779687059457,YoanaEstradaR,4,0,4,4,0.902817,0.236022,0.001459,"#f4c8cf"
1451105184009105410,big_onion_tech,4,0,4,4,0.912895,0.238089,0.001459,"#f4c8cf"
1404480457106939904,internacionalzp,36,0,5,5,0.548952,0.322773,0.001946,"#825403"
1160606541604687873,cienlib,4,0,4,4,0.92866,0.25354,0.001459,"#f4c8cf"
1225487599147634688,SpinosaVittoria,4,0,4,4,0.910273,0.246994,0.001459,"#f4c8cf"
1235317545361641474,AmarillePer,4,0,4,4,0.916591,0.249151,0.001459,"#f4c8cf"
1025669551323848704,Thuban_Isesi,4,0,5,5,0.829306,0.325661,0.001946,"#f4c8cf"
1446511093606662147,Cultureclub_100,4,0,4,4,0.941257,0.246828,0.001459,"#f4c8cf"
1039779177740873728,iesneruda,4,0,4,4,0.902145,0.244768,0.001459,"#f4c8cf"
1131348955256762369,Micaela12104980,4,0,4,4,0.933636,0.235716,0.001459,"#f4c8cf"
792326791616663552,misspornotv,4,0,4,4,0.92707,0.237959,0.001459,"#f4c8cf"
1279499588513267712,Carmen31451831,1,0,1,1,0.706829,0.482541,0,"#b6cb00"
1194083717800714241,dxinahotmailco1,13,0,1,1,0.462335,0.296895,0,"#3bec00"
787366834580299776,Lmariav1,13,0,1,1,0.46783,0.295054,0,"#3bec00"
1274910124025487360,FIKM19,22,6,1,7,0.588776,0.544775,0.002918,"#00e8b2"
4485077452,RebecaRubioR,15,40,25,65,0.552636,0.565271,0.031128,"#008ebb"
1063044043523981312,FiloLab_UGR,1,0,3,3,0.591892,0.552819,0.000973,"#b6cb00"
1126486277942067200,soyjorgeluisgil,38,0,1,1,0.268504,0.615175,0,"#662859"
1171340194542424066,IberlabE,31,3,6,9,0.495254,0.503919,0.003891,"#3e93ff"
1300083781500645378,srsergior,38,1,5,6,0.516214,0.450564,0.002432,"#662859"
1216723370210988032,HispaniaUdc,14,30,12,42,0.527603,0.495065,0.019942,"#00eeff"
1374782833542234114,_sgesther_,30,1,4,5,0.581104,0.585787,0.001946,"#ff77ff"
1402560744781193220,charta_granada,1,1,0,1,0.41124,0.61141,0,"#b6cb00"
1269811901179080704,renatabiblioh,36,0,1,1,0.547603,0.302999,0,"#825403"
1355167841985716224,JavierMdMG,14,0,4,4,0.527264,0.488118,0.001459,"#00eeff"
1398866593237508100,CodeWithTwitchi,34,0,3,3,0.499967,0.417717,0.000973,"#ff0d69"
1259961273686659073,arqueoubu,14,0,2,2,0.560707,0.516515,0.000486,"#00eeff"
841246237684842497,cromantw,13,0,1,1,0.399464,0.484614,0,"#3bec00"
1394687466649657347,SEEC_Astur_Cant,1,0,1,1,0.270503,0.719189,0,"#b6cb00"
1378029716783951878,NexosMultimedia,43,1,1,2,0.684751,0.554244,0.000486,"#fcae7e"
4837861482,fcomUH,43,33,8,41,0.641741,0.541339,0.019455,"#fcae7e"
1371238762504728584,Valino_04,13,0,1,1,0.397033,0.482156,0,"#3bec00"
1437817764731817995,projectaltxa,13,0,1,1,0.395694,0.493758,0,"#3bec00"
722163646240059392,swaglordmlg,36,1,0,1,0.47757,0.3151,0,"#825403"
988881035147534337,JuanCarlosFlorG,58,3,4,7,0.572928,0.481863,0.002918,"#005076"
1454432677080276999,Guiller80680031,43,0,1,1,0.716939,0.550805,0,"#fcae7e"
826204298069557249,452FJournal,15,12,1,13,0.469491,0.587137,0.005837,"#008ebb"
1070512911364149248,vero_benitezp,41,21,25,46,0.433329,0.448922,0.021887,"#697b00"
1359160680901935114,aeonfers,41,7,4,11,0.389422,0.450709,0.004864,"#697b00"
4727030752,ArqueoRomARCYT,15,8,6,14,0.597988,0.650411,0.006323,"#008ebb"
833790055294631938,ceciliamr1948,2,0,1,1,0.655482,0.647749,0,"#ffa64e"
1362040541182119939,RectorJaveriana,49,2,0,2,0.462095,0.529028,0.000486,"#ff7007"
728453717670776832,JorgeGar1996,2,0,1,1,0.646984,0.653983,0,"#ffa64e"
763212059890814976,DigitalLabUDP,49,27,36,63,0.437668,0.481485,0.030156,"#ff7007"
1185192301682941952,nela08_cm,43,0,1,1,0.717486,0.553797,0,"#fcae7e"
801561985892618241,YunielArg,43,0,1,1,0.709889,0.563996,0,"#fcae7e"
951813390070054912,uicamaguey,43,0,1,1,0.706465,0.554154,0,"#fcae7e"
1364593605726375942,JorgeEr61334790,43,0,1,1,0.713545,0.549302,0,"#fcae7e"
1291277441919602689,Douglas_SPP,43,0,1,1,0.708936,0.560565,0,"#fcae7e"
837969237721432066,BilbaoAsFabrik,18,2,0,2,0.757469,0.593831,0.000486,"#5456a6"
1339077984410611712,ObservatorioGDC,43,0,6,6,0.646722,0.677834,0.002432,"#fcae7e"
1293620653988491272,SaladrigasHilda,43,1,0,1,0.606843,0.746864,0,"#fcae7e"
708763281234591748,nicado3,43,2,0,2,0.700269,0.674497,0.000486,"#fcae7e"
1007306542268534784,CanariasCultur,30,4,5,9,0.584666,0.554175,0.003891,"#ff77ff"
1058363812976451586,EncuentrosucmHA,14,17,5,22,0.518942,0.544483,0.010214,"#00eeff"
1121112164008374274,GarrigaLaurie,14,0,1,1,0.574383,0.482746,0,"#00eeff"
865130942381338625,rosarioariasUMA,14,2,24,26,0.533063,0.511724,0.01216,"#00eeff"
971241977000939521,MurryMits,34,0,1,1,0.315808,0.406767,0,"#ff0d69"
722415360885055488,mireyalozaphd,34,0,1,1,0.325799,0.423649,0,"#ff0d69"
700769634484498432,SEECExtremadura,58,0,3,3,0.669251,0.557353,0.000973,"#005076"
1259962752254296064,BibliotecaUns,39,5,1,6,0.630201,0.708948,0.002432,"#ff77f7"
1061070298995478533,kaleidosehun,36,0,1,1,0.527406,0.263077,0,"#825403"
4864538878,elias3177,41,0,1,1,0.339217,0.389058,0,"#697b00"
1425379265974001674,noviosociologo,41,0,1,1,0.319878,0.393588,0,"#697b00"
1206734977347596288,KleMorenoBueno,41,0,1,1,0.336845,0.384647,0,"#697b00"
1185219089880485888,Cel_53,58,0,1,1,0.558551,0.180528,0,"#005076"
1141835144178884613,2158_andres,41,0,1,1,0.336497,0.37756,0,"#697b00"
941430131012374533,Lecturas_sociof,41,0,1,1,0.312993,0.39725,0,"#697b00"
712439301355646977,ceanguel,41,0,1,1,0.328927,0.387979,0,"#697b00"
1348764282213728256,soyCaliAch,41,0,1,1,0.355639,0.376739,0,"#697b00"
769002505934032896,nadia_erre,41,0,1,1,0.345894,0.377205,0,"#697b00"
1256742816803258369,SalvadorBrios04,41,0,1,1,0.326181,0.37853,0,"#697b00"
1137186659777294336,JesicaOrduno,41,0,1,1,0.333921,0.386585,0,"#697b00"
1382197688590995462,nataliixcheltc,41,0,1,1,0.339438,0.371302,0,"#697b00"
889177007757701122,luismarceloh,41,0,1,1,0.314225,0.39259,0,"#697b00"
909456000700289026,2017_liraucio,13,0,4,4,0.472689,0.417671,0.001459,"#3bec00"
1373071927468814339,glaucioddias,36,0,1,1,0.540962,0.268986,0,"#825403"
1190457212768047104,olguesqui,41,0,1,1,0.314713,0.424794,0,"#697b00"
708873112968945665,RoninInstitute,36,3,0,3,0.468521,0.423716,0.000973,"#825403"
768543999464509441,vlifschitz1,41,0,1,1,0.309563,0.426264,0,"#697b00"
1371551211351121920,PythonRoboto,38,0,2,2,0.519155,0.408042,0.000486,"#662859"
1369849870123757568,fvallejol,38,0,2,2,0.525902,0.406282,0.000486,"#662859"
1429451300970844164,DanielArquivos,36,3,0,3,0.462675,0.425872,0.000973,"#825403"
878290543746461702,felibuster0,38,0,2,2,0.527015,0.41044,0.000486,"#662859"
1375490874906443779,HistoriaPTontos,35,1,0,1,0.474003,0.236492,0,"#00faff"
1328486294092189696,MapaSebas,35,1,0,1,0.492638,0.242553,0,"#00faff"
903262935618908160,LabCaHID,38,60,12,72,0.503696,0.461881,0.034533,"#662859"
1379899952072118273,nhDigitales,49,1,0,1,0.421666,0.702713,0,"#ff7007"
1250875378182258689,MonicaAvendaoV1,58,0,1,1,0.588064,0.17658,0,"#005076"
961637173266132992,AmigosAHN,22,1,8,9,0.581147,0.493019,0.003891,"#00e8b2"
1295488409302118407,sbhciencia,36,7,1,8,0.47575,0.349314,0.003405,"#825403"
1321189266903486465,enpunoyletras,31,0,2,2,0.724501,0.39802,0.000486,"#3e93ff"
1092303854924787713,carin0sita_,13,0,3,3,0.446957,0.457035,0.000973,"#3bec00"
727984050816856064,leogued,55,0,9,9,0.622129,0.641735,0.003891,"#cb3f32"
1448597007820546048,bibliotecajal,22,0,1,1,0.606561,0.688707,0,"#00e8b2"
1174339812700151808,Corpus_ODE,1,14,7,21,0.524917,0.567146,0.009728,"#b6cb00"
1062639282937122816,CulturaUbu,14,0,13,13,0.523098,0.490255,0.005837,"#00eeff"
1248298368910139395,eva_moreda,14,0,1,1,0.560917,0.588231,0,"#00eeff"
1434635100210216962,DaveBP2187,38,0,3,3,0.43937,0.334303,0.000973,"#662859"
1025165016620847104,podcastRAH,38,10,25,35,0.472091,0.408115,0.016537,"#662859"
1250818165887643649,melania_cabezas,31,0,2,2,0.723216,0.575427,0.000486,"#3e93ff"
1385220583042977798,santi_chambo,31,0,2,2,0.730626,0.577806,0.000486,"#3e93ff"
1217959590907863041,HermioneClone,34,0,2,2,0.4067,0.45517,0.000486,"#ff0d69"
999314599525699584,DavidMa75883744,30,0,1,1,0.509583,0.635912,0,"#ff77ff"
905360403336749056,PLNnet,35,2,0,2,0.453642,0.526292,0.000486,"#00faff"
1162443969932009472,python4living,38,0,1,1,0.557574,0.300595,0,"#662859"
1062780671037501440,AndresPelestor,13,0,1,1,0.423201,0.424177,0,"#3bec00"
804107314366136320,MarciaLima1971,36,2,0,2,0.491732,0.328289,0.000486,"#825403"
1247563444561289217,ppgihd,36,2,0,2,0.484624,0.321672,0.000486,"#825403"
1385695122042523648,ExpHD_UdeA,13,0,31,31,0.510827,0.498488,0.014591,"#3bec00"
1131572463597477890,Hitz_zentroa,34,25,16,41,0.484974,0.49617,0.019455,"#ff0d69"
1251928046036279296,REMED_20,13,0,4,4,0.466449,0.473153,0.001459,"#3bec00"
823878281695035394,siglo_18,58,0,8,8,0.548374,0.430683,0.003405,"#005076"
1238212851262722048,Ciclos_udp,49,5,5,10,0.37676,0.481897,0.004377,"#ff7007"
1012809059320389633,DH2022_Tokyo,36,2,2,4,0.437994,0.464146,0.001459,"#825403"
717642000871333888,haplapemlct,34,5,4,9,0.477027,0.490353,0.003891,"#ff0d69"
928400749574242304,MariaSotoQ,35,0,2,2,0.58134,0.444988,0.000486,"#00faff"
1381614050572914688,techguyjack,36,0,2,2,0.477013,0.360629,0.000486,"#825403"
871356497401454597,MedGoldenAge,58,6,15,21,0.490644,0.517961,0.009728,"#005076"
735382172476018689,cjulialuna,30,24,13,37,0.486038,0.597336,0.01751,"#ff77ff"
1082828825556381698,sarahrubia,36,1,6,7,0.516279,0.416728,0.002918,"#825403"
1394912452912074755,AfricanLits,49,1,0,1,0.305065,0.470196,0,"#ff7007"
1339305038032871425,clasicas_uva,1,1,2,3,0.479261,0.592021,0.000973,"#b6cb00"
1032017670852567040,HANNAZH4,38,1,2,3,0.426099,0.379182,0.000973,"#662859"
1442942126715723776,Rodriga07619388,30,0,3,3,0.525472,0.538588,0.000973,"#ff77ff"
1138533277818601475,FundacionByB,21,2,2,4,0.399101,0.464801,0.001459,"#c6cc85"
736151131286605824,AnaSnow13,34,0,1,1,0.330056,0.364027,0,"#ff0d69"
817050230155833344,ArchivoVieques,34,0,1,1,0.324166,0.37261,0,"#ff0d69"
1209204504165539840,cperezjimenez01,34,6,0,6,0.441837,0.446905,0.002432,"#ff0d69"
725441203118944256,jbretmaney,34,3,2,5,0.414252,0.459154,0.001946,"#ff0d69"
1324713293412470784,FCDHVieques,34,0,1,1,0.335153,0.370817,0,"#ff0d69"
839602142918938624,flakka82,34,1,2,3,0.515833,0.469193,0.000973,"#ff0d69"
1386623724280074241,ProjectSemap,35,2,2,4,0.399647,0.473461,0.001459,"#00faff"
848798493040881664,muartecu,35,3,0,3,0.408327,0.475391,0.000973,"#00faff"
1442774969323229190,Beclar_UNED,58,0,1,1,0.44632,0.634973,0,"#005076"
1333689330263601153,UbLinguistica,30,0,2,2,0.455835,0.520945,0.000486,"#ff77ff"
1275480504536576004,rmdiazb,58,0,2,2,0.545889,0.598107,0.000486,"#005076"
771828191128195073,purple_solvera,58,0,1,1,0.556847,0.185781,0,"#005076"
4856560239,IsabelSanz66,58,0,1,1,0.566383,0.180614,0,"#005076"
922146895241404416,MSUcollaborates,13,0,1,1,0.400926,0.444869,0,"#3bec00"
1278815100309254144,HuellasIncomoda,41,10,2,12,0.443278,0.442423,0.00535,"#697b00"
753709255807627264,Duaaramarut,13,0,1,1,0.396368,0.442159,0,"#3bec00"
1415102400835248133,softestecho_,36,1,0,1,0.484964,0.326991,0,"#825403"
1354157563114364929,iamgabbarson,49,0,6,6,0.440439,0.484787,0.002432,"#ff7007"
1339031215559553024,RatLabMuseum,36,0,3,3,0.467721,0.339806,0.000973,"#825403"
707739506603114496,Heritales,13,0,4,4,0.507427,0.494512,0.001459,"#3bec00"
894269694798159874,Unesp_TV,36,1,0,1,0.472516,0.331918,0,"#825403"
1203359851973398530,Lidia_PdV,13,2,2,4,0.448059,0.449668,0.001459,"#3bec00"
796497875765198849,RoyCobby,40,17,3,20,0.1476,0.370893,0.009241,"#ff12a3"
1234568252854087681,ieccs_,40,17,2,19,0.102029,0.397315,0.008755,"#ff12a3"
1296330472146993152,juancarlos_rozo,13,1,4,5,0.471686,0.4608,0.001946,"#3bec00"
879851301198278656,LuMende24,13,0,1,1,0.357781,0.505201,0,"#3bec00"
895455791267893248,katarinabundy,36,2,1,3,0.455418,0.459929,0.000973,"#825403"
865553956985946113,RRedine,22,0,3,3,0.576896,0.484508,0.000973,"#00e8b2"
1171034210192232448,ElTallerDeCTXT,40,0,2,2,0.097077,0.409141,0.000486,"#ff12a3"
1061771265130807296,merinored,40,0,2,2,0.106202,0.413603,0.000486,"#ff12a3"
729272394460835840,ManuelRomeroFer,40,0,2,2,0.0986,0.399752,0.000486,"#ff12a3"
1044196866353696770,infovestigacion,49,5,6,11,0.36212,0.498556,0.004864,"#ff7007"
1283896913608269826,Acofartes_,0,2,0,2,0.515725,0.419103,0.000486,"#8ecfec"
745429756812861440,LianaOsorio1,13,10,18,28,0.477582,0.403447,0.013132,"#3bec00"
1019681556548542464,TichaProject,13,0,5,5,0.490121,0.425415,0.001946,"#3bec00"
825174189162246144,pdrslvr,36,5,10,15,0.502174,0.381461,0.006809,"#825403"
744696909403684864,Eps5371,13,15,27,42,0.461354,0.418578,0.019942,"#3bec00"
1031259956035641345,Omar_AS_Isu,13,2,0,2,0.440711,0.33843,0.000486,"#3bec00"
1346648930948444160,ESACH_Evora,13,0,3,3,0.526906,0.433096,0.000973,"#3bec00"
889429484436418560,cidehus_ue,36,19,1,20,0.545374,0.442453,0.009241,"#825403"
855575697632505857,Litsilat2,37,0,1,1,0.561117,0.353218,0,"#006032"
1382978351955124224,dh_turkey,36,0,3,3,0.503772,0.496785,0.000973,"#825403"
1232414823893344256,PrensaUaq,13,1,2,3,0.404152,0.373858,0.000973,"#3bec00"
1129829057435230208,_narellano,38,0,4,4,0.288105,0.149026,0.001459,"#662859"
1207109788863258624,tolonista2,38,1,0,1,0.257767,0.105372,0,"#662859"
1290797653740134402,c_sanhueza_c,38,1,0,1,0.254776,0.109648,0,"#662859"
1451195687643742209,Casviscasillas,49,0,1,1,0.512165,0.732786,0,"#ff7007"
891619821028347904,congresoCICID,49,2,2,4,0.504145,0.653635,0.001459,"#ff7007"
1453012006060105728,danielnc_,49,0,1,1,0.503642,0.730671,0,"#ff7007"
784744520038637568,hernie1983,37,0,3,3,0.569275,0.381136,0.000973,"#006032"
836388241121153024,JMendezMartinez,49,5,19,24,0.497587,0.55663,0.011187,"#ff7007"
1391707291192336389,InsVelzquez7,58,0,1,1,0.458348,0.63973,0,"#005076"
975373216800739329,pseudoisabella,37,0,2,2,0.579682,0.35756,0.000486,"#006032"
1318998016620154881,CarlaoBot,37,0,4,4,0.391952,0.590004,0.001459,"#006032"
752755537100599296,eltioful,30,0,2,2,0.535757,0.65795,0.000486,"#ff77ff"
1321412793497780225,ScienceBot8,36,0,4,4,0.505319,0.272869,0.001459,"#825403"
1437184403462053890,chdunicamp,36,3,0,3,0.478038,0.307624,0.000973,"#825403"
1021465618011381760,IFCH_Unicamp,36,3,0,3,0.475507,0.307244,0.000973,"#825403"
1222750580390727685,khalilacp,34,0,8,8,0.422903,0.496411,0.003405,"#ff0d69"
977239071041912832,AniaRHdez,13,37,3,40,0.520854,0.474658,0.018969,"#3bec00"
1243362024127594500,faboramaa,35,2,7,9,0.476842,0.563773,0.003891,"#00faff"
1313283952673779713,AnthropologyBot,35,0,2,2,0.382779,0.521917,0.000486,"#00faff"
1245137134203387904,MatildeVargasH,35,1,2,3,0.424453,0.485954,0.000973,"#00faff"
912574159045115904,DigHumns_ANU,36,0,1,1,0.386609,0.474142,0,"#825403"
1326114549402046464,stheniosse_,36,1,1,2,0.456908,0.299455,0.000486,"#825403"
1125349461641842696,EuropeanAn,22,5,0,5,0.543286,0.536197,0.001946,"#00e8b2"
1187807025264283648,PerfilesUNAM,13,2,1,3,0.441549,0.461667,0.000973,"#3bec00"
929574097020956672,ArevaloGuizar,13,6,15,21,0.450486,0.45195,0.009728,"#3bec00"
1265458935726776326,Elisassgallardo,3,0,10,10,0.458293,0.678373,0.004377,"#ffb3ff"
1166022114702479367,BoteroCC,13,0,3,3,0.485827,0.453113,0.000973,"#3bec00"
1233887141408755712,TransUma,14,7,9,16,0.546287,0.508787,0.007296,"#00eeff"
826379445351149568,CiudadanoGamez,35,0,1,1,0.344654,0.500074,0,"#00faff"
4875570585,ArnaldusV,14,5,7,12,0.544823,0.566686,0.00535,"#00eeff"
913031252034379776,imfcsic,22,39,10,49,0.530523,0.569343,0.023346,"#00e8b2"
895689508972367872,PonceMartinezJF,15,0,1,1,0.393142,0.765877,0,"#008ebb"
1319266758616698880,MercePuigRE,22,0,1,1,0.539899,0.648007,0,"#00e8b2"
1164298987517698053,preservaDigital,35,0,1,1,0.577809,0.301238,0,"#00faff"
1014768317716889601,Kiwosancom,55,0,5,5,0.672372,0.591753,0.001946,"#cb3f32"
771784687060561920,TeredelRocio,35,0,1,1,0.572928,0.299475,0,"#00faff"
1305027683814797312,robotjuggler,55,1,0,1,0.74168,0.620116,0,"#cb3f32"
836945306998669312,sandra_copy,55,3,0,3,0.761647,0.651933,0.000973,"#cb3f32"
4851286607,davidperezmk,55,2,0,2,0.743459,0.646981,0.000486,"#cb3f32"
965567002214633472,apredig,13,0,3,3,0.514999,0.409052,0.000973,"#3bec00"
1300412833725853696,ppghufba,36,0,13,13,0.516441,0.401048,0.005837,"#825403"
1217582546646634496,AnpuhBa,36,2,1,3,0.488389,0.346135,0.000973,"#825403"
1090376233794318337,andreayaar,22,0,1,1,0.535838,0.638578,0,"#00e8b2"
1295807194580094977,cmch_historicas,7,0,1,1,0.413522,0.21165,0,"#ffb800"
1182821034547806209,CEAScdmx,7,3,2,5,0.441892,0.286998,0.001946,"#ffb800"
1245372231582171137,binobiasutti,36,0,4,4,0.498683,0.323054,0.001459,"#825403"
1356055663135354886,PhiTech_,38,0,7,7,0.519187,0.462475,0.002918,"#662859"
1207820335812431873,ArakadiaE,7,0,1,1,0.411611,0.214492,0,"#ffb800"
717105716885123072,layitx,37,1,0,1,0.229431,0.490515,0,"#006032"
1130792124675444737,WPGrinon,55,0,2,2,0.607502,0.513978,0.000486,"#cb3f32"
925836225315065857,ManzanillaMiel5,1,0,16,16,0.567953,0.526288,0.007296,"#b6cb00"
765555545550032897,Minitoz40,35,1,0,1,0.610539,0.450142,0,"#00faff"
1052173371465715714,BlueShield_Int,34,0,1,1,0.425168,0.57101,0,"#ff0d69"
1081752531758395392,RuthCaicedo14,49,1,8,9,0.496414,0.471924,0.003891,"#ff7007"
1221706313450901504,DokumentaV,1,2,15,17,0.495064,0.487181,0.007782,"#b6cb00"
1144979837632876545,Trab211,36,0,4,4,0.515066,0.255802,0.001459,"#825403"
737252789949190149,raul_villgrs,22,10,14,24,0.512994,0.540197,0.011187,"#00e8b2"
879124258701680640,z3perez,34,0,1,1,0.535079,0.378846,0,"#ff0d69"
937180087086125057,AlouquaViolet,38,0,1,1,0.52285,0.35617,0,"#662859"
1249908519559737345,Angalore2,38,2,5,7,0.50845,0.436418,0.002918,"#662859"
943677262917877761,SmartCitiesFeed,36,0,1,1,0.460787,0.274308,0,"#825403"
943678301393928193,GeosystemsFeed,36,0,1,1,0.487773,0.275318,0,"#825403"
1093455743955668992,dominichi,36,0,7,7,0.519019,0.398924,0.002918,"#825403"
923257301603115010,AD_CCyT,21,0,2,2,0.364103,0.475361,0.000486,"#c6cc85"
720813814904696833,mxlzinha,36,2,7,9,0.516237,0.35469,0.003891,"#825403"
1445466827216228357,cemop_lab,37,0,1,1,0.688572,0.326339,0,"#006032"
788430113859854336,unicampoficial,36,20,0,20,0.539005,0.308561,0.009241,"#825403"
966406486766292992,hdcicuba,30,35,21,56,0.534465,0.512163,0.026751,"#ff77ff"
1270370128014774273,kmanyola,30,0,6,6,0.471439,0.52062,0.002432,"#ff77ff"
1236009587477819394,GencoreUniandes,37,2,0,2,0.574123,0.392467,0.000486,"#006032"
1328336883500412932,UniCienciaSomos,34,1,2,3,0.617989,0.487539,0.000973,"#ff0d69"
987909175803080704,aprendizajeinfo,37,2,0,2,0.552577,0.464137,0.000486,"#006032"
1213877104657354757,CBDRS_BIDISO,14,18,12,30,0.540021,0.533119,0.014105,"#00eeff"
992961013879377920,apariciomex,13,0,4,4,0.467068,0.455955,0.001459,"#3bec00"
745294543507984385,mediateca_inah,13,5,0,5,0.49965,0.496036,0.001946,"#3bec00"
927406258268844032,fronteriza956,34,18,33,51,0.428103,0.431865,0.024319,"#ff0d69"
1184473847682211841,lenguapodcast,15,2,2,4,0.518913,0.560736,0.001459,"#008ebb"
1362444605128605698,JavariaAbbasi7,13,0,1,1,0.416262,0.428956,0,"#3bec00"
872882730215886848,maryknewman,13,0,1,1,0.412431,0.428558,0,"#3bec00"
719687574428782592,tainacan_l3p,36,7,2,9,0.497117,0.360103,0.003891,"#825403"
1170033775176298496,cenidiap_inbal,37,1,1,2,0.574706,0.32832,0.000486,"#006032"
1179020098197233665,civis_eu,37,1,0,1,0.639934,0.48974,0,"#006032"
818776501617393665,CienciaGob,30,12,0,12,0.493766,0.545758,0.00535,"#ff77ff"
1054435068804968448,EarlyModChicana,41,0,1,1,0.360494,0.390012,0,"#697b00"
1323424270425489409,Reina__Mariel,49,0,2,2,0.371329,0.592158,0.000486,"#ff7007"
1035968464274567168,FacundoMilman,49,1,0,1,0.298197,0.672006,0,"#ff7007"
1375187161125912582,jldp89,13,0,1,1,0.420697,0.412022,0,"#3bec00"
890037807682469888,JuanAstrolab,37,0,1,1,0.456942,0.205102,0,"#006032"
899733078641225728,FacebookWatch,7,3,0,3,0.375317,0.2424,0.000973,"#ffb800"
771533659815878656,PenelopeUbaldo1,34,0,7,7,0.500174,0.439051,0.002918,"#ff0d69"
1106060147108077569,WiliMarti,37,0,1,1,0.462294,0.214891,0,"#006032"
859329715697360896,etym_dub,34,0,3,3,0.4657,0.437048,0.000973,"#ff0d69"
1443112931684753408,Journal_DigHist,36,3,0,3,0.520398,0.449495,0.000973,"#825403"
1447566217603133443,iberia_meneses,37,0,1,1,0.692715,0.393262,0,"#006032"
1262599990247149569,delosquesobran,37,2,0,2,0.628909,0.399603,0.000486,"#006032"
1141653316851707905,UNEDfilosofia,30,1,3,4,0.536778,0.580714,0.001459,"#ff77ff"
719807030979141632,buenourbano,31,0,1,1,0.653626,0.387431,0,"#3e93ff"
1050722149634400256,thefluxions,31,2,1,3,0.593526,0.428422,0.000973,"#3e93ff"
1412777505417740288,pdh_journal,36,4,0,4,0.538376,0.392852,0.001459,"#825403"
819491398332379136,CotilleosUPO,37,1,0,1,0.572426,0.358635,0,"#006032"
1317491874471550976,MolinaGonzJR,30,0,1,1,0.516446,0.655794,0,"#ff77ff"
892418487930564608,aceved0villalba,22,0,2,2,0.582914,0.581517,0.000486,"#00e8b2"
1439920658180362247,CGrieb,13,0,3,3,0.482228,0.427277,0.000973,"#3bec00"
921124139850706946,luaramai,13,6,14,20,0.505663,0.43481,0.009241,"#3bec00"
962303224828039168,Colombianists,38,0,23,23,0.516379,0.458703,0.0107,"#662859"
1349900186181644297,Chanti25026845,13,0,3,3,0.486221,0.42128,0.000973,"#3bec00"
927252051725307904,Apcanoc,14,0,2,2,0.561821,0.601844,0.000486,"#00eeff"
914425926607425537,paoloroseano,30,0,1,1,0.46915,0.680593,0,"#ff77ff"
1306425463481470981,zettel57,38,2,0,2,0.396098,0.372911,0.000486,"#662859"
1268905120068251648,RevistasUAndes,38,2,0,2,0.393855,0.374042,0.000486,"#662859"
1354422829891149825,MarthaLux2,38,1,0,1,0.344236,0.356699,0,"#662859"
1166653478913138688,MWWForschung,13,1,0,1,0.400823,0.392571,0,"#3bec00"
1186123209118277634,Acacia33602548,38,0,1,1,0.324474,0.177806,0,"#662859"
781570475222769664,BiblioUniAlcala,31,8,0,8,0.598121,0.574024,0.003405,"#3e93ff"
750762938923884544,biblioinefupm,31,3,2,5,0.592536,0.588079,0.001946,"#3e93ff"
1267646017635340288,Sebasti19654409,38,0,1,1,0.278809,0.183284,0,"#662859"
1389415675572150277,marijalum,38,0,1,1,0.341952,0.17793,0,"#662859"
4858791321,siskor2,7,0,2,2,0.408532,0.330944,0.000486,"#ffb800"
1397732268010057734,TUniversidades,7,1,1,2,0.399078,0.33301,0.000486,"#ffb800"
1384639062737367042,Gutierrez96Alan,38,0,1,1,0.353698,0.186238,0,"#662859"
785610243866779649,camilamera_,38,0,1,1,0.336323,0.193961,0,"#662859"
1065679420038496256,andress08576666,38,0,1,1,0.329625,0.178365,0,"#662859"
939173341830766592,CamAndraLe,38,0,1,1,0.309061,0.170192,0,"#662859"
835849736188006400,ivanrodsoriano,38,0,1,1,0.343514,0.168363,0,"#662859"
1197220698764148736,SOLCHAred,14,0,4,4,0.428807,0.397155,0.001459,"#00eeff"
1242493043355176960,jmunevarc,38,0,1,1,0.347228,0.180947,0,"#662859"
1387677429653725195,Ana57005013,38,0,1,1,0.29875,0.182637,0,"#662859"
1050859076555558913,alejand79805141,38,0,1,1,0.346231,0.166169,0,"#662859"
953809627422044160,pagebutlocal,38,0,1,1,0.337139,0.18042,0,"#662859"
1250448508513124352,MarioMoroso1,38,0,1,1,0.313112,0.173861,0,"#662859"
763380943000309760,henaoivan04,38,0,1,1,0.286432,0.181258,0,"#662859"
902866813557624832,luisalvarogall1,38,0,1,1,0.320685,0.199218,0,"#662859"
852675360726667264,eljulius2211,38,0,1,1,0.286896,0.178855,0,"#662859"
1007352245661388800,carolvame,38,0,1,1,0.32056,0.18969,0,"#662859"
1063043010181713920,SoyJuanDuenas,38,0,1,1,0.300831,0.19676,0,"#662859"
1339005982987472896,EntreAmericas,38,0,1,1,0.292974,0.199021,0,"#662859"
1284996634825367552,socarraspi,38,0,1,1,0.344317,0.175511,0,"#662859"
1141180708569980929,Araanhaku,38,0,1,1,0.308919,0.174591,0,"#662859"
742534297987473408,1v4nD4r10,38,0,2,2,0.412469,0.341802,0.000486,"#662859"
1133755218775236608,AnaLaMilagrosa,38,0,1,1,0.355124,0.168964,0,"#662859"
4872514103,savelindaparada,38,0,1,1,0.309765,0.184865,0,"#662859"
1093360816093573120,Ulises66584647,38,0,1,1,0.298546,0.192052,0,"#662859"
1401306856937639939,SebastianConn18,38,0,1,1,0.315009,0.186994,0,"#662859"
1020022320323284992,stefaniaGT11,38,0,1,1,0.308171,0.199053,0,"#662859"
1111052722084691969,CanasRubencho,38,0,1,1,0.337958,0.18973,0,"#662859"
1295420679156895749,MamaduCisseMaCi,36,0,1,1,0.490948,0.290954,0,"#825403"
998602479309873153,CarnelosL,14,0,2,2,0.615525,0.505085,0.000486,"#00eeff"
982308925151178753,ADerechoCultura,58,11,10,21,0.592073,0.461461,0.009728,"#005076"
1357825634903461891,med_vanishing,36,0,1,1,0.391754,0.471553,0,"#825403"
1442678319686852608,MarielaZappala,58,0,1,1,0.663351,0.427201,0,"#005076"
937092114583838720,smorenab,58,0,2,2,0.62833,0.41367,0.000486,"#005076"
1363490889402896385,RodriguezCouto,58,1,1,2,0.637624,0.435661,0.000486,"#005076"
1005436073609179137,AModernistas,58,16,7,23,0.587287,0.446799,0.0107,"#005076"
864425724240855040,rsemap,58,21,6,27,0.601609,0.404822,0.012646,"#005076"
1282978915909283840,RPrivilegium,58,1,0,1,0.65611,0.429239,0,"#005076"
1184131169480249344,UFVinvestiga,15,0,2,2,0.536123,0.677556,0.000486,"#008ebb"
983759190207365121,denizcemonduygu,1,1,0,1,0.524202,0.653306,0,"#b6cb00"
1191660436971765762,FernandoGmezPr1,19,0,1,1,0.66652,0.767981,0,"#00d3ff"
728308814357909505,camontorroella,19,0,1,1,0.622381,0.802359,0,"#00d3ff"
1127980288997580802,trinxeramemoria,19,1,1,2,0.605655,0.751578,0.000486,"#00d3ff"
1364870888441716739,PeralGarrobo,14,0,2,2,0.551296,0.538496,0.000486,"#00eeff"
1324443986581442569,GatPrograma,37,0,1,1,0.566532,0.347135,0,"#006032"
1054910992277213189,Ana84450795,19,0,1,1,0.666943,0.79163,0,"#00d3ff"
787690626225737728,bonzos1979,38,0,4,4,0.660499,0.61129,0.001459,"#662859"
999423791615836165,CautivosNi,19,0,1,1,0.664293,0.793593,0,"#00d3ff"
1321066142476193792,isizquierdo1,31,1,3,4,0.614255,0.579608,0.001459,"#3e93ff"
1190299805723058177,MaraTeresaGilS1,19,0,1,1,0.606002,0.780616,0,"#00d3ff"
1252497143165849602,ccooultura,19,0,1,1,0.672197,0.789637,0,"#00d3ff"
1030553150741270528,CisquetMaqui,19,0,1,1,0.608367,0.787844,0,"#00d3ff"
1349781648808833029,MunainGorka,22,16,1,17,0.399478,0.618474,0.007782,"#00e8b2"
1098982940695060480,estefanialsalas,14,3,6,9,0.536392,0.518628,0.003891,"#00eeff"
4909960797,asanchezsanche8,30,0,3,3,0.551222,0.574117,0.000973,"#ff77ff"
861908586527686657,CeydeUPM,31,0,2,2,0.607522,0.599197,0.000486,"#3e93ff"
803996027149778944,Crai_Upr,30,0,4,4,0.548935,0.572351,0.001459,"#ff77ff"
925830117623988224,claudiabagla,14,0,4,4,0.5485,0.548923,0.001459,"#00eeff"
1444274235657105409,AFadonDuarte,14,0,2,2,0.557186,0.543524,0.000486,"#00eeff"
1009734447602765824,IankoLopez,30,1,0,1,0.492607,0.632326,0,"#ff77ff"
1004989511305220096,Emebebe1,22,0,3,3,0.536422,0.573328,0.000973,"#00e8b2"
1066420554784227328,brandonlobe,13,0,1,1,0.428403,0.413275,0,"#3bec00"
1425540745407127561,Pub_Humanities,41,0,2,2,0.357952,0.34406,0.000486,"#697b00"
921715586962481154,PAD_aka_Pete,22,0,1,1,0.297529,0.668866,0,"#00e8b2"
1252931535214444545,1Insumisx,22,0,1,1,0.305494,0.66825,0,"#00e8b2"
1222619941100249094,EEscombros,22,0,1,1,0.298444,0.659728,0,"#00e8b2"
1104062176761954304,Noemjimnez20,22,0,1,1,0.305786,0.673951,0,"#00e8b2"
1191405125803429890,HernandoSaeta,22,0,1,1,0.304549,0.663107,0,"#00e8b2"
1391801832024981507,piloco22,22,0,1,1,0.29293,0.661961,0,"#00e8b2"
864950196714778625,Livia_en_Roma,22,0,1,1,0.303163,0.665977,0,"#00e8b2"
857375146440630273,CIUPacifico,0,1,0,1,0.768817,0.488097,0,"#8ecfec"
702934769470988289,Ingenieria_UP,0,1,0,1,0.770118,0.496088,0,"#8ecfec"
1261368837188063232,100DaysofDH,49,0,10,10,0.435825,0.463992,0.004377,"#ff7007"
781673995343101952,Alba_Comino,4,4,0,4,0.467733,0.456352,0.001459,"#f4c8cf"
953205478036836352,DiggingCH,4,18,12,30,0.449954,0.469827,0.014105,"#f4c8cf"
908846368999051271,BIBENF_UFRGS,36,0,2,2,0.542887,0.305459,0.000486,"#825403"
4581241035,APuentesBlanco,22,3,8,11,0.548172,0.573503,0.004864,"#00e8b2"
1426225987356962816,emilio_vivo,15,3,1,4,0.518727,0.592355,0.001459,"#008ebb"
1426171049973063682,laprofedice_pod,14,0,1,1,0.566327,0.585829,0,"#00eeff"
1319654926876893185,ClaudiaDematte,14,1,0,1,0.431953,0.57229,0,"#00eeff"
1187337668792856576,EmmaMarcos,14,1,0,1,0.428304,0.577938,0,"#00eeff"
904028305774477313,celes_unsam,37,1,0,1,0.233606,0.485963,0,"#006032"
1069790442689097733,NayeliDrn,34,0,2,2,0.529199,0.408716,0.000486,"#ff0d69"
1252058233327452169,ocampo_rosibel,37,0,1,1,0.568059,0.348708,0,"#006032"
1324326310206910465,RAracne,14,26,2,28,0.519596,0.538079,0.013132,"#00eeff"
1410305101651234822,Jose_MFerreira,36,0,1,1,0.532284,0.338512,0,"#825403"
1311178850005549057,MServaPereira,36,0,2,2,0.516388,0.349872,0.000486,"#825403"
847038485118832640,ila_uca,14,0,2,2,0.571758,0.478388,0.000486,"#00eeff"
1062684024752218113,STeL_UB,14,0,3,3,0.55956,0.533126,0.000973,"#00eeff"
844820614980370432,Laboratorio_SQ,14,0,2,2,0.576649,0.476631,0.000486,"#00eeff"
1174685846127239169,MundosTrabalho,36,13,17,30,0.498678,0.39375,0.014105,"#825403"
1395682496713531396,UnlockArchives,4,15,3,18,0.514583,0.426032,0.008268,"#f4c8cf"
1258126171725860864,vopereyra,36,0,2,2,0.516721,0.358301,0.000486,"#825403"
878199405165383680,NobincisUCM,36,0,2,2,0.527202,0.472902,0.000486,"#825403"
782867596349759488,otriupsa,14,1,2,3,0.494162,0.549789,0.000973,"#00eeff"
1263419673296670721,ScriptoriumD,13,0,13,13,0.520901,0.522973,0.005837,"#3bec00"
1226214236348653571,GeoffCocksucker,49,0,1,1,0.340308,0.471903,0,"#ff7007"
1074238052334231552,damianmnts,1,0,2,2,0.487548,0.71657,0.000486,"#b6cb00"
1435257152382423049,cc2b_bot,37,0,9,9,0.569905,0.530563,0.003891,"#006032"
1386239953970122752,JMC_SCQ_1963,22,1,1,2,0.611305,0.516286,0.000486,"#00e8b2"
1181132607188275200,Jessica_tm9,30,0,1,1,0.535143,0.659081,0,"#ff77ff"
4723765936,J_RuanoG,14,0,2,2,0.562538,0.501994,0.000486,"#00eeff"
1396200873169195013,viaje_palabra,37,4,0,4,0.658161,0.372753,0.001459,"#006032"
1156240478406402048,BizarroLab,14,1,0,1,0.603422,0.371708,0,"#00eeff"
1269232742820126722,MuseosAndaluces,14,0,2,2,0.577843,0.479805,0.000486,"#00eeff"
1009905478053351424,Nerina_EAO,37,3,12,15,0.494749,0.546345,0.006809,"#006032"
963734195293032454,JorgeLeivaRojo,14,6,2,8,0.619323,0.514264,0.003405,"#00eeff"
1122841916377370627,MariaAgostinaS2,14,0,2,2,0.581116,0.483998,0.000486,"#00eeff"
1331365041556381703,HistArtUma,14,15,7,22,0.566494,0.502955,0.010214,"#00eeff"
775740202576781312,VisualizingPam,13,0,1,1,0.414262,0.483695,0,"#3bec00"
847083497122660353,MehlNathalie,49,0,1,1,0.342331,0.480583,0,"#ff7007"
1239837977829875715,r2gf_,1,3,0,3,0.463291,0.467965,0.000973,"#b6cb00"
800074668489093121,jackiealmo,49,0,1,1,0.295843,0.499734,0,"#ff7007"
953284807806644224,Xuanin_Asturies,49,0,1,1,0.306847,0.493796,0,"#ff7007"
903730366929928192,BiDi_UNAM,49,1,0,1,0.303203,0.496388,0,"#ff7007"
952329447532875778,Veritohj1,21,0,1,1,0.046467,0.638136,0,"#c6cc85"
1392487069717499904,antj_tinedo,30,0,1,1,0.52491,0.660114,0,"#ff77ff"
1265250972038844421,sibiuni,36,1,0,1,0.467213,0.320134,0,"#825403"
4645342272,NuclearWolf79,0,14,3,17,0.355626,0.460513,0.007782,"#8ecfec"
1217873092128780288,javierhist,34,0,7,7,0.47345,0.448551,0.002918,"#ff0d69"
4827425818,labra_burgos,21,0,1,1,0.006941,0.621728,0,"#c6cc85"
4765226075,PabloUmaran,21,0,1,1,0.009342,0.64207,0,"#c6cc85"
803986960754806784,Max201522c,21,0,1,1,0.035123,0.617861,0,"#c6cc85"
1425553651003711489,Luisiba05853774,21,0,1,1,0.019966,0.617851,0,"#c6cc85"
1055978478942732288,Tdcar4,21,0,1,1,0.033233,0.652872,0,"#c6cc85"
1379340372317462528,GrupoCadiz,31,1,2,3,0.61649,0.551631,0.000973,"#3e93ff"
895648741167816709,ab_eddo,21,0,1,1,0.025553,0.645944,0,"#c6cc85"
1226650903488475136,Xime16446443,21,0,1,1,0.005413,0.623965,0,"#c6cc85"
1194342958126043136,CAtenss,21,0,1,1,0.029628,0.623842,0,"#c6cc85"
1260770598952763393,VitalisSr,21,0,1,1,0.018181,0.619893,0,"#c6cc85"
1209993611619770374,sandros08288544,21,0,1,1,0.029123,0.612134,0,"#c6cc85"
1222138618715738112,laloAlarcn2,21,0,1,1,0.018083,0.62391,0,"#c6cc85"
1368250074539687939,carmen_borbaran,21,0,1,1,0.03751,0.650544,0,"#c6cc85"
1096215368358608897,carrasco_cueto,21,0,1,1,0.01774,0.614368,0,"#c6cc85"
1217947016413810691,Hector_LinaresG,58,0,3,3,0.561337,0.433938,0.000973,"#005076"
1183909366040334336,Cecilia77478756,21,0,1,1,0.051268,0.644436,0,"#c6cc85"
926582230784397312,Verukita1,36,5,0,5,0.433052,0.38049,0.001946,"#825403"
1273621434615631872,JoseLoneWolf,21,0,1,1,0.029119,0.648251,0,"#c6cc85"
923712344655650818,fercastilloruiz,21,0,1,1,0.041428,0.642431,0,"#c6cc85"
1314162984567083009,Spechtblue3,21,0,1,1,0.023315,0.650672,0,"#c6cc85"
1425174198364868610,pavlovarrientos,21,0,1,1,0.013271,0.63443,0,"#c6cc85"
1320491915305984000,Miral59633373,21,0,1,1,0.049895,0.649135,0,"#c6cc85"
1389855913218035712,AustenAll,30,0,1,1,0.501094,0.638552,0,"#ff77ff"
1325901893500071938,R_Descendientes,58,0,1,1,0.66198,0.35054,0,"#005076"
1094111943290470400,CarlosMendezNLP,38,0,3,3,0.470299,0.47269,0.000973,"#662859"
1395456640770527238,RicoNogu,38,0,3,3,0.468233,0.472283,0.000973,"#662859"
932679391540318209,LatineStories,41,1,0,1,0.36996,0.388827,0,"#697b00"
1059302147765035008,OnofrioTarsio,36,2,0,2,0.470376,0.317246,0.000486,"#825403"
1322173663198748675,CGMartinez21,41,0,2,2,0.349193,0.346309,0.000486,"#697b00"
1193337091851243521,Pinoyadjacent32,41,0,2,2,0.349906,0.354393,0.000486,"#697b00"
880118381021732864,MichaelBaysa,41,0,2,2,0.36049,0.347661,0.000486,"#697b00"
765759503140790275,zavoodie,41,0,2,2,0.354325,0.350038,0.000486,"#697b00"
1150983488062943232,HugoFilosofo,13,0,1,1,0.399963,0.488415,0,"#3bec00"
1192893485214502912,GalbarroJaime,14,0,15,15,0.500938,0.520044,0.006809,"#00eeff"
1194411527723454464,DarioHermo,34,1,0,1,0.407566,0.472821,0,"#ff0d69"
1263304939188731905,SharikaCrawfo17,34,0,1,1,0.440733,0.381293,0,"#ff0d69"
1390368947820810241,agendahistoria,36,0,1,1,0.558325,0.277916,0,"#825403"
850113100435083264,jioguinun_,13,0,1,1,0.426715,0.435182,0,"#3bec00"
1172482407397765123,eea_csic,1,7,2,9,0.412796,0.702321,0.003891,"#b6cb00"
1007750569916694528,imorenonava,13,3,3,6,0.514685,0.468011,0.002432,"#3bec00"
1366772076959445000,2Batuta,1,0,1,1,0.352551,0.743488,0,"#b6cb00"
914334305614274560,Araceli_ENTHUMN,22,0,3,3,0.471109,0.675411,0.000973,"#00e8b2"
1028714800283615233,edhuUDEM,4,1,0,1,0.439203,0.275682,0,"#f4c8cf"
1423291747438714891,NEPEHD,36,19,6,25,0.468642,0.34215,0.011673,"#825403"
1224365686782296064,DigitalesMaster,37,62,47,109,0.514374,0.499749,0.052529,"#006032"
796717568010625024,GIPIUAHResearch,37,1,0,1,0.692749,0.49485,0,"#006032"
1067712104063479809,SPeperstraete,4,0,2,2,0.506143,0.386667,0.000486,"#f4c8cf"
1082801917594603522,Joyceane_g,36,0,1,1,0.468839,0.231697,0,"#825403"
722549283283726336,bioviniciux,36,0,1,1,0.479169,0.231409,0,"#825403"
1403821200959279104,laybeth_b,35,0,1,1,0.733511,0.412705,0,"#00faff"
1126975208802398208,PedroMuro11,35,0,1,1,0.721835,0.417464,0,"#00faff"
925597948410580993,RoccoLozano,37,4,9,13,0.570182,0.493878,0.005837,"#006032"
1052888164304605190,loepUCM,30,2,1,3,0.532529,0.564834,0.000973,"#ff77ff"
1101171518413910016,fps_gbg,49,0,1,1,0.361614,0.47571,0,"#ff7007"
1141063687459020800,YPereiraMelo,37,5,9,14,0.557584,0.49863,0.006323,"#006032"
1367324153179598849,rehvira,37,0,1,1,0.55341,0.377297,0,"#006032"
1272370355919892480,alberto_app,13,2,1,3,0.443863,0.38159,0.000973,"#3bec00"
1116045615325155328,panoptikuhn,37,2,0,2,0.64755,0.496048,0.000486,"#006032"
1381908052899733505,SrtaCarnahan,58,0,2,2,0.640427,0.398328,0.000486,"#005076"
986678407625920513,SWHPubLib,30,1,0,1,0.514814,0.637882,0,"#ff77ff"
1175349369962475520,IT_GesPub,37,11,18,29,0.621111,0.54009,0.013619,"#006032"
1317876121418039296,discus_group,37,1,0,1,0.692062,0.49067,0,"#006032"
1336670103656570883,GamesJackhammer,0,0,1,1,0.298246,0.460649,0,"#8ecfec"
1300494075548893184,madlonz4,58,0,1,1,0.574005,0.161763,0,"#005076"
1158792716110749698,foro_deh,10,14,3,17,0.412019,0.37569,0.007782,"#52d7c0"
941129205693190144,mmoonyx,37,0,1,1,0.533289,0.271261,0,"#006032"
1367865108999897090,andrefmpaiva,36,0,4,4,0.529798,0.41355,0.001459,"#825403"
1039704599031103488,DoctoradoTes,37,1,0,1,0.697176,0.287883,0,"#006032"
772417876057808896,madrida360,58,0,1,1,0.570775,0.163774,0,"#005076"
1366126511015739405,arriety80,58,0,1,1,0.578325,0.191215,0,"#005076"
1386710525850050562,artefactos_usal,37,3,0,3,0.584369,0.309738,0.000973,"#006032"
1320479956246405121,MarianoMVillu,37,0,1,1,0.617888,0.239719,0,"#006032"
965937765144846337,SettembriniSein,37,0,1,1,0.615166,0.237726,0,"#006032"
775163304939511809,huerta_ricard,31,1,4,5,0.566608,0.47155,0.001946,"#3e93ff"
1360229638413328392,EajpTei,49,0,1,1,0.355119,0.477759,0,"#ff7007"
941015027053727744,PDGUZ,37,1,0,1,0.568452,0.364337,0,"#006032"
1147824745032945665,StellizHt,4,78,1,79,0.796432,0.266166,0.037938,"#f4c8cf"
1252171810289995776,NegueruelaDario,38,0,6,6,0.515203,0.4883,0.002432,"#662859"
1036510764738244609,SEDIAgob,37,2,0,2,0.71994,0.526363,0.000486,"#006032"
1121364987178618880,UNEDNLP,37,2,3,5,0.582716,0.540125,0.001946,"#006032"
1306383429848662016,LabVoces,37,0,3,3,0.545735,0.471808,0.000973,"#006032"
1027409451890880512,Faby_Nava77,4,0,2,2,0.654802,0.352644,0.000486,"#f4c8cf"
1192643174218510336,artemalvac,37,0,4,4,0.670458,0.428721,0.001459,"#006032"
948887351882846208,agaitant,37,0,2,2,0.637258,0.552319,0.000486,"#006032"
1268624675522981888,fesea64,4,0,1,1,0.848288,0.229097,0,"#f4c8cf"
1113571508612358144,marilou2019,4,0,1,1,0.857952,0.247168,0,"#f4c8cf"
1081199984052035584,Didacus_QB,34,0,3,3,0.505203,0.42155,0.000973,"#ff0d69"
880342914630660096,clio_wrestler,58,0,2,2,0.649999,0.396227,0.000486,"#005076"
4734741924,tjcarib82,4,0,1,1,0.854073,0.220325,0,"#f4c8cf"
1066027077676224514,Jaguarmex1,4,0,1,1,0.845524,0.241258,0,"#f4c8cf"
1265738979233746944,nephsufrrj,37,2,0,2,0.577052,0.334713,0.000486,"#006032"
1090412742404648960,ReivindicNal,4,0,1,1,0.850789,0.216396,0,"#f4c8cf"
830818727453138944,luaradel,4,0,1,1,0.840191,0.236284,0,"#f4c8cf"
1243416361797169153,ROXCOCA1,4,0,1,1,0.860445,0.218024,0,"#f4c8cf"
1214899831258439680,abdelvan8009,4,0,1,1,0.834215,0.215289,0,"#f4c8cf"
858491226731028480,iTenienteDan,4,0,1,1,0.866916,0.253469,0,"#f4c8cf"
911320934383890432,EdgardAguilar2,4,0,1,1,0.850824,0.240452,0,"#f4c8cf"
1314609245812404224,AzanedoM,58,0,2,2,0.653911,0.39839,0.000486,"#005076"
775677347592888320,IF_Espana,37,0,3,3,0.711868,0.501277,0.000973,"#006032"
940938863790428160,Sorbonne_Univ_,37,1,0,1,0.782692,0.494175,0,"#006032"
1133523609455091718,modernaemfoco,58,0,4,4,0.579994,0.441146,0.001459,"#005076"
857217909629779969,amloalacarcel,4,0,1,1,0.879929,0.231799,0,"#f4c8cf"
1287946333224132609,LUISMAR98623651,4,0,1,1,0.849457,0.21081,0,"#f4c8cf"
783312089767026688,malenassm,4,0,1,1,0.84923,0.243189,0,"#f4c8cf"
818154669792890880,ChangoBananero7,4,0,1,1,0.889906,0.234053,0,"#f4c8cf"
4721511432,Psicobable,4,0,1,1,0.840596,0.217255,0,"#f4c8cf"
1270160547099574277,JosLuisPortil20,4,0,1,1,0.875965,0.250762,0,"#f4c8cf"
1266182417284505600,ngelaMontes6,4,0,1,1,0.838471,0.242215,0,"#f4c8cf"
728100120441458688,rsanchezpsique,4,0,1,1,0.881275,0.24434,0,"#f4c8cf"
1121610816707530752,JuanCar16821253,4,0,1,1,0.848113,0.244914,0,"#f4c8cf"
1110653685024129024,JokinSup,4,0,1,1,0.851955,0.22515,0,"#f4c8cf"
1059168294354214912,whoopsiedoopsi2,4,0,1,1,0.850643,0.214212,0,"#f4c8cf"
1295356746630934531,JhorEl46367598,4,0,1,1,0.842447,0.220587,0,"#f4c8cf"
1239231847072235521,GIAP_ICAC,4,1,3,4,0.585899,0.706248,0.001459,"#f4c8cf"
1217361330786664450,ICAC_cat,4,3,6,9,0.582586,0.711912,0.003891,"#f4c8cf"
1359866767112359936,paloma_aliende,4,0,3,3,0.598424,0.705611,0.000973,"#f4c8cf"
1129762583404253185,agarciag_UAH,37,1,3,4,0.573276,0.46704,0.001459,"#006032"
1322109481787052032,SpainIcon,37,0,2,2,0.685321,0.503984,0.000486,"#006032"
968902304530337793,AECPA_,37,8,1,9,0.651537,0.517736,0.003891,"#006032"
897940722392813569,CAA_Australasia,13,2,2,4,0.444011,0.435313,0.001459,"#3bec00"
1175018459425587200,llamadme_susan,37,0,2,2,0.721503,0.629283,0.000486,"#006032"
1090298224492068865,ainavidalpe,37,1,0,1,0.758459,0.695413,0,"#006032"
1414065872495390720,a_solernou,49,0,7,7,0.487779,0.475664,0.002918,"#ff7007"
1273368107990560769,cehisunmdp,49,0,3,3,0.464502,0.474342,0.000973,"#ff7007"
1064220753351069702,SilGFerreyra,49,0,6,6,0.502758,0.480316,0.002432,"#ff7007"
1361698646903914504,destinoUAM,37,0,1,1,0.655158,0.402814,0,"#006032"
1268502043372781568,AndersonsWeb,36,2,1,3,0.464146,0.354108,0.000973,"#825403"
749764966174056448,Yenice91,38,0,5,5,0.501136,0.469019,0.001946,"#662859"
834478797567070208,sera_el_sereno,13,0,1,1,0.458574,0.396357,0,"#3bec00"
709057534510952449,Rivero_MPilar,38,0,1,1,0.728498,0.582947,0,"#662859"
1245145031045980163,Enn69027260,38,0,1,1,0.707537,0.583749,0,"#662859"
719288111998574593,pablaevelina,49,1,6,7,0.449173,0.528536,0.002918,"#ff7007"
975445388646903808,HDRio_2018,36,15,0,15,0.49741,0.389151,0.006809,"#825403"
1321330133064699904,aluzsanchez1,38,0,5,5,0.485333,0.465418,0.001946,"#662859"
4706485827,JoseDavCortes,38,0,6,6,0.484071,0.465002,0.002432,"#662859"
1374636733682229248,harvest57688777,0,0,1,1,0.284233,0.452569,0,"#8ecfec"
991515881590087680,saltydogsbot,0,0,1,1,0.293818,0.467341,0,"#8ecfec"
1317601620113412096,DavidMolinaRom1,37,0,2,2,0.691337,0.506054,0.000486,"#006032"
719816239124783105,XHumDigitUAB,14,56,15,71,0.570355,0.546922,0.034047,"#00eeff"
1039162341865205767,vbucs_,21,0,1,1,0.33483,0.445662,0,"#c6cc85"
868197680522178560,m_horno,14,0,1,1,0.64071,0.574493,0,"#00eeff"
717732084899381248,IberoPublica,13,3,0,3,0.456789,0.374633,0.000973,"#3bec00"
949376259326398464,joseangelguio,37,0,2,2,0.650789,0.552097,0.000486,"#006032"
1042058069843296257,DeUaq,13,20,23,43,0.446288,0.493073,0.020428,"#3bec00"
1356726225935470593,reneca_mx,13,0,1,1,0.472643,0.337607,0,"#3bec00"
1409453849333702657,DhUnige,49,0,1,1,0.340544,0.477285,0,"#ff7007"
885267834938556416,tonikasius,37,0,2,2,0.565067,0.534562,0.000486,"#006032"
1387346503673524229,feryx92,7,5,0,5,0.446538,0.375581,0.001946,"#ffb800"
1244496800775536645,maxenegreteg,13,0,1,1,0.486219,0.341583,0,"#3bec00"
849599580224278528,G_Adamez_C,14,0,7,7,0.53887,0.554582,0.002918,"#00eeff"
854958702197125121,Ahistcon,19,8,0,8,0.608768,0.683878,0.003405,"#00d3ff"
1031699643745353728,yayoelmx,0,0,1,1,0.288122,0.463611,0,"#8ecfec"
4749406357,cnatalia003,37,0,1,1,0.168434,0.614446,0,"#006032"
1352388332949528578,proyecto_narra,34,2,0,2,0.534124,0.354156,0.000486,"#ff0d69"
950312676894367744,DevMicrocosm,0,0,1,1,0.295777,0.456856,0,"#8ecfec"
4898171715,lozgarrido,15,38,17,55,0.534067,0.534155,0.026265,"#008ebb"
1264857541726605313,Marisonne1,37,0,6,6,0.573842,0.547408,0.002432,"#006032"
4866873579,margalarramendi,15,5,6,11,0.540581,0.668501,0.004864,"#008ebb"
801028007901143040,hidalgo_tenorio,37,0,8,8,0.526038,0.528271,0.003405,"#006032"
1345906682967302151,Vernica07217584,37,0,1,1,0.179935,0.477852,0,"#006032"
1155659344513576960,lourdes59219983,37,0,1,1,0.190318,0.489015,0,"#006032"
1376256325106171909,Nughuffer19821,37,0,1,1,0.218783,0.477016,0,"#006032"
954361349529853952,SEHMedicina,22,4,2,6,0.522128,0.564306,0.002432,"#00e8b2"
1347656361677631490,HPSshouts,22,0,4,4,0.483353,0.538258,0.001459,"#00e8b2"
1427344356097282067,nesm_py,37,0,1,1,0.194099,0.471358,0,"#006032"
1156561948588335104,JudithM28329174,37,0,1,1,0.20578,0.480397,0,"#006032"
717465024168640512,masterencritica,37,2,2,4,0.600653,0.487818,0.001459,"#006032"
916320498086305793,Portico_Digital,36,1,0,1,0.478198,0.270435,0,"#825403"
710519898477350912,ITHAKA_org,36,1,0,1,0.467067,0.272244,0,"#825403"
1248332926602838016,Infusionlogica,37,2,0,2,0.717967,0.49491,0.000486,"#006032"
1353818617171722240,JRicardoHuesca1,13,0,3,3,0.432837,0.465801,0.000973,"#3bec00"
1182703047782359041,JoseMTorralba,37,0,1,1,0.617831,0.465114,0,"#006032"
1232831486849671172,netoahenrique,36,0,2,2,0.534733,0.328488,0.000486,"#825403"
1037285417261953024,AndalusHistoria,22,2,1,3,0.699278,0.66567,0.000973,"#00e8b2"
1134816808408702976,YuriPires6,36,4,5,9,0.519448,0.377521,0.003891,"#825403"
1370255487237828609,Zinnyharmony,36,0,2,2,0.540603,0.328657,0.000486,"#825403"
1132124495173623809,ErichsenLucas,36,2,4,6,0.491232,0.320385,0.002432,"#825403"
1226452425214656512,XmlTeiCz,36,0,1,1,0.463214,0.282517,0,"#825403"
780149787303682048,GameHistoryOrg,36,2,0,2,0.487396,0.323635,0.000486,"#825403"
834094283741396992,EMWmatt,36,0,1,1,0.454867,0.278338,0,"#825403"
970596409975156737,fdmhildesheim,13,0,8,8,0.471751,0.454201,0.003405,"#3bec00"
714465139899166722,intcocho,14,2,4,6,0.467625,0.588796,0.002432,"#00eeff"
772458210636787712,vwestric_west,36,0,3,3,0.465491,0.419545,0.000973,"#825403"
1157433162978537478,ciclo_a,36,0,1,1,0.517756,0.243373,0,"#825403"
1219556753051963392,cultivate_mss,36,0,1,1,0.472882,0.274926,0,"#825403"
1372114308004515844,DHCSSza,36,0,2,2,0.399697,0.462209,0.000486,"#825403"
1379808931787251721,dhtech_group,36,9,0,9,0.443166,0.454591,0.003891,"#825403"
1169316589818339328,a_adban,14,1,0,1,0.329198,0.433245,0,"#00eeff"
1427669951041703941,lamariadetodas,13,0,1,1,0.424031,0.401689,0,"#3bec00"
786490414953934848,MaquisPelicula,19,7,3,10,0.625189,0.743407,0.004377,"#00d3ff"
1002272500301037569,WikiDienstag,36,2,0,2,0.447263,0.336513,0.000486,"#825403"
1168892162253164544,DH_unibe,36,2,0,2,0.458641,0.320675,0.000486,"#825403"
719223478516375554,Expectativas01,30,0,1,1,0.612673,0.479124,0,"#ff77ff"
1356231879528230912,rzine_shs,34,0,3,3,0.483677,0.419975,0.000973,"#ff0d69"
842524220684943360,LASARESEARCH,37,13,7,20,0.502565,0.425147,0.009241,"#006032"
1045633197231550465,innova_udc,14,4,12,16,0.534695,0.529037,0.007296,"#00eeff"
1271560158657892353,ArchTrans,49,2,0,2,0.358607,0.496353,0.000486,"#ff7007"
935181221893730309,verogomezphd,49,3,9,12,0.437065,0.481815,0.00535,"#ff7007"
1034180055453392896,HGCP_UC,7,12,4,16,0.418381,0.315598,0.007296,"#ffb800"
1379837194282663936,EmyRodas9,14,0,1,1,0.589162,0.461041,0,"#00eeff"
1264514995192303620,jrastiz,14,4,3,7,0.568972,0.474473,0.002918,"#00eeff"
1329254341446938629,KAoghz,13,0,1,1,0.415836,0.479905,0,"#3bec00"
1069362034532368384,lioshenkawaco,34,0,1,1,0.453888,0.380936,0,"#ff0d69"
755692362890903552,LaTardeCOPE,14,1,0,1,0.417675,0.628002,0,"#00eeff"
1055387920343851008,Mojarromero,15,9,4,13,0.489392,0.564377,0.005837,"#008ebb"
1072849421392625665,leandro2404,36,0,1,1,0.527919,0.24324,0,"#825403"
1124765991924199424,aliciabedul,34,1,3,4,0.388936,0.426129,0.001459,"#ff0d69"
974330797971988482,HabEscritoras,41,3,7,10,0.31147,0.370787,0.004377,"#697b00"
1274088069294108672,addictgirls,34,0,3,3,0.490362,0.407602,0.000973,"#ff0d69"
1043929150057320454,psychicdeath,36,0,2,2,0.483901,0.376824,0.000486,"#825403"
1199354869133524992,mrcsalb,36,0,2,2,0.484333,0.381075,0.000486,"#825403"
1138839334537367553,Oresto18,36,0,3,3,0.488175,0.348082,0.000973,"#825403"
1348558873636921349,opensource_orgs,49,0,5,5,0.405683,0.456617,0.001946,"#ff7007"
907721809075863552,StephanieSR05,38,0,8,8,0.554979,0.446799,0.003405,"#662859"
1018318954555723776,UnedMexico,30,6,6,12,0.535952,0.541774,0.00535,"#ff77ff"
1415718246997794821,JulioAGonzlezM3,13,0,1,1,0.416578,0.426717,0,"#3bec00"
1200223080070692872,vitamina_leo,36,1,3,4,0.495374,0.319005,0.001459,"#825403"
750983484869574656,Robertosants824,36,0,2,2,0.484691,0.268572,0.000486,"#825403"
1060729022504730630,M4tDicas,36,0,2,2,0.489516,0.270569,0.000486,"#825403"
1363516760922738691,antineurose,36,0,2,2,0.464266,0.270477,0.000486,"#825403"
1303006978680201220,biblio_utadeo,38,1,0,1,0.334111,0.354506,0,"#662859"
994990845379129344,AMAUSAOrg,41,1,0,1,0.244196,0.337712,0,"#697b00"
847851963773460481,AndrosSpica,4,0,2,2,0.545063,0.684732,0.000486,"#f4c8cf"
728316752766062593,s_boadas,14,10,30,40,0.521528,0.527531,0.018969,"#00eeff"
1281253609988997120,100DaysOf2020,49,0,1,1,0.357753,0.479265,0,"#ff7007"
1364497572509880322,Bills_Bot,49,0,1,1,0.349481,0.482743,0,"#ff7007"
1127829883013361665,xaelbot,49,0,1,1,0.357949,0.46857,0,"#ff7007"
716938037696061440,UNIRCareers,14,0,3,3,0.438601,0.534933,0.000973,"#00eeff"
1118919431801966592,JairMartinsdeM1,14,1,0,1,0.602574,0.375127,0,"#00eeff"
1296860952642629633,ldm_nu,36,0,1,1,0.449431,0.261622,0,"#825403"
1249267382440398848,LulaDilma13,36,0,1,1,0.442816,0.259379,0,"#825403"
1354251750832799745,JacoboZavaleta,34,0,2,2,0.485481,0.398108,0.000486,"#ff0d69"
947685474570661889,RMS_UNAM,7,9,0,9,0.401333,0.281975,0.003891,"#ffb800"
1204128767251230720,codedailybot,49,0,1,1,0.350549,0.47317,0,"#ff7007"
1193902886150914049,SocialesUV,7,0,1,1,0.370252,0.216213,0,"#ffb800"
4373963417,DHBBAW,34,0,45,45,0.473378,0.475369,0.021401,"#ff0d69"
955289710020124672,IndieDevProBot,49,0,1,1,0.356801,0.468659,0,"#ff7007"
1134910842028171264,SociologiaUdg,7,0,1,1,0.371644,0.213962,0,"#ffb800"
1420214653867728896,Rafavega7237,7,0,1,1,0.371548,0.211276,0,"#ffb800"
1486225834109067267,oculus,36,1,0,1,0.527653,0.313205,0,"#825403"
1106531527234650112,PostgradoUCAB,35,1,0,1,0.617454,0.389436,0,"#00faff"
1377125719218606082,gatin79001684,36,0,2,2,0.465449,0.245196,0.000486,"#825403"
1333552728547717120,Gentedemar2020,34,1,0,1,0.578676,0.440446,0,"#ff0d69"
1334205949750489089,historisismos,34,10,1,11,0.518495,0.412554,0.004864,"#ff0d69"
714585866715291649,rdrx_,13,0,14,14,0.458301,0.465321,0.006323,"#3bec00"
1169195169717084160,hezikt_eus,30,0,4,4,0.515024,0.544063,0.001459,"#ff77ff"
749219109284511744,jrdiazfernan88,14,0,1,1,0.584286,0.471997,0,"#00eeff"
747721267982237696,_ITEMadrid_,14,34,9,43,0.477244,0.518063,0.020428,"#00eeff"
747416373228376064,cardosoalaura,49,0,1,1,0.288591,0.48365,0,"#ff7007"
1307355301549543435,rosiaXbot,49,0,1,1,0.366536,0.470798,0,"#ff7007"
1315555020985831425,MargheFantoli,22,0,1,1,0.583887,0.475097,0,"#00e8b2"
1415385858350460928,cristinamgamfer,13,0,1,1,0.57361,0.416226,0,"#3bec00"
735627367926890496,data_datum,49,0,1,1,0.286479,0.491945,0,"#ff7007"
4871846710,O_de_R,49,0,1,1,0.296283,0.48601,0,"#ff7007"
1136333170767540225,AlfonsoRamrezL2,43,0,2,2,0.707988,0.568736,0.000486,"#fcae7e"
1395103570186444803,dptocicuba,43,1,0,1,0.735597,0.664135,0,"#fcae7e"
1266192708412080130,RIHISTORIADORAS,34,6,5,11,0.523387,0.406901,0.004864,"#ff0d69"
898265837857013763,AmenazaRoboto,37,12,4,16,0.687795,0.390633,0.007296,"#006032"
1266191612843110402,ProfBedStuy,37,0,4,4,0.68876,0.383536,0.001459,"#006032"
946870215081709573,epistolaria,37,0,4,4,0.689467,0.378572,0.001459,"#006032"
909891254338703360,PodRoboto,37,0,4,4,0.692539,0.380735,0.001459,"#006032"
1294393330973970435,Historia152,1,5,6,11,0.490295,0.558843,0.004864,"#b6cb00"
1369192672984973312,elhombrepalabra,14,0,1,1,0.70801,0.508867,0,"#00eeff"
1250172899882946560,lazarobot,14,5,1,6,0.554374,0.486967,0.002432,"#00eeff"
1254442555422408705,_Juliamsampaio,36,2,1,3,0.492075,0.325264,0.000973,"#825403"
1235264783194238977,qualichat,36,2,0,2,0.486228,0.316784,0.000486,"#825403"
915609293377998854,REDFEMP_TyP,31,0,1,1,0.597473,0.462731,0,"#3e93ff"
877931790719221760,PublicHistoryIT,49,6,0,6,0.423121,0.450645,0.002432,"#ff7007"
1282173705070669824,sciBot6,49,0,5,5,0.441804,0.489592,0.001946,"#ff7007"
1182642793698811905,venicedph,13,11,3,14,0.472481,0.461327,0.006323,"#3bec00"
1284662357759717377,TEI_Pelican,49,1,0,1,0.35061,0.461092,0,"#ff7007"
1390415263800119300,litelectronica,0,2,8,10,0.446042,0.496837,0.004377,"#8ecfec"
1395757538533154819,Anavarrop_,22,0,1,1,0.530363,0.650333,0,"#00e8b2"
1394404583129104393,grupoatlasurjc,37,1,0,1,0.709898,0.3638,0,"#006032"
1166374846848258048,riramosuniv,31,0,6,6,0.477121,0.497296,0.002432,"#3e93ff"
1209164914809548802,tecmerinrevista,31,1,2,3,0.59959,0.421764,0.000973,"#3e93ff"
846385653176774658,PECElPilar,31,0,1,1,0.70808,0.267401,0,"#3e93ff"
1027891560002846720,R_Consuelo_GG,14,0,4,4,0.517538,0.538408,0.001459,"#00eeff"
702161516469030912,AnaBubenik,37,3,1,4,0.503243,0.538111,0.001459,"#006032"
1391862433237585921,LasPistolerasDH,34,0,3,3,0.374453,0.430555,0.000973,"#ff0d69"
891989801444007937,layo_sa,58,0,1,1,0.459548,0.637918,0,"#005076"
933524220218363905,enlaschicherias,37,0,3,3,0.591131,0.402744,0.000973,"#006032"
773528630064537600,MuseosColombia,38,0,9,9,0.512753,0.459305,0.003891,"#662859"
931978933289013248,creature_lma,37,2,0,2,0.5208,0.378561,0.000486,"#006032"
1352348858580402181,EscuelitaSA,34,0,10,10,0.411103,0.435352,0.004377,"#ff0d69"
1290418317262544896,life_x_code,34,0,5,5,0.415731,0.448302,0.001946,"#ff0d69"
823104849466290176,clairemmassey,34,0,3,3,0.372197,0.423752,0.000973,"#ff0d69"
1026851154934882304,PorChicana,34,4,0,4,0.403699,0.444348,0.001459,"#ff0d69"
709333678925750273,NanetteRissler,30,0,29,29,0.488605,0.505538,0.013619,"#ff77ff"
1243565887602425863,Biblio_FUBerlin,14,0,2,2,0.442319,0.525311,0.000486,"#00eeff"
1246810759000207366,bibwelt,37,1,0,1,0.575773,0.370823,0,"#006032"
1200543063233433606,blablacchino,58,0,1,1,0.459689,0.642472,0,"#005076"
1326824912141623296,itsmariapr,14,0,1,1,0.570778,0.471993,0,"#00eeff"
1402287396830466058,AlmagroTClasico,37,4,2,6,0.555489,0.497591,0.002432,"#006032"
1318371547720175618,chiviroOwl,34,0,7,7,0.479892,0.443023,0.002918,"#ff0d69"
1346857671568326662,VanesaRgallardo,37,0,1,1,0.459327,0.617961,0,"#006032"
1038104175593316352,pb_trad,14,0,1,1,0.589041,0.488776,0,"#00eeff"
1197128414651723776,urilifekorea,37,0,1,1,0.456379,0.618219,0,"#006032"
1397322379706130437,cite_lab,36,9,3,12,0.506202,0.420394,0.00535,"#825403"
1319976310102462471,Marcela18987810,37,1,1,2,0.503258,0.506448,0.000486,"#006032"
1243161081633259524,ach2021,34,7,3,10,0.433494,0.44483,0.004377,"#ff0d69"
1204088196520431616,vemproenej,37,2,1,3,0.535692,0.34799,0.000973,"#006032"
1308805061720649735,4rtl3y,37,0,1,1,0.566613,0.360654,0,"#006032"
1272448855628492800,asodat2023,14,17,4,21,0.494527,0.525463,0.009728,"#00eeff"
1077514864099237888,wellnessrain,14,0,1,1,0.580919,0.474121,0,"#00eeff"
1362066728356872193,MusicEncoding21,34,0,2,2,0.26882,0.591739,0.000486,"#ff0d69"
725357267013480449,MusicEncoding,34,0,2,2,0.279248,0.594161,0.000486,"#ff0d69"
4567815741,music_enfanthen,34,0,4,4,0.382989,0.56434,0.001459,"#ff0d69"
755348497176596481,cdeusmar,37,0,1,1,0.721699,0.340263,0,"#006032"
950451187039592448,zvilac,14,12,16,28,0.516869,0.529667,0.013132,"#00eeff"
1373694368243195909,WoMuNetProject,14,0,1,1,0.489674,0.577879,0,"#00eeff"
924377431611527169,RedArgEA,49,27,12,39,0.47759,0.529453,0.018482,"#ff7007"
1119748332337942528,elpostlector,37,0,1,1,0.690873,0.598057,0,"#006032"
1415824927182163969,LidiaRo79374309,37,1,0,1,0.571029,0.367286,0,"#006032"
1205464890158338049,UniversidadGob,31,5,0,5,0.561067,0.487486,0.001946,"#3e93ff"
776717161159065600,CheckoutLabs,19,5,3,8,0.638274,0.735186,0.003405,"#00d3ff"
924613235201970176,AlayArte,19,3,0,3,0.666647,0.740355,0.000973,"#00d3ff"
1380227805871534082,RGateiro,37,2,0,2,0.509228,0.372602,0.000486,"#006032"
1171973372407889921,danielsousario,36,0,3,3,0.511186,0.383862,0.000973,"#825403"
975442223302094849,RevistaEpidauro,49,9,0,9,0.458996,0.493488,0.003891,"#ff7007"
1062024953732698112,EprMujeres,19,6,0,6,0.633934,0.73364,0.002432,"#00d3ff"
1278778370432565251,activistica,37,0,3,3,0.588549,0.388588,0.000973,"#006032"
825206401630810112,perea_lup,13,0,1,1,0.409755,0.398306,0,"#3bec00"
1238275984400560129,CBioinformatica,13,0,1,1,0.38861,0.396844,0,"#3bec00"
879825421352583168,RLadiesCDMX,13,6,3,9,0.437752,0.447765,0.003891,"#3bec00"
747491433658060800,dankerohe,36,0,5,5,0.485458,0.360938,0.001946,"#825403"
924228991036223488,JNursiyono,36,2,0,2,0.403235,0.360886,0.000486,"#825403"
1128114424060030976,CRIEA3,13,0,5,5,0.49253,0.490687,0.001946,"#3bec00"
1245893319860895747,ep_philippe,37,2,0,2,0.535696,0.374475,0.000486,"#006032"
715990974644822016,BrigadistaAle,19,2,0,2,0.658049,0.745317,0.000486,"#00d3ff"
926125844795416576,AmicalBrigades,19,2,0,2,0.659339,0.752871,0.000486,"#00d3ff"
822379388570218497,UCAextension,37,3,2,5,0.627038,0.420154,0.001946,"#006032"
1232298369072148482,DptFilolModerna,15,9,10,19,0.515261,0.662546,0.008755,"#008ebb"
1311751180792606729,IBGtrManchester,19,1,0,1,0.618923,0.778612,0,"#00d3ff"
973642422449295360,fcpsuaq,13,1,1,2,0.410708,0.456999,0.000486,"#3bec00"
788410789443018752,alissonmasoares,36,3,4,7,0.52278,0.432169,0.002918,"#825403"
755298736264318976,begobr93,37,1,0,1,0.56193,0.358363,0,"#006032"
1065575323239149569,Martajimalon,37,0,1,1,0.63901,0.426974,0,"#006032"
1131605625862008832,RubnChacn3,30,10,3,13,0.54089,0.489892,0.005837,"#ff77ff"
748615876329369600,ameliestrike,37,1,0,1,0.573663,0.376293,0,"#006032"
969889350296178688,CalimaLastra,14,0,2,2,0.562986,0.474145,0.000486,"#00eeff"
1380540745661218817,EyPPFLACSO,37,4,0,4,0.621613,0.490773,0.001459,"#006032"
747211958303211520,Karinagmontes,37,0,1,1,0.693338,0.548799,0,"#006032"
1326149660218626049,Kaukirinoumeak1,30,0,2,2,0.545709,0.601706,0.000486,"#ff77ff"
1009746847336935424,archiletras,14,0,2,2,0.562595,0.504192,0.000486,"#00eeff"
1030150370004230150,miguelgarbau,14,0,2,2,0.565074,0.521681,0.000486,"#00eeff"
1232865408366940161,dr_mmontanez,49,0,3,3,0.430414,0.492792,0.000973,"#ff7007"
1284271889628762120,FacundoPrice,49,0,1,1,0.367839,0.526521,0,"#ff7007"
861524140536332288,CLUNL_,36,9,4,13,0.518149,0.435195,0.005837,"#825403"
705194246127529984,cibercliografia,34,3,4,7,0.478213,0.446122,0.002918,"#ff0d69"
1152288554778812417,ophidiphilia,14,1,2,3,0.347505,0.487955,0.000973,"#00eeff"
1396730653081804801,Revista_REDOC,37,3,1,4,0.45338,0.492204,0.001459,"#006032"
940832638490894336,BlkHwk0ps,37,0,2,2,0.644424,0.283009,0.000486,"#006032"
985425300292022273,fullNam35087976,37,0,2,2,0.651364,0.286615,0.000486,"#006032"
1276639487544766470,Elizabe07366443,37,0,1,1,0.687958,0.309744,0,"#006032"
1001090814938886146,angelhugarci,1,0,1,1,0.310578,0.748431,0,"#b6cb00"
891634902961188864,revistaRILE,1,0,1,1,0.322797,0.747847,0,"#b6cb00"
4874205953,ArtemisNymph,37,5,2,7,0.577105,0.499249,0.002918,"#006032"
1247199060165099520,CardosuAle,34,0,2,2,0.415942,0.498345,0.000486,"#ff0d69"
1390047197178310665,julialuru,34,0,2,2,0.411602,0.493009,0.000486,"#ff0d69"
1253375648309141504,crim_unam,7,3,0,3,0.417991,0.079496,0.000973,"#ffb800"
1327377522594557952,BorthiryE,49,0,1,1,0.54445,0.42888,0,"#ff7007"
1061697864550752256,iara_gautier,37,3,1,4,0.634541,0.354668,0.001459,"#006032"
1260011917847953408,alegomexx,36,0,1,1,0.424352,0.25294,0,"#825403"
1227917842118561793,agusnieto77,49,2,4,6,0.525324,0.467227,0.002432,"#ff7007"
920000089820663808,YadiraLizamaMue,13,0,5,5,0.608632,0.507453,0.001946,"#3bec00"
1116204493350346752,HDitadura,36,4,0,4,0.509034,0.369357,0.001459,"#825403"
1060206426134585344,poetadiletante,1,0,8,8,0.455787,0.549787,0.003405,"#b6cb00"
796191699815038977,serpientederio,13,0,5,5,0.508826,0.448101,0.001946,"#3bec00"
748520777385926656,DigitalHumani,36,2,11,13,0.516225,0.51101,0.005837,"#825403"
741705695993569281,CanalCaribeCuba,37,1,1,2,0.580822,0.368833,0.000486,"#006032"
1176574253531054080,periodistascuba,37,2,0,2,0.581579,0.37466,0.000486,"#006032"
1162413809346236416,NaptuneM,30,0,2,2,0.554756,0.514461,0.000486,"#ff77ff"
743456072673992704,elindepcom,18,5,0,5,0.45152,0.721338,0.001946,"#5456a6"
969248160790007810,VitaActivaOrg,13,0,3,3,0.425396,0.466283,0.000973,"#3bec00"
910649850777268225,InternetCiudada,13,0,1,1,0.352941,0.516312,0,"#3bec00"
866040885250805760,AlejandraC711,37,1,0,1,0.569742,0.378503,0,"#006032"
1028776947629912066,DigitalixMx,13,0,1,1,0.409047,0.42018,0,"#3bec00"
1337504124884160513,pajarosdelmonte,38,0,1,1,0.555916,0.41056,0,"#662859"
1171484900412706816,RevistaJanus,14,11,3,14,0.509324,0.507754,0.006323,"#00eeff"
1297617007668596745,fest_digital,30,9,2,11,0.541216,0.612415,0.004864,"#ff77ff"
1266505019563655174,Lorena50180363,37,1,0,1,0.555998,0.355431,0,"#006032"
966733181549514753,RHispanico,13,0,1,1,0.451623,0.354275,0,"#3bec00"
704247685470097408,HuDiCat,14,23,4,27,0.51463,0.491286,0.012646,"#00eeff"
1407350738318135304,Rodrigo67802236,37,2,0,2,0.533286,0.377804,0.000486,"#006032"
1408981999180713989,ItatiAlfonso,37,1,1,2,0.514997,0.510397,0.000486,"#006032"
1408955564227432452,Bethy54335549,37,1,0,1,0.561658,0.366094,0,"#006032"
4574094447,casaro_maria,37,1,0,1,0.57705,0.372651,0,"#006032"
1178548210081714177,SoyPodcastera,49,0,2,2,0.437306,0.616147,0.000486,"#ff7007"
1355256949584105477,marezinha9,36,0,2,2,0.517827,0.307292,0.000486,"#825403"
1408238780188966913,Leticia52436992,37,1,0,1,0.571477,0.364392,0,"#006032"
709188203157299200,LLCCHHPUCP,49,1,0,1,0.4073,0.508164,0,"#ff7007"
1262500627600506880,MoltedoLian,49,0,1,1,0.398331,0.417754,0,"#ff7007"
986053054905581568,MikAlice_M,49,0,5,5,0.421605,0.515143,0.001946,"#ff7007"
1183172110522433537,Juancamimg,37,1,1,2,0.584097,0.343155,0.000486,"#006032"
1408425215911247875,FabinOrlandoVe1,37,1,0,1,0.576821,0.362836,0,"#006032"
1321422923312279552,HumanidadesDig3,30,3,1,4,0.569218,0.481659,0.001459,"#ff77ff"
1095340945602736128,UdG_DifPat,34,0,1,1,0.370311,0.473647,0,"#ff0d69"
1408220131654782978,StefiZarate3,37,1,1,2,0.507572,0.507966,0.000486,"#006032"
1380446091376787457,TheMedievalist,38,0,2,2,0.372106,0.510044,0.000486,"#662859"
849292483678932992,MontseBosch11,34,0,1,1,0.367256,0.470207,0,"#ff0d69"
4697014770,_Laris_Lari,36,0,6,6,0.476642,0.311615,0.002432,"#825403"
724695976179539969,usaldci,37,2,2,4,0.456742,0.510553,0.001459,"#006032"
907720814711189504,mfernandezcampa,34,0,2,2,0.342436,0.408995,0.000486,"#ff0d69"
1012028620477550594,MIN_UACh,37,2,0,2,0.601641,0.369475,0.000486,"#006032"
1407632187818717191,Liliana78147636,37,1,0,1,0.558531,0.363381,0,"#006032"
1407522208986058761,Dinal69086671,37,1,0,1,0.569061,0.378804,0,"#006032"
1397327776793997317,TeoCompNe,37,1,0,1,0.565833,0.357603,0,"#006032"
1177490993592991744,cmmalagafair,14,10,5,15,0.608239,0.513842,0.006809,"#00eeff"
1195807221373919232,jfm4em,34,1,7,8,0.401242,0.439637,0.003405,"#ff0d69"
810962229071908865,rsc2110,34,0,4,4,0.530136,0.466032,0.001459,"#ff0d69"
1196451299526610945,dh_univr,14,19,4,23,0.534581,0.537332,0.0107,"#00eeff"
1268124878152118280,inesfdezcaba,31,0,1,1,0.60465,0.477682,0,"#3e93ff"
1496070887866576899,surculturas,14,4,0,4,0.604494,0.539988,0.001459,"#00eeff"
1328521147395215360,CendoyaSolange,3,0,1,1,0.474908,0.660435,0,"#ffb3ff"
1275847408866545665,ProfCeciliaM,34,0,2,2,0.34234,0.423654,0.000486,"#ff0d69"
981877352895516672,adrianacamprubi,30,0,3,3,0.53044,0.55017,0.000973,"#ff77ff"
738100811432132608,alfonso_goday,38,0,1,1,0.079658,0.421026,0,"#662859"
4501962742,cylareacts,38,51,0,51,0.146909,0.450539,0.024319,"#662859"
793590300681830404,Tony_Vestonice,38,0,1,1,0.11432,0.426465,0,"#662859"
1369364811927142405,bego15967,38,0,1,1,0.081494,0.446075,0,"#662859"
1183020191661379584,Alecor29,38,0,1,1,0.070096,0.430163,0,"#662859"
821636457513283588,dritaack,38,0,1,1,0.08733,0.4502,0,"#662859"
1326918433758449666,FelipeERuan3,14,0,1,1,0.496393,0.647804,0,"#00eeff"
1162484987553337344,Minimango98,38,0,1,1,0.103281,0.448339,0,"#662859"
829346445782302721,macogu42,38,0,1,1,0.074386,0.423826,0,"#662859"
1127636051621707777,Matuthanos1,38,0,1,1,0.092048,0.448175,0,"#662859"
765225892834672640,lauriitapf,38,0,1,1,0.082675,0.425475,0,"#662859"
4819706849,Carleshm99,38,0,1,1,0.104374,0.433756,0,"#662859"
1087053146025873408,Cherry4Bomb,38,0,1,1,0.115089,0.435987,0,"#662859"
825791834593046528,darthcornudus,38,0,1,1,0.092796,0.443851,0,"#662859"
1089199225773146114,pichu2113,38,0,1,1,0.084688,0.441567,0,"#662859"
1357318302905819136,FomaOst,38,0,1,1,0.100352,0.441797,0,"#662859"
1043913920849825792,Edu_Eh22,38,0,1,1,0.093584,0.439527,0,"#662859"
1271190135862964234,MelkartCansao,38,0,1,1,0.108658,0.422566,0,"#662859"
933646192092819458,clasicas_uam,22,8,1,9,0.589513,0.512993,0.003891,"#00e8b2"
790547170801975296,MLouis_Twit,3,0,1,1,0.456163,0.6577,0,"#ffb3ff"
1406091250579685378,MariaPasi,3,0,1,1,0.478376,0.66103,0,"#ffb3ff"
1075444961867374592,Gabriel39194377,13,5,2,7,0.373364,0.480629,0.002918,"#3bec00"
920229878728814593,amidi_com,13,0,4,4,0.447111,0.414581,0.001459,"#3bec00"
971422300456308737,womenhistory1,19,1,0,1,0.648716,0.775607,0,"#00d3ff"
1023385358015320064,mujeresmsalas,19,1,0,1,0.64355,0.793758,0,"#00d3ff"
1350115382770749452,PeruFuentes,38,1,1,2,0.507666,0.40677,0.000486,"#662859"
1026636127380361217,AlanColin_Arce,41,0,7,7,0.385431,0.414132,0.002918,"#697b00"
1214520938064162816,INDI_inclusion,14,0,3,3,0.544316,0.562994,0.000973,"#00eeff"
1279394802954625026,_deboraval,36,0,2,2,0.533458,0.402961,0.000486,"#825403"
1392154849467326468,BelderrainPilar,1,0,1,1,0.360389,0.562115,0,"#b6cb00"
4809347241,Maraalm_,1,1,1,2,0.413105,0.537559,0.000486,"#b6cb00"
795748043832381442,lellislolellis,36,5,9,14,0.463892,0.395853,0.006323,"#825403"
971894198935982081,kohantoys,36,0,2,2,0.528579,0.153097,0.000486,"#825403"
1346131952546541570,GuiLaitano,49,3,2,5,0.514313,0.44725,0.001946,"#ff7007"
1215361849459380225,miluguzr,13,0,1,1,0.398662,0.450065,0,"#3bec00"
1370907086238928898,Maruja04741108,30,0,1,1,0.69542,0.484524,0,"#ff77ff"
1252986071249555457,arroyo_labrador,30,9,1,10,0.608522,0.495103,0.004377,"#ff77ff"
1360201886624800770,dhum2021C,14,0,3,3,0.519271,0.572927,0.000973,"#00eeff"
808818902012665860,dmarcosborba,36,0,1,1,0.513914,0.222181,0,"#825403"
1295313687549480960,PythonbotBr,36,0,1,1,0.510436,0.220605,0,"#825403"
733978715705778176,RoyalSitesMad,30,0,1,1,0.701912,0.480207,0,"#ff77ff"
1066078059244208128,netoventuraraul,36,0,1,1,0.551102,0.291259,0,"#825403"
905470522602938373,DistantReading,34,20,0,20,0.504413,0.474435,0.009241,"#ff0d69"
809514440504868864,bncolorado,34,1,4,5,0.5003,0.538319,0.001946,"#ff0d69"
1016377495057297408,archiviststan,34,3,14,17,0.461384,0.453464,0.007782,"#ff0d69"
1109155467484450817,HumanidadesUfv,15,33,8,41,0.525261,0.639742,0.019455,"#008ebb"
836704501411299328,henar_pizarro,30,0,4,4,0.584081,0.578464,0.001459,"#ff77ff"
1395094909263269889,ManuelR19409919,30,0,1,1,0.692314,0.482275,0,"#ff77ff"
1015384340077928448,ObsHistoria,36,11,27,38,0.535019,0.3992,0.017996,"#825403"
838452112942059521,gabgonzag4,49,0,1,1,0.515841,0.381288,0,"#ff7007"
1351136206894018560,cuentatuciencia,21,0,1,1,0.338769,0.452924,0,"#c6cc85"
1299341136474132482,practicalIIIF,36,5,2,7,0.471845,0.381466,0.002918,"#825403"
1389997850440908804,HKombativa,38,1,1,2,0.551434,0.399005,0.000486,"#662859"
715265329631510528,ecava12,41,3,0,3,0.35322,0.385294,0.000973,"#697b00"
1394398771425972231,DptoHa,22,4,1,5,0.515139,0.533597,0.001946,"#00e8b2"
1065391377637355520,Ger13Ruiz,30,0,2,2,0.544856,0.613734,0.000486,"#ff77ff"
1138817806093508610,ArisquetaIgea,40,0,1,1,0.630088,0.048103,0,"#ff12a3"
1239205478774816775,_LecturaComun_,40,227,0,227,0.599461,0.091311,0.109922,"#ff12a3"
1052294996345409536,DomingoAlbMtnez,40,0,1,1,0.672293,0.033989,0,"#ff12a3"
1372936519376326665,TheOrosian,30,0,2,2,0.543173,0.726935,0.000486,"#ff77ff"
1128993811487760384,JimenaUcm,30,1,1,2,0.545447,0.729761,0.000486,"#ff77ff"
4550998635,florsol123,40,0,1,1,0.615239,0.045925,0,"#ff12a3"
1166004522252144641,Clo75191356,40,0,1,1,0.601751,0.016717,0,"#ff12a3"
1153749813961379841,DominoeDancer,13,1,7,8,0.440754,0.512278,0.003405,"#3bec00"
876432438175596548,rominickyDL,49,45,49,94,0.464097,0.506304,0.045233,"#ff7007"
1081302172212568066,Harlock55536717,40,0,1,1,0.601307,0.044407,0,"#ff12a3"
1311091696487272448,JuanCar09848298,40,0,1,1,0.663836,0.030713,0,"#ff12a3"
769588811621928960,DavidAndradeTe1,40,0,1,1,0.632232,0.011971,0,"#ff12a3"
1184908632720367617,ivan_deblasVK,40,0,1,1,0.589818,0.045444,0,"#ff12a3"
897058814230499328,mmsfeir,36,2,0,2,0.46902,0.354166,0.000486,"#825403"
1170281714444328960,NadaAmmagui,36,2,0,2,0.471075,0.351914,0.000486,"#825403"
1216201236598394885,suphan76069481,36,3,0,3,0.472159,0.348086,0.000973,"#825403"
1314038732576772098,guizado_mariana,40,0,1,1,0.595191,0.029357,0,"#ff12a3"
861299029346574337,AlbertClaramont,40,0,1,1,0.596006,0.031536,0,"#ff12a3"
914092650109837312,DianaViri6,40,0,1,1,0.615731,0.010049,0,"#ff12a3"
862390570353926145,imlhandris,40,0,1,1,0.6086,0.023702,0,"#ff12a3"
1304288878984073216,Lexie_Blum,40,0,1,1,0.614311,0.051025,0,"#ff12a3"
1123332371405651968,CarlosEchj,40,0,1,1,0.587012,0.036946,0,"#ff12a3"
1261348868408717318,rojoynegro37,40,0,1,1,0.58812,0.021066,0,"#ff12a3"
1332040781482356739,FlordeM65929374,40,0,1,1,0.629614,0.019515,0,"#ff12a3"
1038037615856021504,PatriciaJuezGa1,15,7,12,19,0.524715,0.607809,0.008755,"#008ebb"
1361589437084401665,trinim57,40,0,1,1,0.637534,0.050143,0,"#ff12a3"
1349311178439352320,Chekito02650061,40,0,1,1,0.63458,0.03505,0,"#ff12a3"
1274682557460885505,18debrumario1,40,0,1,1,0.631978,0.040217,0,"#ff12a3"
1379967853386956803,SoyLaMuriel,40,0,1,1,0.567777,0.009555,0,"#ff12a3"
1345420214767411200,AB_DECAUSAJUSTA,40,0,1,1,0.657647,0.023604,0,"#ff12a3"
1393281114983251969,ResistenciaX3,40,0,1,1,0.635772,0.045669,0,"#ff12a3"
1228392644981805058,GUSTAVO12582465,40,0,1,1,0.676775,0.029545,0,"#ff12a3"
702629062209101824,albertomantuan3,40,0,1,1,0.591338,0.026601,0,"#ff12a3"
1301847256379908101,Libre86081873,40,0,1,1,0.666237,0.021133,0,"#ff12a3"
1334026116751876097,Fabri96976271,40,0,1,1,0.633023,0.033744,0,"#ff12a3"
1026075119096086529,gaby_withYnotI,40,0,1,1,0.600705,0.014581,0,"#ff12a3"
1047828174065811456,ternasca,40,0,1,1,0.636587,0.054793,0,"#ff12a3"
922022510241165314,ZahiaGC,40,0,1,1,0.567364,0.024542,0,"#ff12a3"
1090911079742484480,SCualesquiera,40,0,1,1,0.615405,0.023975,0,"#ff12a3"
1056497821665386496,Juanch4_,40,0,1,1,0.572092,0.047087,0,"#ff12a3"
912768367492304896,Aguarafa1,40,0,1,1,0.599701,0.040497,0,"#ff12a3"
1070609351281389569,Mara42732098,40,0,1,1,0.618196,0.0053,0,"#ff12a3"
4603237948,Muysilvestre,40,0,1,1,0.658066,0.03468,0,"#ff12a3"
1364631878549057538,ISIDROLAPUENTE,30,0,6,6,0.650719,0.618373,0.002432,"#ff77ff"
844819906302373888,m_mrcd,40,0,1,1,0.608814,0.048589,0,"#ff12a3"
1263934048294109184,bowiemartell,40,0,1,1,0.61186,0.026003,0,"#ff12a3"
1025779648100229122,maruxiiiiiiii,40,0,1,1,0.6315,0.031009,0,"#ff12a3"
1213620308571111431,alemira,40,0,1,1,0.588711,0.028712,0,"#ff12a3"
1370798797459177472,dnolimits1809,40,0,1,1,0.610093,0.042483,0,"#ff12a3"
857570286077661186,soypipogonzalez,40,0,1,1,0.568771,0.041422,0,"#ff12a3"
949993367525523456,Ijustwantomeme,40,0,1,1,0.611432,0.019075,0,"#ff12a3"
1076116099161300992,CanelaYPastilla,40,0,1,1,0.656655,0.042282,0,"#ff12a3"
1032043587247243265,Etheliiinaaa,40,0,1,1,0.586906,0.030633,0,"#ff12a3"
937984821833461760,Manuela34537619,40,0,1,1,0.63682,0.01223,0,"#ff12a3"
1005154332621312001,verwencita,40,0,1,1,0.600602,0.010055,0,"#ff12a3"
1401818795828711426,LinTercero,40,0,1,1,0.606122,0.033516,0,"#ff12a3"
789599711053357056,HikouNoKangae,40,0,1,1,0.626593,0.056981,0,"#ff12a3"
953580981927149568,RebecaGG35,40,0,1,1,0.556792,0.025097,0,"#ff12a3"
894923850256982016,GustavoUgarte7,40,0,1,1,0.603697,0.028427,0,"#ff12a3"
910985832512856064,Beatrix07460769,40,0,1,1,0.662086,0.027817,0,"#ff12a3"
1215255794507296769,CReche73543114,40,0,1,1,0.642856,0.052135,0,"#ff12a3"
945345059574157312,Olvido_Contento,40,0,1,1,0.621527,0.021513,0,"#ff12a3"
998289294187024387,ArriolaMil,40,0,1,1,0.627616,0.0223,0,"#ff12a3"
1088139896571736066,RafaMateos,40,0,1,1,0.584494,0.047704,0,"#ff12a3"
1072072285639598081,CalotoIglesias,40,0,1,1,0.651508,0.012898,0,"#ff12a3"
4538173635,DiegoSCFCB,40,0,1,1,0.637432,0.02718,0,"#ff12a3"
1392061485573083140,AdrinMa52783509,30,0,1,1,0.726631,0.644971,0,"#ff77ff"
1238615328780955648,Brrrreo,40,0,1,1,0.600846,0.046407,0,"#ff12a3"
994832302474743809,Amor_Plantonico,40,0,1,1,0.629801,0.00109,0,"#ff12a3"
1049221598035812352,Sovitico1,40,0,1,1,0.617859,0.04186,0,"#ff12a3"
1345065714164641799,ntuanico,40,0,1,1,0.58704,0.007509,0,"#ff12a3"
885854304795545602,IliberisGra,40,0,1,1,0.597571,0.011185,0,"#ff12a3"
706476019411197953,measrobaolacoca,40,0,1,1,0.603276,0,0,"#ff12a3"
1256014179544240129,DatabutlerP,36,0,2,2,0.487023,0.417689,0.000486,"#825403"
1145002687911682053,franeldel,40,0,1,1,0.636817,0.029476,0,"#ff12a3"
1088091326162321410,manchashumedad,40,0,1,1,0.590997,0.01231,0,"#ff12a3"
731636263602642944,franfavreau,40,0,1,1,0.640475,0.019193,0,"#ff12a3"
1372290002122645509,___informe,40,0,1,1,0.645039,0.034629,0,"#ff12a3"
953623541383159808,umamiblue,40,0,1,1,0.608504,0.030666,0,"#ff12a3"
883433915926667265,gerclouds,40,0,1,1,0.64564,0.044371,0,"#ff12a3"
1375772759700176899,JaviDelgadour,40,0,1,1,0.612822,0.014833,0,"#ff12a3"
1399785307344670720,upo_hd,13,0,1,1,0.431354,0.41081,0,"#3bec00"
1192524460366221314,DiarioArtemisa,43,0,2,2,0.737637,0.580719,0.000486,"#fcae7e"
1272669433258037250,UJCdeCuba,43,1,0,1,0.787492,0.616882,0,"#fcae7e"
1089503954914996225,AngelaIdioma,14,0,1,1,0.504965,0.646163,0,"#00eeff"
965636892413833217,elexis_eu,36,2,0,2,0.506691,0.362584,0.000486,"#825403"
1142819859472048131,sarampcarvalho,36,2,0,2,0.505464,0.363245,0.000486,"#825403"
1228084889234419714,lainformal2,14,0,1,1,0.490352,0.638979,0,"#00eeff"
1290375955920420865,ForeignKentucky,14,0,1,1,0.50763,0.643517,0,"#00eeff"
708050779744149505,AnnaBosque2,0,0,1,1,0.432784,0.604807,0,"#8ecfec"
1083144899199975424,celpyc,30,0,1,1,0.469912,0.57928,0,"#ff77ff"
723905729669828608,L_DigitalesUCM,31,8,1,9,0.489189,0.590162,0.003891,"#3e93ff"
791640220068380673,esAsiaOriental,14,4,1,5,0.618033,0.455288,0.001946,"#00eeff"
1398329391663534082,lcorrea87,0,0,1,1,0.425478,0.608838,0,"#8ecfec"
1108039887926763520,mhd_ub,22,18,4,22,0.573579,0.533042,0.010214,"#00e8b2"
4860805845,NormasUNE,0,1,1,2,0.456088,0.601117,0.000486,"#8ecfec"
1094617619909496833,arentio1,7,0,1,1,0.689445,0.593274,0,"#ffb800"
911073552433942529,thericote,0,0,1,1,0.426676,0.60467,0,"#8ecfec"
1067809214624669697,SdRecercaUPF,22,2,0,2,0.569757,0.625198,0.000486,"#00e8b2"
1126513571880300545,TFundaciones,0,0,2,2,0.381999,0.608342,0.000486,"#8ecfec"
821081863037054976,ZeekerSolutions,0,0,3,3,0.431261,0.571778,0.000973,"#8ecfec"
1232315262671577088,agepea_asoc,14,0,1,1,0.691041,0.427105,0,"#00eeff"
1370500068290265095,luiz_coletto,36,0,2,2,0.530806,0.331113,0.000486,"#825403"
753615934326210560,master_gcd,22,6,4,10,0.586539,0.574744,0.004377,"#00e8b2"
1242824721802158080,srpraca,36,0,2,2,0.523067,0.332985,0.000486,"#825403"
1242776999619330048,LgHumanMachine,30,3,1,4,0.534945,0.454455,0.001459,"#ff77ff"
4407571426,malagademuseos,14,0,1,1,0.660126,0.494429,0,"#00eeff"
716767711792078849,rutestercita,0,0,1,1,0.42927,0.609701,0,"#8ecfec"
905178483894214656,clavilux_of_FL,34,2,11,13,0.482762,0.447354,0.005837,"#ff0d69"
796369544080146432,Xbal_Urbano,22,1,8,9,0.596541,0.569542,0.003891,"#00e8b2"
1227488549165043714,UnitedFronteras,41,36,10,46,0.431768,0.453075,0.021887,"#697b00"
4793645256,ana_asaenz,13,0,7,7,0.482353,0.4824,0.002918,"#3bec00"
1135204659994537991,VSancas,58,0,1,1,0.556538,0.664171,0,"#005076"
1069370111218266113,codexeditor,36,0,1,1,0.390727,0.475985,0,"#825403"
712720118841794560,borderartists,41,0,1,1,0.379784,0.401643,0,"#697b00"
1060202869977243649,RedesMigrantes,41,2,3,5,0.431864,0.428892,0.001946,"#697b00"
1330948990242721793,cocit_bc,41,0,2,2,0.385396,0.410232,0.000486,"#697b00"
1021398580089810946,miguelrosarioc3,41,0,2,2,0.382319,0.407839,0.000486,"#697b00"
1168139691599769600,DigiLingo,36,0,1,1,0.389295,0.484528,0,"#825403"
904701071406321664,spasovskiniko,58,0,1,1,0.615516,0.583817,0,"#005076"
1266665411958931456,SocialRumbo,0,0,1,1,0.281092,0.495484,0,"#8ecfec"
986780212070199296,ACharlesMuller,36,0,1,1,0.375315,0.47587,0,"#825403"
938049703064809472,O_GarciaObregon,13,0,4,4,0.384155,0.387747,0.001459,"#3bec00"
1392587350824345600,TheWeeknd_BOT,36,0,1,1,0.525077,0.301364,0,"#825403"
1030901349607727106,ZonaDocs,13,2,0,2,0.368706,0.337504,0.000486,"#3bec00"
857930297912025089,MortaraSara,36,1,1,2,0.476416,0.324684,0.000486,"#825403"
864445647704948736,UNAM_UK,1,1,3,4,0.460056,0.55918,0.001459,"#b6cb00"
4895170186,FL_ICTs,1,0,6,6,0.486766,0.642061,0.002432,"#b6cb00"
4452509439,rosa_ferndez,1,0,1,1,0.421809,0.707172,0,"#b6cb00"
908716591050838016,enrique_del_rey,1,0,1,1,0.433531,0.706663,0,"#b6cb00"
1311635305573814277,AccEducativaExt,1,0,1,1,0.420097,0.711387,0,"#b6cb00"
920908512796037120,Revolutions19e,13,0,1,1,0.554976,0.392254,0,"#3bec00"
1300738543476670465,DariahHr,36,0,2,2,0.536293,0.450695,0.000486,"#825403"
917094566259580928,bill_demarest,34,0,2,2,0.482924,0.41311,0.000486,"#ff0d69"
1212473080427110400,betsoretorno,36,1,1,2,0.466608,0.324897,0.000486,"#825403"
984615738064494592,Allyne_aes,36,2,0,2,0.474005,0.327456,0.000486,"#825403"
1004789024001646592,edmundoigne,13,0,1,1,0.336807,0.28163,0,"#3bec00"
1327751389087473664,AmargadaLimena,38,0,4,4,0.530167,0.454613,0.001459,"#662859"
1313622876457762816,Elias_Stephen31,38,0,4,4,0.52556,0.451809,0.001459,"#662859"
1038612376369680384,lasalatinx,34,0,3,3,0.407356,0.402383,0.000973,"#ff0d69"
1237331381455372288,BittersweetHis2,38,0,4,4,0.527206,0.45229,0.001459,"#662859"
913431772729417728,lamarionamiret,30,0,1,1,0.609145,0.448961,0,"#ff77ff"
741304292032819202,TAMquarterly,37,0,2,2,0.453504,0.373421,0.000486,"#006032"
1209013521956122626,abc_cordoba,49,0,6,6,0.433346,0.524148,0.002432,"#ff7007"
832178951107801089,Fab_Hunter,34,0,1,1,0.286585,0.376885,0,"#ff0d69"
1395309103900155905,CbaQuest,34,2,2,4,0.349624,0.405395,0.001459,"#ff0d69"
1071043914537295872,SSHOpenCloud,34,1,0,1,0.282615,0.384338,0,"#ff0d69"
1189229957744119808,marmolizqedit,30,7,11,18,0.531588,0.519716,0.008268,"#ff77ff"
954705808088059904,humdigus,1,39,10,49,0.470985,0.545199,0.023346,"#b6cb00"
1194753389541896192,laiamirallesj,14,0,1,1,0.434,0.561723,0,"#00eeff"
722403191124586496,franzini1971,36,0,2,2,0.525419,0.340828,0.000486,"#825403"
1015579177704181762,unifesp,36,11,0,11,0.507508,0.40187,0.004864,"#825403"
1055717361549000704,PecheTec,8,0,1,1,0.254932,0.265011,0,"#00ed5d"
1075024836496424960,Melisaacostagi1,8,0,1,1,0.227631,0.270189,0,"#00ed5d"
1247227185808760840,Campo95000548,8,0,1,1,0.294254,0.266277,0,"#00ed5d"
1361279729337315328,dhum2021D,30,0,4,4,0.45687,0.512613,0.001459,"#ff77ff"
964641673589542912,MeritxellSimonM,14,0,2,2,0.556931,0.478541,0.000486,"#00eeff"
1360199622539546625,dhum2021E,14,0,2,2,0.461232,0.544017,0.000486,"#00eeff"
4775994627,mtropedroangel,7,0,1,1,0.360658,0.175402,0,"#ffb800"
1239331756597182466,h_campaz,38,0,1,1,0.625596,0.711175,0,"#662859"
1168564690026455040,SclTug,32,6,2,8,0.429452,0.479979,0.003405,"#00b1c7"
1151569066299146242,bellurria,30,0,1,1,0.591543,0.491916,0,"#ff77ff"
1199441639292444673,CrcamiloChica,34,0,1,1,0.567198,0.345316,0,"#ff0d69"
893531729855688704,BACartography,34,10,50,60,0.445896,0.438421,0.028696,"#ff0d69"
1041027855084339200,GEXEL4,30,1,0,1,0.598416,0.570659,0,"#ff77ff"
730034146672775168,SlaveSocieties,34,0,6,6,0.439742,0.443051,0.002432,"#ff0d69"
1042096472605569024,red_palmira,38,0,2,2,0.530537,0.38012,0.000486,"#662859"
1191926553929830400,RiveroEtelvina,22,0,1,1,0.611554,0.622895,0,"#00e8b2"
721031135724183552,romanicas_usal,58,0,1,1,0.454676,0.636708,0,"#005076"
1275896336165019653,SencUNAM,13,1,2,3,0.495312,0.494772,0.000973,"#3bec00"
911940669224210432,CmarcaFederal,38,0,1,1,0.401922,0.381555,0,"#662859"
1284239283482578944,rgluisalfonso1,30,0,1,1,0.520238,0.621024,0,"#ff77ff"
772701076986466304,BantaniEdu,36,4,0,4,0.451071,0.402204,0.001459,"#825403"
1391273203893522434,GlandiYoshi,7,0,1,1,0.350103,0.366366,0,"#ffb800"
912443885372280832,betofree45,7,0,1,1,0.351724,0.362522,0,"#ffb800"
1345437096278962177,Claudio99693893,7,0,1,1,0.365173,0.359204,0,"#ffb800"
1377393025190612994,XtotheZen,37,0,3,3,0.738024,0.383097,0.000973,"#006032"
1168165050672189440,Conver_Historia,19,9,0,9,0.631045,0.715812,0.003891,"#00d3ff"
1383521743151636480,RogrioM22510519,36,0,3,3,0.540086,0.38041,0.000973,"#825403"
1385346794008326145,mariajm1829,34,0,1,1,0.558027,0.351037,0,"#ff0d69"
1212384623335919617,festia10,41,0,1,1,0.344241,0.348208,0,"#697b00"
769846502172819456,provuldigital,37,0,1,1,0.686858,0.4943,0,"#006032"
1167972238685069312,NinaVzqz23,41,0,1,1,0.339823,0.338038,0,"#697b00"
1382156800351420416,URevisited,31,0,2,2,0.615998,0.374973,0.000486,"#3e93ff"
817872277282942976,sanse_eu,30,0,1,1,0.523916,0.658475,0,"#ff77ff"
1298317332247347200,Izavelle3,13,0,1,1,0.435259,0.411338,0,"#3bec00"
858656551749529602,s_kronenwett,36,0,3,3,0.478883,0.522483,0.000973,"#825403"
1108818668580950016,TheLIThistorian,41,0,1,1,0.348021,0.335552,0,"#697b00"
1011751695162880000,hannahljnc,49,1,5,6,0.428368,0.483863,0.002432,"#ff7007"
1033920673108951045,wchslnd,38,0,2,2,0.390638,0.221265,0.000486,"#662859"
725517136907632640,blkatlanticCDN,13,0,1,1,0.379229,0.44664,0,"#3bec00"
1360199646853935105,dhum2021b,36,3,0,3,0.49546,0.478121,0.000973,"#825403"
920998771680595969,proferachstein,13,0,1,1,0.37159,0.444118,0,"#3bec00"
1040027456399462401,DH_at_UVA,13,0,1,1,0.360646,0.450687,0,"#3bec00"
1382411904468062214,ClusterMelilla,14,2,4,6,0.566874,0.493134,0.002432,"#00eeff"
1088817673440514050,BibyArchRANME,15,0,17,17,0.50223,0.586125,0.007782,"#008ebb"
1211238455042199552,xscape_project,14,0,2,2,0.508349,0.572689,0.000486,"#00eeff"
1334522540316893186,Cochise561,14,0,1,1,0.58839,0.464104,0,"#00eeff"
1338046570986672129,Indomitus8,0,0,2,2,0.774104,0.423143,0.000486,"#8ecfec"
750289652603584512,Sesgismundovida,0,1,0,1,0.822475,0.371019,0,"#8ecfec"
928966702599110656,artshumsdigit,36,2,5,7,0.498905,0.405152,0.002918,"#825403"
1101092269044785152,UABOpenLabs,22,6,3,9,0.572335,0.566848,0.003891,"#00e8b2"
1353064609997934592,bembusproject,14,0,2,2,0.542164,0.452669,0.000486,"#00eeff"
1146812423418142720,ahira_de,39,0,2,2,0.566686,0.611603,0.000486,"#ff77f7"
1034746397902467072,javihaller,19,4,4,8,0.607156,0.743363,0.003405,"#00d3ff"
939275467168911367,marinaalvarezdl,3,0,2,2,0.472696,0.604867,0.000486,"#ffb3ff"
1284118227807809537,ACIMarxistes,19,0,4,4,0.605388,0.759712,0.001459,"#00d3ff"
1288756934783324161,20C_Communism,19,2,0,2,0.595879,0.770029,0.000486,"#00d3ff"
727032332151050240,ArchivoTLE,19,2,0,2,0.607591,0.769196,0.000486,"#00d3ff"
804273644792848384,SibFUniversity,30,6,0,6,0.516249,0.484571,0.002432,"#ff77ff"
1185966285944950786,arnaldpuy,14,0,1,1,0.589158,0.521733,0,"#00eeff"
1360539582580854784,dhum2021F,30,0,2,2,0.529475,0.5103,0.000486,"#ff77ff"
1224145632169992192,FwLaura,36,0,1,1,0.380867,0.232799,0,"#825403"
1241045456018460674,ChMuellerHvlB,49,3,6,9,0.44816,0.482609,0.003891,"#ff7007"
1087034331799977985,devngecu,22,0,1,1,0.580233,0.595358,0,"#00e8b2"
1367956096497942528,SinforgedsBr,36,1,0,1,0.469522,0.334616,0,"#825403"
1382693386478612482,Paisajescoloni1,35,42,0,42,0.54767,0.341056,0.019942,"#00faff"
1108119187774472194,elisa_marazzi,14,0,2,2,0.574295,0.575309,0.000486,"#00eeff"
984366613137887233,ProfesionELE,1,0,1,1,0.416628,0.793047,0,"#b6cb00"
722455100489404416,pelayo_fergar,22,0,2,2,0.57114,0.57577,0.000486,"#00e8b2"
1200676615413477377,inesgaiomachado,36,0,1,1,0.600377,0.39025,0,"#825403"
723431520375967744,nuno_ivo,36,3,2,5,0.61985,0.447397,0.001946,"#825403"
961613644088868864,carloslmarch,49,0,6,6,0.470087,0.538265,0.002432,"#ff7007"
1214531946061213696,HDRio2020,36,40,10,50,0.509851,0.37175,0.023833,"#825403"
1186214220024700935,mdolors_canada,30,0,1,1,0.527697,0.657387,0,"#ff77ff"
1359525558116319232,Carme97686198,31,0,1,1,0.682106,0.541149,0,"#3e93ff"
1135849298686611457,fonetica_UNED,30,0,3,3,0.499816,0.61516,0.000973,"#ff77ff"
1339603122897883137,FornetJaime,31,0,4,4,0.583929,0.52294,0.001459,"#3e93ff"
1288887110943027201,blackstembot,36,0,4,4,0.476315,0.466861,0.001459,"#825403"
714538612109533184,id_communism,19,1,0,1,0.692318,0.784881,0,"#00d3ff"
1361230103808798720,hdum2021A,30,4,7,11,0.461025,0.529085,0.004864,"#ff77ff"
1361235266221006848,humd2021,30,2,3,5,0.532192,0.585215,0.001946,"#ff77ff"
1184007622724333569,MariaSF___,31,0,2,2,0.600119,0.501129,0.000486,"#3e93ff"
717974960115949569,Todoporlaparte,1,0,1,1,0.444935,0.792723,0,"#b6cb00"
1048651879180378112,mario_casado_m,14,1,4,5,0.499915,0.592516,0.001946,"#00eeff"
959466294952300544,amazakkishi,1,0,1,1,0.400796,0.781001,0,"#b6cb00"
1350734023451156483,GomezPuerto1,1,0,1,1,0.417464,0.78758,0,"#b6cb00"
1254208095590506497,LaGonzlez17,30,0,2,2,0.555422,0.468629,0.000486,"#ff77ff"
1356401593189625856,Ximena49953825,35,0,1,1,0.558568,0.260279,0,"#00faff"
715661789221031937,AnaMaHen,35,0,1,1,0.554961,0.267998,0,"#00faff"
913499274566127616,CADInfusion,13,0,1,1,0.400647,0.396186,0,"#3bec00"
1338945745945317381,TonitoRousseau,35,0,1,1,0.556117,0.272117,0,"#00faff"
834792209492955141,VMongey,35,0,1,1,0.561741,0.270127,0,"#00faff"
1359989292605591553,dsb_lu,41,3,9,12,0.475298,0.47369,0.00535,"#697b00"
1347448419250536448,YehimyCh,35,0,1,1,0.569088,0.258015,0,"#00faff"
1079447411032875009,JuanGar76168740,3,0,3,3,0.556422,0.571131,0.000973,"#ffb3ff"
1046795820073406465,GCasaroes,36,2,0,2,0.494263,0.350012,0.000486,"#825403"
1035219676723380224,jkoyocku,35,0,2,2,0.500943,0.357728,0.000486,"#00faff"
982831941438394368,Terrero_Cuba,30,0,2,2,0.553733,0.473939,0.000486,"#ff77ff"
1127720139682668544,HDigitalesChile,13,19,5,24,0.43471,0.46883,0.011187,"#3bec00"
1270486813082357760,Dadoscope1,36,0,2,2,0.546074,0.438049,0.000486,"#825403"
1033420712478998528,grupoCAPIRE,13,0,2,2,0.452625,0.468205,0.000486,"#3bec00"
1117483379128250369,digmodlang,49,3,5,8,0.46415,0.51032,0.003405,"#ff7007"
1372070982253481986,BotResentido,35,0,1,1,0.585813,0.269586,0,"#00faff"
1374567214427279361,gato_seb,36,0,1,1,0.5808,0.285173,0,"#825403"
813182383650459648,__abjr__,36,1,2,3,0.523002,0.414773,0.000973,"#825403"
1216570486701903872,natalie_cobo,34,0,3,3,0.530035,0.356901,0.000973,"#ff0d69"
922877469698543616,centroISUR,34,0,1,1,0.520002,0.369846,0,"#ff0d69"
1232727847640260608,alfescuderov,35,0,1,1,0.558866,0.265407,0,"#00faff"
1112695801162227717,AdriChira,35,0,1,1,0.579754,0.267589,0,"#00faff"
1269267054508617729,CaetanoSordi,30,0,1,1,0.580624,0.362176,0,"#ff77ff"
1311709736614723587,RedeHumanidades,30,4,2,6,0.549966,0.435305,0.002432,"#ff77ff"
877561983460966401,GonzalezSilen,34,0,2,2,0.559421,0.384917,0.000486,"#ff0d69"
1259880191209299968,ArquinSlide,13,0,1,1,0.532883,0.462548,0,"#3bec00"
1022402798183477248,BeaMilz,36,3,6,9,0.510173,0.397003,0.003891,"#825403"
1118111620042055680,cezaryrosinski_,14,6,3,9,0.451057,0.463858,0.003891,"#00eeff"
1104764042609070080,IBLPAN,14,7,2,9,0.436756,0.445184,0.003891,"#00eeff"
1172296849975365637,letcesar,36,9,5,14,0.515629,0.385643,0.006323,"#825403"
923288995144093697,tomaszumerle,14,0,4,4,0.437615,0.488358,0.001459,"#00eeff"
830102509230366721,BeeaJardim,36,0,2,2,0.532768,0.43794,0.000486,"#825403"
1000032762064199680,okRa_Barreto,36,0,5,5,0.541007,0.39527,0.001946,"#825403"
1309513458782740480,mblaszczynska,14,0,2,2,0.394248,0.430711,0.000486,"#00eeff"
727651724169744384,pablo_spindola,36,0,4,4,0.53712,0.431583,0.001459,"#825403"
1223215494016184320,ErikaMelek2,36,0,2,2,0.537965,0.440174,0.000486,"#825403"
1289798980856053760,3IS_ec,14,0,2,2,0.43571,0.527743,0.000486,"#00eeff"
1235297245546893313,DocenciaY,49,0,5,5,0.434534,0.496805,0.001946,"#ff7007"
1186795623892357121,Lahisd_UFU,36,2,2,4,0.497477,0.418122,0.001459,"#825403"
1262813505931132928,Lapehnasredes,13,2,0,2,0.438224,0.435918,0.000486,"#3bec00"
973121494254530566,Geotec_UMA,14,10,4,14,0.654271,0.517451,0.006323,"#00eeff"
1067018454656565253,jaime_faure,49,0,3,3,0.436423,0.595242,0.000973,"#ff7007"
777100568573702146,AJPintoT,14,2,4,6,0.717615,0.522908,0.002432,"#00eeff"
1034899617740152832,AdanArsuaga,14,3,0,3,0.778484,0.5131,0.000973,"#00eeff"
1067803502452326405,JosLuisPrado8,43,0,1,1,0.874907,0.506724,0,"#fcae7e"
855336729850421248,CrearigrupUV,31,56,25,81,0.574372,0.50803,0.038911,"#3e93ff"
1311081230427971585,Porfirio0269,7,0,1,1,0.367966,0.352417,0,"#ffb800"
1145517423149428736,ClaudiaMatasOr2,7,0,1,1,0.367427,0.366046,0,"#ffb800"
1263567874083434497,Saludencasa6,13,0,1,1,0.477732,0.339687,0,"#3bec00"
1184497833078116353,carole_mendess,36,0,1,1,0.522475,0.303925,0,"#825403"
1053027225770045441,GilbertoHochman,36,0,1,1,0.54313,0.30168,0,"#825403"
1038564116598796288,tguzman_ba,13,1,0,1,0.421024,0.429608,0,"#3bec00"
958767985325375490,ReDCA_FBA,13,5,0,5,0.39093,0.5186,0.001946,"#3bec00"
764220104569556993,FHum_UAEM,13,1,0,1,0.419322,0.291409,0,"#3bec00"
960811653460905985,DHandDSatGale,36,0,1,1,0.392787,0.478197,0,"#825403"
1353060466302406657,Galicia_AI,30,0,3,3,0.547114,0.663055,0.000973,"#ff77ff"
1318492511464263682,ciaourense,30,3,2,5,0.550342,0.65685,0.001946,"#ff77ff"
829015419050721280,Victoriasoca1,30,0,6,6,0.523569,0.603457,0.002432,"#ff77ff"
898401890844647424,cbcolquhoun,13,0,1,1,0.395362,0.401081,0,"#3bec00"
1016759119708131329,UNEDOurense,30,7,7,14,0.555797,0.620344,0.006323,"#ff77ff"
877517892098588672,FCPySUAEMex,41,6,0,6,0.365874,0.424873,0.002432,"#697b00"
1309684332559294466,PepRohm,36,1,0,1,0.470833,0.32711,0,"#825403"
1024701855237070849,boga_garcia,14,0,2,2,0.421269,0.542978,0.000486,"#00eeff"
985264984916709382,fernandoplazap,14,0,3,3,0.451133,0.571177,0.000973,"#00eeff"
1254118350093004800,MercedesGarcaM8,14,0,2,2,0.425507,0.546869,0.000486,"#00eeff"
719282735605526532,Boixymorer,14,0,2,2,0.417753,0.545268,0.000486,"#00eeff"
1133469462210985984,AraMendozaP,41,0,1,1,0.313135,0.382823,0,"#697b00"
1230681685022445568,LavalleRolando,13,0,1,1,0.488086,0.33862,0,"#3bec00"
1100852387663831041,AnalemaG27,41,0,1,1,0.332835,0.382762,0,"#697b00"
1263967309292548103,cetdel,41,0,1,1,0.349997,0.375033,0,"#697b00"
1337611950847643648,LuisFajardoVel1,41,0,1,1,0.322857,0.394859,0,"#697b00"
1359159765423824896,SalmaArriaga7,41,0,1,1,0.301742,0.386086,0,"#697b00"
1027329803073015814,abraham_gm1916,41,4,8,12,0.382699,0.425251,0.00535,"#697b00"
770697032855986176,JonyStrike1,41,0,2,2,0.40119,0.432166,0.000486,"#697b00"
715126615810904064,IA_UNED,30,2,13,15,0.544137,0.574842,0.006809,"#ff77ff"
1050703297336791040,IfUNEDBarbastro,30,0,2,2,0.577072,0.633853,0.000486,"#ff77ff"
1312052536627597313,MariaSerrAgui,13,0,1,1,0.422646,0.420166,0,"#3bec00"
4559297794,JGallardo2021,30,0,1,1,0.590209,0.662139,0,"#ff77ff"
956353450044022784,campsdefoc,37,0,3,3,0.739163,0.387394,0.000973,"#006032"
821388886354132992,MiPiaceVOD,37,0,3,3,0.733836,0.385148,0.000973,"#006032"
1382021566163193858,carou_rosa,14,0,1,1,0.330248,0.557528,0,"#00eeff"
882618245693526016,soledad_cavallo,37,0,1,1,0.281425,0.467395,0,"#006032"
905443786410651648,UoDSCGH,36,0,1,1,0.490291,0.307504,0,"#825403"
989993497238401024,LEDIFCS,36,14,4,18,0.506308,0.33862,0.008268,"#825403"
1276572906395439104,desgranges_nina,36,4,2,6,0.504883,0.320826,0.002432,"#825403"
1186327570465411072,xxciajihle,1,7,0,7,0.497022,0.611064,0.002918,"#b6cb00"
1258121134438047744,rg_natha,34,3,5,8,0.538821,0.41416,0.003405,"#ff0d69"
1369704248624185351,fajalauzahd,31,2,5,7,0.734117,0.560807,0.002918,"#3e93ff"
1347118601841602562,IrnRincon,13,0,6,6,0.470679,0.48976,0.002432,"#3bec00"
1142169066028904448,DiogoCortiz,36,1,1,2,0.484611,0.245203,0.000486,"#825403"
1110861369438597121,idealbarcelona,1,2,0,2,0.452968,0.554169,0.000486,"#b6cb00"
1258999555334508544,AlcalaFerraez,38,0,1,1,0.560466,0.413894,0,"#662859"
1374077370374688777,prinmaugr,31,1,0,1,0.807236,0.56891,0,"#3e93ff"
783365013297852416,Patrimonio_UGR,31,1,0,1,0.804536,0.566026,0,"#3e93ff"
1214917768983851008,medievalugr,31,1,0,1,0.805383,0.571395,0,"#3e93ff"
1035275298479198208,dijei3311,36,0,1,1,0.362597,0.278552,0,"#825403"
1110260722976595969,TFlaulhabe,36,0,1,1,0.452196,0.232194,0,"#825403"
921421567304830976,Lunarheritage,38,0,1,1,0.562598,0.413906,0,"#662859"
784481520106995712,natafloresca,34,0,3,3,0.44724,0.437925,0.000973,"#ff0d69"
1232320775149019138,peumeirelles,36,0,2,2,0.511556,0.298267,0.000486,"#825403"
788328554253709312,jl_rodriguezg,14,36,6,42,0.557705,0.532862,0.019942,"#00eeff"
736284761589714944,ymontoyag,36,1,11,12,0.513094,0.451047,0.00535,"#825403"
939917215079550976,ALAntropologia,49,4,1,5,0.518272,0.445518,0.001946,"#ff7007"
1247706454787649536,WCAAimpact,13,0,1,1,0.484702,0.341914,0,"#3bec00"
954384372056100865,alguienparecia,38,0,1,1,0.554606,0.411489,0,"#662859"
1324709169694412800,Omatheusmariano,36,0,1,1,0.446816,0.219621,0,"#825403"
904956262634450944,HispanicasUCLM,15,0,4,4,0.484648,0.60089,0.001459,"#008ebb"
1071899278673629184,WDCValencia2022,22,1,0,1,0.602124,0.644287,0,"#00e8b2"
863650220797812737,leofn,36,12,0,12,0.491164,0.405379,0.00535,"#825403"
1251581685847785477,gamerlabufma,36,1,0,1,0.475277,0.319203,0,"#825403"
1148370926322556929,mv_pereirasilva,49,0,3,3,0.507014,0.378939,0.000973,"#ff7007"
1262022428189999104,FranciscoKerche,36,2,0,2,0.497178,0.328214,0.000486,"#825403"
1199368489263419393,GoHumanities,36,3,13,16,0.529283,0.447613,0.007296,"#825403"
1147569187923144705,agecsmiberia,37,0,2,2,0.481382,0.558479,0.000486,"#006032"
1250043110291173376,ShayTweeter,34,0,2,2,0.471447,0.410597,0.000486,"#ff0d69"
1132403172440510465,gcprazeres,36,0,4,4,0.506979,0.352407,0.001459,"#825403"
1377160806349955075,medimalaga,14,0,1,1,0.664936,0.512909,0,"#00eeff"
1186371970646073344,Lang_UAM,37,0,1,1,0.562689,0.46544,0,"#006032"
946407990311124992,ForoMalagaUrb,14,0,1,1,0.661651,0.508709,0,"#00eeff"
1210236061512863744,MalagaDonde,19,0,2,2,0.635357,0.563179,0.000486,"#00d3ff"
1292521037796696064,glauber_lobato,36,0,1,1,0.511094,0.286491,0,"#825403"
724636321197727744,DigitPatrimonio,15,0,1,1,0.658837,0.708763,0,"#008ebb"
1311612110133252097,DescubreToletum,15,0,1,1,0.659455,0.713714,0,"#008ebb"
1311668487710887942,joanacvp,36,4,2,6,0.528361,0.413509,0.002432,"#825403"
1204435953194020865,AngelaMPite,36,1,0,1,0.563676,0.395077,0,"#825403"
1153612563483103232,dani_sanches,36,22,15,37,0.511918,0.418736,0.01751,"#825403"
794186032283525121,PeriodicoToledo,15,0,4,4,0.571265,0.673553,0.001459,"#008ebb"
899809654598979584,w1ckson,36,0,2,2,0.508066,0.293839,0.000486,"#825403"
809795061701611520,carolinehobbit,36,0,1,1,0.44159,0.246539,0,"#825403"
1320108094236536832,ProfessoraSoph1,36,1,0,1,0.443982,0.336965,0,"#825403"
4815824777,NataliaUsme,36,3,0,3,0.406281,0.38577,0.000973,"#825403"
1319692537561579522,PatricioSimone2,38,0,2,2,0.498662,0.409065,0.000486,"#662859"
784349432296931329,caroubauer,36,24,6,30,0.511705,0.309342,0.014105,"#825403"
1167074462841417728,manuellacaputo,36,1,6,7,0.496663,0.346635,0.002918,"#825403"
4736562604,clarafelix1998,36,1,0,1,0.46337,0.320931,0,"#825403"
1196369711904280576,Coraz0nDeLe0n,36,0,3,3,0.452512,0.477658,0.000973,"#825403"
1498453768177963009,souericalima,36,2,0,2,0.490159,0.330326,0.000486,"#825403"
1317787185228206081,bizantinista,36,1,0,1,0.455191,0.338198,0,"#825403"
1373927044225056768,juditbachiller,31,0,2,2,0.609669,0.581621,0.000486,"#3e93ff"
1120695632782594048,SandraIRamosM,22,0,4,4,0.283881,0.619835,0.001459,"#00e8b2"
1334701301532389376,AloAlo_Bahia,36,1,0,1,0.477692,0.33391,0,"#825403"
798587882172715008,Wazo_Coop,42,0,3,3,0.699001,0.51496,0.000973,"#66e087"
878768867471970308,GihenaSofia,34,0,1,1,0.538176,0.345757,0,"#ff0d69"
1184180377038086150,uni_intercambio,36,1,0,1,0.436029,0.337917,0,"#825403"
735019674811928576,melomanodig,13,1,0,1,0.522095,0.387294,0,"#3bec00"
1354453633144942597,CodeAttBot,36,0,1,1,0.449432,0.326692,0,"#825403"
1093918743955161088,historiadoseua,36,0,3,3,0.468256,0.358675,0.000973,"#825403"
1367171200372326400,Rabelo_RSR,36,0,1,1,0.576416,0.288048,0,"#825403"
1092448240572739590,dhhagUNAV,1,1,0,1,0.722317,0.439568,0,"#b6cb00"
902457523491495940,Lauvanderberg1,42,0,1,1,0.743968,0.49657,0,"#66e087"
829719791149674504,TerraDiPalma,42,0,1,1,0.737698,0.494201,0,"#66e087"
795701887328800768,ArteEnRuinas,42,0,1,1,0.742598,0.489698,0,"#66e087"
859937676904062977,luacalzavara,36,0,1,1,0.502612,0.324719,0,"#825403"
850367751684272130,montirome,42,0,1,1,0.73533,0.48771,0,"#66e087"
850366350170238981,maricardo178,42,0,1,1,0.732521,0.492201,0,"#66e087"
1176509223724900352,revistasuchile,49,15,8,23,0.383755,0.489776,0.0107,"#ff7007"
1066727355702542337,idictcomunica,43,0,3,3,0.680475,0.580525,0.000973,"#fcae7e"
958093454227230720,UlrikeUlrasss,21,0,1,1,0.480595,0.958625,0,"#c6cc85"
1208418014351237121,MunozYafza,21,0,1,1,0.487694,0.950548,0,"#c6cc85"
988008109049352192,puntovioletaSA,21,0,1,1,0.480419,0.946691,0,"#c6cc85"
822785204716703744,PaulaMartnPlz,21,0,1,1,0.480941,0.939989,0,"#c6cc85"
996961652942794752,IsaLechuga1,21,0,1,1,0.470683,0.942238,0,"#c6cc85"
1092528143536140288,PearlJamYield,21,0,1,1,0.457707,0.953314,0,"#c6cc85"
1008233852815511552,paomolinave,21,0,1,1,0.489106,0.942252,0,"#c6cc85"
1235620941914349569,TodxsVan,21,0,1,1,0.484325,0.960327,0,"#c6cc85"
1037782356550144000,ClevelandKimchi,36,0,3,3,0.402405,0.443971,0.000973,"#825403"
750286186392977409,ACDH_OeAW,13,18,5,23,0.491443,0.490087,0.0107,"#3bec00"
1368568357008650241,ADitaPorAqui,36,1,0,1,0.448322,0.336041,0,"#825403"
849738048187379713,narpan_cat,34,0,2,2,0.444619,0.457024,0.000486,"#ff0d69"
965322328644161536,Opinado47749562,36,0,2,2,0.523339,0.25385,0.000486,"#825403"
1109140780508241920,GracaMGalvao1,36,0,2,2,0.522518,0.248761,0.000486,"#825403"
1197929980400984069,cleiberlicius,36,0,2,2,0.520226,0.251112,0.000486,"#825403"
723481866754510848,aascastellucci,36,1,13,14,0.503659,0.348394,0.006323,"#825403"
1370150104687054848,VozesANPUH,36,4,2,6,0.493178,0.336587,0.002432,"#825403"
1247151360493195265,RBH_ANPUH,36,2,0,2,0.501975,0.330243,0.000486,"#825403"
1326968198495956994,anpuh_ce,36,2,0,2,0.491071,0.334515,0.000486,"#825403"
1369712455312695297,UmaDiversaLuta,36,2,0,2,0.495072,0.332339,0.000486,"#825403"
1250861593245736962,historianawiki,36,8,6,14,0.483649,0.36849,0.006323,"#825403"
1258495551949230088,historiaemquar1,36,1,0,1,0.495254,0.264454,0,"#825403"
1008714063520690177,baianojhon,36,2,0,2,0.447929,0.332428,0.000486,"#825403"
931865682689646592,Postfranquismo,19,4,3,7,0.629476,0.738952,0.002918,"#00d3ff"
784581450448404481,KeilaGrinberg,36,2,0,2,0.496358,0.325817,0.000486,"#825403"
1178715177354694656,FTransiciones,19,1,0,1,0.668671,0.780357,0,"#00d3ff"
841603276835586048,HistoriaEuropa,19,1,0,1,0.689413,0.787327,0,"#00d3ff"
1328682973328240645,LaVictimas,19,1,0,1,0.675733,0.770896,0,"#00d3ff"
917110997080559618,AHdP_Historia,19,1,0,1,0.62946,0.767743,0,"#00d3ff"
708915428454576128,NotionHQ,36,2,0,2,0.471046,0.356204,0.000486,"#825403"
917463565115813888,cultura_hola,42,0,1,1,0.738028,0.505802,0,"#66e087"
1359499831111151621,CalefybTech,34,0,1,1,0.434069,0.344349,0,"#ff0d69"
1280462137475780609,imrajeshberwal,34,0,1,1,0.429215,0.343141,0,"#ff0d69"
1090168213575532545,aiccex,42,0,1,1,0.73841,0.498726,0,"#66e087"
1221837318769795073,wazobooks,42,0,1,1,0.730149,0.502678,0,"#66e087"
743514113897172992,Johaiderfm,38,0,1,1,0.354847,0.341854,0,"#662859"
1362131854418186242,jornadasfycl,37,0,1,1,0.563478,0.461671,0,"#006032"
1170392545471467520,MaConieCastillo,3,0,2,2,0.445734,0.617278,0.000486,"#ffb3ff"
941699387272650752,AlbertoGamGon,14,5,2,7,0.530768,0.506963,0.002918,"#00eeff"
1354476127247622146,NoemiAR26,7,0,1,1,0.404728,0.352717,0,"#ffb800"
1265979280292483073,Cultural_Data,30,1,0,1,0.595529,0.553932,0,"#ff77ff"
1012074471342133248,JuanaJosefaGar1,30,0,2,2,0.540541,0.593759,0.000486,"#ff77ff"
1062040776593588225,ElusiveMambo,34,0,1,1,0.391296,0.451734,0,"#ff0d69"
903055851723816961,alex_estradaRev,30,0,2,2,0.540559,0.590784,0.000486,"#ff77ff"
1022155139191386113,ppdunam,13,19,7,26,0.474821,0.444893,0.01216,"#3bec00"
989576496103788546,INULAB_ULL,13,0,4,4,0.49741,0.517088,0.001459,"#3bec00"
821527015497015299,Rodolfo_LOL,7,0,1,1,0.410505,0.354594,0,"#ffb800"
4765272913,IUEDUNED,30,8,8,16,0.519017,0.581495,0.007296,"#ff77ff"
760970024798527488,MarinaSuaza,38,0,1,1,0.670373,0.453106,0,"#662859"
1100892438149976064,JoseRMolinaGonz,30,0,3,3,0.547806,0.582403,0.000973,"#ff77ff"
775777178243960834,milili1280,38,0,1,1,0.668014,0.450302,0,"#662859"
1005157996362715137,economia_red,38,0,1,1,0.670908,0.46384,0,"#662859"
1073056485888966656,Juan_nighteyes,38,0,1,1,0.673127,0.460637,0,"#662859"
1088825738986483712,Unicayrepelente,38,0,1,1,0.66782,0.459429,0,"#662859"
1142625784630300672,JoseCamiloCC,38,0,1,1,0.660784,0.461557,0,"#662859"
1143282089950883840,Yolis33443581,34,0,1,1,0.457193,0.378278,0,"#ff0d69"
734033143397781504,MercBriones1,19,0,4,4,0.636874,0.749627,0.001459,"#00d3ff"
1214510532478349314,civil_spanish,19,1,2,3,0.631355,0.751404,0.000973,"#00d3ff"
1116435971732594689,LegsSadovsky_,34,1,7,8,0.456165,0.523465,0.003405,"#ff0d69"
4923880355,Escivilwarbooks,19,1,0,1,0.620764,0.786296,0,"#00d3ff"
1351949573439315979,ArquivosAlgarve,36,2,0,2,0.386287,0.369484,0.000486,"#825403"
1284135676280221696,Caadiazma,38,0,8,8,0.491406,0.434367,0.003405,"#662859"
1365546325635436546,Fainer77591466,34,0,4,4,0.465977,0.43286,0.001459,"#ff0d69"
1169069602141347843,aelyzegois,36,1,0,1,0.480472,0.318438,0,"#825403"
1151508604106792962,CompHumResearch,13,2,0,2,0.432277,0.473839,0.000486,"#3bec00"
1088089458250039296,EoscSecretariat,36,0,1,1,0.540937,0.355201,0,"#825403"
799812756434194438,_nefasta,36,0,2,2,0.491474,0.299615,0.000486,"#825403"
811221000419479552,C2DH_LU,36,2,0,2,0.482453,0.508027,0.000486,"#825403"
1231164058650501120,DHARPAproject,15,1,0,1,0.520567,0.729285,0,"#008ebb"
1351111027438596101,LisaWalleit,22,0,1,1,0.537815,0.654412,0,"#00e8b2"
1133775476269490177,marxeline13,34,0,2,2,0.451849,0.413299,0.000486,"#ff0d69"
971395236147720192,fabreu_2,36,1,0,1,0.491527,0.293212,0,"#825403"
1362039576076963841,dhum2021L,30,0,1,1,0.38802,0.55673,0,"#ff77ff"
847060290634203137,aintzaneeemff,30,0,1,1,0.386846,0.549648,0,"#ff77ff"
709382318788644866,HarvardOnline,13,6,0,6,0.488641,0.469727,0.002432,"#3bec00"
4578082223,StudyInRuss,14,0,1,1,0.591052,0.364442,0,"#00eeff"
1139084646795436032,MayaAndGonzalez,13,0,8,8,0.480136,0.456022,0.003405,"#3bec00"
1231737427406073858,ActosRevista,14,0,1,1,0.584566,0.455161,0,"#00eeff"
1245763222298386436,IILP_UMH,22,3,0,3,0.62332,0.459781,0.000973,"#00e8b2"
1307575781418295301,Nanahut2,49,0,1,1,0.379417,0.489829,0,"#ff7007"
968041433872719873,FAMCollioure,19,4,0,4,0.64238,0.737166,0.001459,"#00d3ff"
960588163663253505,coverwallet_es,30,3,0,3,0.526414,0.597503,0.000973,"#ff77ff"
1304169169517187072,GaleBrasil,36,0,4,4,0.440008,0.334119,0.001459,"#825403"
1364902111524384769,MineriaTextos,14,0,3,3,0.461537,0.520474,0.000973,"#00eeff"
1278689428253413378,AnitaCarneiro_,36,0,3,3,0.368309,0.507849,0.000973,"#825403"
1363558831712854020,EvaMa16120155,2,0,2,2,0.584016,0.562151,0.000486,"#ffa64e"
702472566187884544,BibliotecaEESC,36,0,1,1,0.539905,0.278636,0,"#825403"
975994998649950208,fdezcanseco,37,0,1,1,0.609479,0.554225,0,"#006032"
1332413896498552832,adalucervantes,13,0,2,2,0.457705,0.327307,0.000486,"#3bec00"
845348579451506689,carmlarramendi,15,10,10,20,0.528673,0.626979,0.009241,"#008ebb"
1198310330545459200,trifidodarcy,37,0,1,1,0.70022,0.366107,0,"#006032"
1359473546163068928,traditioorbis,37,3,0,3,0.652592,0.420539,0.000973,"#006032"
1241390269347647490,DeLamoso,36,1,0,1,0.476252,0.319481,0,"#825403"
712019135647993856,citlallijaso,34,0,2,2,0.529465,0.360743,0.000486,"#ff0d69"
1199731349734727681,LeonaVicky60,34,0,2,2,0.527079,0.36058,0.000486,"#ff0d69"
4774437856,Generacion27,19,1,0,1,0.671167,0.772231,0,"#00d3ff"
994232501391503360,odiloncaldeira,36,1,3,4,0.513738,0.375894,0.001459,"#825403"
1362725336459395080,modernitas2021,30,0,2,2,0.494229,0.595105,0.000486,"#ff77ff"
898418445494108160,Kath_Galeano,38,3,0,3,0.506506,0.359209,0.000973,"#662859"
1361282720446480388,Dhum2021M,36,3,0,3,0.464394,0.426173,0.000973,"#825403"
831530340346974208,VladimirDaza1,38,0,2,2,0.553873,0.471029,0.000486,"#662859"
1363232766238810116,JonMarketing2,37,0,3,3,0.635431,0.433087,0.000973,"#006032"
825337487593725957,alexariasarango,38,0,1,1,0.674599,0.456871,0,"#662859"
888970592921292800,DianaSan2017,38,0,1,1,0.676064,0.472315,0,"#662859"
1003513134081085440,Elena63056252,13,0,2,2,0.511072,0.41974,0.000486,"#3bec00"
1164964138214481920,revistafiguras,13,10,2,12,0.513432,0.460499,0.00535,"#3bec00"
1361276906348417025,dhum2021i,13,0,1,1,0.401555,0.487711,0,"#3bec00"
1002403869559750656,DataScienceArg,37,0,2,2,0.285968,0.458355,0.000486,"#006032"
1253701147069607936,RedaccionM,49,1,0,1,0.339311,0.555511,0,"#ff7007"
4920814606,wsosaescudero,37,0,1,1,0.242067,0.42805,0,"#006032"
999020146965536768,Conversation_E,31,47,5,52,0.529791,0.562169,0.024805,"#3e93ff"
717655573500674048,joserra7797,14,0,2,2,0.571269,0.551607,0.000486,"#00eeff"
1249024856789856256,gaska_maria,37,0,1,1,0.266065,0.472225,0,"#006032"
934093867514724354,Edumedia_3,14,0,2,2,0.568429,0.546486,0.000486,"#00eeff"
1144591663706382336,chesapeakedh,41,4,0,4,0.40941,0.436403,0.001459,"#697b00"
4628272581,vivanco_regina,41,0,1,1,0.383608,0.382232,0,"#697b00"
1226583135678320647,VerMorCam,15,0,1,1,0.557395,0.645204,0,"#008ebb"
1318613728586248192,RomeaElena,15,0,2,2,0.532706,0.625727,0.000486,"#008ebb"
1125128537885876225,AnaPaul51940248,36,0,1,1,0.518209,0.303759,0,"#825403"
1042557399117099008,javierre,30,1,0,1,0.636479,0.682132,0,"#ff77ff"
994701526236090368,Cdecampo1,30,1,0,1,0.643395,0.679847,0,"#ff77ff"
1223584388316893185,PAdGUE,2,0,1,1,0.457504,0.336203,0,"#ffa64e"
1047276155412393985,cnievesRdguez,14,0,3,3,0.485655,0.527077,0.000973,"#00eeff"
850325749362028545,InesPerezIPO,0,0,2,2,0.431239,0.599162,0.000486,"#8ecfec"
1184797855044853765,LenguaUcm,1,20,1,21,0.436373,0.678917,0.009728,"#b6cb00"
1152538829926125568,AhleAsociacion,1,6,0,6,0.436658,0.631355,0.002432,"#b6cb00"
805248855990292480,filonewsOK,37,11,0,11,0.294898,0.494174,0.004864,"#006032"
730111190647590913,diegofrailegmz,0,0,5,5,0.456994,0.573682,0.001946,"#8ecfec"
1252571483890737160,yanimallorquin,37,0,3,3,0.450755,0.508725,0.000973,"#006032"
881874560005681152,huskydramatico_,19,0,1,1,0.657494,0.781542,0,"#00d3ff"
1120338066269511685,ClubdeCiencia1,37,0,2,2,0.247955,0.488792,0.000486,"#006032"
782942504589070337,SReferencia_UBA,49,0,2,2,0.403072,0.592276,0.000486,"#ff7007"
1151133878863589378,CIGET_Megacen,22,0,2,2,0.613403,0.576874,0.000486,"#00e8b2"
977956783875555328,RitaJisa,13,0,2,2,0.487892,0.422556,0.000486,"#3bec00"
1305210842120503296,HArelllano,13,0,1,1,0.415415,0.3069,0,"#3bec00"
1149047460154748929,RNArqueoDigital,49,1,19,20,0.449387,0.50566,0.009241,"#ff7007"
955753098571583488,pezenlarama,14,0,3,3,0.469793,0.549432,0.000973,"#00eeff"
842076086691344392,castro_mrosa,37,2,10,12,0.495297,0.511561,0.00535,"#006032"
1342883800213299202,paanalytics1,37,0,1,1,0.276637,0.469845,0,"#006032"
784023184932732929,lolopaoladg,36,0,1,1,0.438933,0.201266,0,"#825403"
1238467363483377664,2020Indicadores,37,0,1,1,0.283877,0.465377,0,"#006032"
1310956426899189761,exbonaerense,37,0,1,1,0.265444,0.460082,0,"#006032"
1065941148630421504,lucasenrich,37,0,1,1,0.276283,0.473676,0,"#006032"
1207814690094669826,DavidCelisR,38,0,1,1,0.336444,0.461083,0,"#662859"
1240322951079133190,PFMuseosCol,38,0,1,1,0.340876,0.460559,0,"#662859"
1351863847808888832,IHTC_unileon,30,0,1,1,0.620995,0.473122,0,"#ff77ff"
4845992707,IDICT_Cuba,22,0,2,2,0.60881,0.577173,0.000486,"#00e8b2"
1159526698351828994,DelAlumFiloUNED,15,3,2,5,0.487461,0.564518,0.001946,"#008ebb"
972129554901950465,SymbolaComics,13,0,2,2,0.465867,0.409204,0.000486,"#3bec00"
843851246658306049,Desdeelcero,34,0,1,1,0.467509,0.376435,0,"#ff0d69"
1040925667188199424,olivejacquot,34,1,13,14,0.471941,0.485321,0.006323,"#ff0d69"
1179144529355706373,PpghisUfrj,36,1,1,2,0.485348,0.346364,0.000486,"#825403"
1216058160894685185,BArtedeto,42,0,1,1,0.735026,0.500736,0,"#66e087"
1126431839051235334,DunesHistory,36,0,2,2,0.547311,0.38688,0.000486,"#825403"
917090249062404098,RebMart86,36,0,1,1,0.612987,0.249011,0,"#825403"
881859697090981888,archivocolonial,22,1,10,11,0.48716,0.552594,0.004864,"#00e8b2"
1311993574393884674,iamvholloway,34,0,2,2,0.518698,0.354418,0.000486,"#ff0d69"
773832807017742336,kingsdigitallab,13,1,0,1,0.410674,0.49245,0,"#3bec00"
1200840006035623937,hn_lab,13,1,0,1,0.402455,0.492959,0,"#3bec00"
804380656704823297,hernan_ISDIEB,22,1,6,7,0.61275,0.549668,0.002918,"#00e8b2"
1083802932691288067,AstridW_CSIC,22,1,0,1,0.663629,0.523497,0,"#00e8b2"
991982597084499968,carla_mileidy,58,0,3,3,0.469484,0.566871,0.000973,"#005076"
1208866424405602308,MAEComunica,31,0,3,3,0.610444,0.51184,0.000973,"#3e93ff"
1049673781441167361,ssrecio,14,0,1,1,0.567978,0.473675,0,"#00eeff"
781150323243089920,RazonAbierta,30,1,0,1,0.531107,0.621748,0,"#ff77ff"
1127110122944245760,KunigoSomos,38,7,2,9,0.590294,0.473368,0.003891,"#662859"
1065253005581275136,jhumanidades,30,2,15,17,0.493526,0.542256,0.007782,"#ff77ff"
974448919269822464,ciberhumanidad,42,116,20,136,0.63165,0.469502,0.065661,"#66e087"
1111606998297128961,loshumanistas_,34,0,2,2,0.546352,0.45014,0.000486,"#ff0d69"
1114211806002675713,maranon_h,13,0,2,2,0.491934,0.386959,0.000486,"#3bec00"
1148109056244105216,mmorenonk,34,1,1,2,0.535479,0.365364,0.000486,"#ff0d69"
999052006886199297,modolo_leandro,36,1,2,3,0.456437,0.43576,0.000973,"#825403"
1351515081117491201,RiveraSalwator,13,0,8,8,0.50589,0.486005,0.003405,"#3bec00"
1116748212273143808,literaturacomun,36,1,2,3,0.482439,0.329743,0.000973,"#825403"
868127218362462208,butantanoficial,36,2,0,2,0.463234,0.324933,0.000486,"#825403"
809231029580009472,DrRob3000,34,0,1,1,0.334082,0.410347,0,"#ff0d69"
1344676770554011648,ccarocastell,31,0,3,3,0.604095,0.509092,0.000973,"#3e93ff"
1000732935576866816,_luisenriquez3O,13,0,2,2,0.438551,0.416386,0.000486,"#3bec00"
1288769305014939650,42UrdulizFTef,0,1,1,2,0.425213,0.554431,0.000486,"#8ecfec"
1135199470914719745,ViveroDominguez,34,0,5,5,0.482501,0.435937,0.001946,"#ff0d69"
1302338862744825856,DanyContrera93,43,0,1,1,0.864034,0.530579,0,"#fcae7e"
1082786080850620418,ObservaCiencia,43,28,2,30,0.801741,0.545729,0.014105,"#fcae7e"
869128565110996992,EEAGrantsPT,36,3,3,6,0.567521,0.355254,0.002432,"#825403"
4855329143,cubaciencia,43,0,1,1,0.850174,0.543172,0,"#fcae7e"
1223237874193223680,MarcelWorldd,43,0,1,1,0.886753,0.547158,0,"#fcae7e"
803269303470530560,Clop207,43,0,1,1,0.858196,0.536577,0,"#fcae7e"
1346497978001989632,Steph_SQuito,43,0,1,1,0.861339,0.544994,0,"#fcae7e"
1304812894127783938,RrFamoso,43,0,1,1,0.874769,0.553937,0,"#fcae7e"
730468533495312384,MarialinaBall,43,0,1,1,0.878433,0.530873,0,"#fcae7e"
1066116311854563328,Argelia31645372,43,0,1,1,0.847732,0.538997,0,"#fcae7e"
729852102894325760,JOHAN37293350,43,0,1,1,0.867696,0.547147,0,"#fcae7e"
1214761574365315072,JessicaArias98,43,0,2,2,0.74526,0.549088,0.000486,"#fcae7e"
1193306230795702272,ProyectosCITMA,43,0,2,2,0.744689,0.544421,0.000486,"#fcae7e"
1108362507478073344,FundoraLourdes,43,0,1,1,0.870582,0.535118,0,"#fcae7e"
822536454438064128,axelhangel1972,43,0,1,1,0.871825,0.537494,0,"#fcae7e"
1350095023581384705,epahppr,43,0,1,1,0.87661,0.549366,0,"#fcae7e"
705772915615211520,iNOVAmedialab,36,2,3,5,0.548852,0.417907,0.001946,"#825403"
1285925886529806337,barroso_villar,43,0,1,1,0.85939,0.539252,0,"#fcae7e"
870675796217745408,ICIMAR_Cuba,43,0,1,1,0.864855,0.551717,0,"#fcae7e"
719592287932715008,RedCienciaCuba,43,0,1,1,0.87387,0.532885,0,"#fcae7e"
947330587353845760,gueto_danna,37,1,0,1,0.656369,0.291252,0,"#006032"
1051240268761051136,VGauthierU,37,1,0,1,0.402692,0.167634,0,"#006032"
1099099729567367169,23Cubanito,43,0,1,1,0.85915,0.533127,0,"#fcae7e"
1080073511429910529,HeydiMV82,43,0,1,1,0.868309,0.541661,0,"#fcae7e"
1075776545367752704,CeferinoJulioSS,43,0,1,1,0.873431,0.545893,0,"#fcae7e"
851597508476358656,MigueOg150498,13,0,1,1,0.374353,0.248554,0,"#3bec00"
1206880986199404544,MnemosineP,30,3,1,4,0.523778,0.498828,0.001459,"#ff77ff"
717017512114790400,Granviademadrid,58,0,1,1,0.540732,0.175843,0,"#005076"
916349322123456512,AtanasiusGrin,58,0,3,3,0.602774,0.283928,0.000973,"#005076"
700710204103483393,Boro_RR,58,0,1,1,0.577642,0.166457,0,"#005076"
861353489007427584,dressup_ucla,34,0,2,2,0.357734,0.418792,0.000486,"#ff0d69"
953265927851855872,Dr_Saint_Herard,34,1,4,5,0.426377,0.471583,0.001946,"#ff0d69"
1105392277797646336,MedasNantes,36,1,0,1,0.428508,0.293703,0,"#825403"
926505813522501632,Ibero_Judaica,13,0,4,4,0.501029,0.376397,0.001459,"#3bec00"
788025410323877888,vicen_investiga,31,0,3,3,0.604579,0.485137,0.000973,"#3e93ff"
1328806710568488968,Rebtica1,13,0,3,3,0.486802,0.437943,0.000973,"#3bec00"
1347675201321000964,etno_activities,14,0,1,1,0.699636,0.566526,0,"#00eeff"
736179924684406785,mjofiguerero,49,1,9,10,0.411491,0.438748,0.004377,"#ff7007"
965911621678911488,redinedgob,2,0,12,12,0.596349,0.513594,0.00535,"#ffa64e"
1046392829382201349,juanxovr,19,0,3,3,0.539093,0.571109,0.000973,"#00d3ff"
1168516979239673864,BilligProject,36,1,0,1,0.606409,0.281743,0,"#825403"
1181536484458975232,eltiempolate,22,1,2,3,0.708339,0.735563,0.000973,"#00e8b2"
1225431058390376450,melissasaldana_,41,0,2,2,0.38685,0.402958,0.000486,"#697b00"
1228759843101646849,KevinVeTor,41,0,3,3,0.393334,0.421411,0.000973,"#697b00"
877918850771283970,gabbrena,13,0,2,2,0.41668,0.346079,0.000486,"#3bec00"
765737804085288960,varo_scientist,22,0,2,2,0.707803,0.738106,0.000486,"#00e8b2"
1168848970266873856,UmBiblioteca,22,0,2,2,0.702944,0.740342,0.000486,"#00e8b2"
1106240942128971779,ana_halbach,31,0,3,3,0.604043,0.496208,0.000973,"#3e93ff"
1027223088184930306,RubVilchisNjer1,41,0,3,3,0.384966,0.414269,0.000973,"#697b00"
1304858858347790336,MatiDenis29,31,0,3,3,0.614176,0.492947,0.000973,"#3e93ff"
1257309949983461382,TIDD_PUCSP,36,2,2,4,0.534907,0.408504,0.001459,"#825403"
1185318246934863873,MariaClaraRive8,13,0,2,2,0.43639,0.415941,0.000486,"#3bec00"
1331670193542746114,JorgeRo22205914,13,0,1,1,0.404436,0.377869,0,"#3bec00"
760198434418667520,BibliotecaFM,13,0,1,1,0.364401,0.251,0,"#3bec00"
911586827475259392,L_GarSar,33,0,1,1,0.237389,0.612961,0,"#ff8c00"
722457273017077760,7MerceAguilar,33,0,1,1,0.230721,0.621293,0,"#ff8c00"
1323934271174778880,elnafgonzalez,33,0,1,1,0.231826,0.615461,0,"#ff8c00"
928044703374807040,Xaviaventuras,7,0,1,1,0.715422,0.307011,0,"#ffb800"
948440322912202753,poder_edomex,41,1,2,3,0.332489,0.315135,0.000973,"#697b00"
1151896883356405760,DNE_MX,41,0,2,2,0.325614,0.31014,0.000486,"#697b00"
1246565218001584134,DarioPriego,41,0,2,2,0.319594,0.307688,0.000486,"#697b00"
998278409640955910,AutoridadEdomex,41,0,2,2,0.33402,0.30783,0.000486,"#697b00"
1047567355067416581,ComisionVerdadC,38,6,0,6,0.506057,0.407186,0.002432,"#662859"
1198277312535511040,4factorial,38,0,2,2,0.364831,0.311564,0.000486,"#662859"
1220742727224250368,Empleocscol,38,0,4,4,0.5278,0.42514,0.001459,"#662859"
1077975469788667905,luizacaires3,36,1,0,1,0.445063,0.151153,0,"#825403"
762978099508178944,IMIENS_UNED,30,1,0,1,0.478188,0.652382,0,"#ff77ff"
1023551601624137729,evaarevalo01,14,0,1,1,0.65559,0.490213,0,"#00eeff"
1166767423535624192,DigBlk,34,0,2,2,0.352423,0.415408,0.000486,"#ff0d69"
990137871704231936,SoliObreraGu,19,1,0,1,0.691138,0.771241,0,"#00d3ff"
1114607208241795073,UnidasGuada,19,1,0,1,0.686173,0.776932,0,"#00d3ff"
945238449061355520,Ashanti_Alston,19,0,2,2,0.63774,0.639017,0.000486,"#00d3ff"
1147509735459098625,WashingtonSegu4,36,0,1,1,0.525774,0.28184,0,"#825403"
1304108141752315905,unicampbot,36,0,4,4,0.512519,0.346465,0.001459,"#825403"
1480388487816032256,Everis,13,1,0,1,0.365422,0.376707,0,"#3bec00"
978667389540753409,JoseAMunoz11,34,0,2,2,0.341006,0.418392,0.000486,"#ff0d69"
1044329629107056642,vanessaperezg_,31,0,3,3,0.543407,0.550757,0.000973,"#3e93ff"
1205515324382158849,southflarchives,34,0,2,2,0.35627,0.423515,0.000486,"#ff0d69"
1242069962073743361,fraser_susannah,14,0,1,1,0.507019,0.735234,0,"#00eeff"
837022921172389894,TransmediaCat,14,2,2,4,0.511851,0.662253,0.001459,"#00eeff"
1313735689507352579,COST_CA19142,14,1,1,2,0.508107,0.723668,0.000486,"#00eeff"
841781617282674689,mirelys_puerta,31,2,9,11,0.531878,0.496444,0.004864,"#3e93ff"
966329753719529472,LauraLozanoMar,22,1,3,4,0.697916,0.516807,0.001459,"#00e8b2"
966293668800933888,GloriFuertesBot,22,2,0,2,0.751233,0.533631,0.000486,"#00e8b2"
1239549797486538752,AveFnix27650652,0,0,1,1,0.198481,0.698965,0,"#8ecfec"
1313018539918405637,ockham68gmailc1,1,0,1,1,0.687661,0.476566,0,"#b6cb00"
1304587478586871808,ensinandouniver,36,1,0,1,0.490278,0.153984,0,"#825403"
723472080503726080,BiblioLazaro,34,0,1,1,0.634318,0.439888,0,"#ff0d69"
926027952093061120,CristinaSuarezv,0,1,0,1,0.197785,0.696976,0,"#8ecfec"
1248002656267894795,mdetraduccion,14,0,1,1,0.67797,0.637085,0,"#00eeff"
714192329028935680,ABatLo73,49,0,1,1,0.394546,0.334847,0,"#ff7007"
1312524774187438080,BrayamMarcial,41,1,2,3,0.396482,0.416734,0.000973,"#697b00"
720776561230802944,AndreLAppel,49,7,2,9,0.528242,0.389225,0.003891,"#ff7007"
1054003323848876032,LaovejaR,49,1,1,2,0.29436,0.539887,0.000486,"#ff7007"
1091000332249903105,dtsiuclm,15,1,0,1,0.527013,0.743656,0,"#008ebb"
1093096816999043072,FacSocial_UCLM,15,1,0,1,0.520289,0.735445,0,"#008ebb"
1301538860405579776,RojoAndreaT,41,1,5,6,0.423064,0.402039,0.002432,"#697b00"
1242356665200062464,DH_BUW,13,4,0,4,0.460601,0.478752,0.001459,"#3bec00"
1331680814720028674,IILP_UJI,55,1,0,1,0.69523,0.526725,0,"#cb3f32"
4773878429,mmarquinezz20,22,0,1,1,0.611785,0.612133,0,"#00e8b2"
816970398126501888,AnaBMartinezG,1,8,3,11,0.580797,0.546245,0.004864,"#b6cb00"
1056813430575951872,Achille10223755,1,0,1,1,0.658318,0.57269,0,"#b6cb00"
1155044933654523904,majogallucci,1,0,1,1,0.660101,0.575832,0,"#b6cb00"
1301645635720863749,sgalindoa001,41,1,4,5,0.404814,0.429744,0.001946,"#697b00"
1301637643642580992,JUrielAlcantar1,41,0,4,4,0.394936,0.427067,0.001459,"#697b00"
1301539523239784449,MaraTap34736456,41,0,4,4,0.401516,0.425073,0.001459,"#697b00"
1179574164992266240,Suggy_Jimenez,41,2,4,6,0.402854,0.42916,0.002432,"#697b00"
1193552153186574336,AnaNikita1012,19,0,1,1,0.646643,0.775257,0,"#00d3ff"
1288822338478395392,DonantesMemoria,19,0,1,1,0.655536,0.794087,0,"#00d3ff"
817747183088726017,DeadCrushJM,41,1,0,1,0.361862,0.394063,0,"#697b00"
1199347597082652678,eharry14,38,0,2,2,0.644468,0.413683,0.000486,"#662859"
1026658483406422016,Lizz11716784,41,2,3,5,0.403969,0.422266,0.001946,"#697b00"
1019224851125624832,RuminatingProf,13,0,3,3,0.449932,0.449026,0.000973,"#3bec00"
1013735388593229824,InFoDiTex,49,1,6,7,0.450413,0.459116,0.002918,"#ff7007"
1145769738733334538,ElGemotron9,41,2,3,5,0.387755,0.419201,0.001946,"#697b00"
1142010313782546437,SeetaLabs,36,0,2,2,0.509223,0.282053,0.000486,"#825403"
1307276675214958592,AgenteCordel,14,13,4,17,0.532428,0.529418,0.007782,"#00eeff"
1271876900252762113,ConSaudade,13,3,0,3,0.438935,0.420603,0.000973,"#3bec00"
724376123665043456,GrubStreetWomen,22,1,0,1,0.4178,0.603998,0,"#00e8b2"
1102974261793300481,OWSDUY,31,0,4,4,0.557005,0.556274,0.001459,"#3e93ff"
1224721146605637633,CinthyaRosas13,41,1,5,6,0.393567,0.42403,0.002432,"#697b00"
1093514846719627264,JovanaVaher,41,2,6,8,0.399065,0.427641,0.003405,"#697b00"
715364459099856896,odio_nao,36,0,1,1,0.483698,0.219897,0,"#825403"
747620138631962624,AnarcoFino,36,0,1,1,0.482237,0.22205,0,"#825403"
4843916997,cult_latina,42,0,8,8,0.600027,0.450351,0.003405,"#66e087"
1105900802273656834,yare_cubalit,44,13,3,16,0.903276,0.610822,0.007296,"#6c241e"
1328331303595421698,Biocolores,13,0,2,2,0.420417,0.468594,0.000486,"#3bec00"
1104769144480763904,CNCComunica,44,0,1,1,0.962899,0.620618,0,"#6c241e"
1141132908104695808,CaribeXxi,44,0,1,1,0.954392,0.624638,0,"#6c241e"
1096455377363890179,EstevezVarinia,44,0,1,1,0.961232,0.622649,0,"#6c241e"
961444483232665601,JosuePoet,44,1,1,2,0.94552,0.622154,0.000486,"#6c241e"
1107643387400851458,EnriquePrezDaz2,44,0,2,2,0.874914,0.606618,0.000486,"#6c241e"
953985170629066752,jgutiear,22,4,6,10,0.563769,0.568713,0.004377,"#00e8b2"
1116834800969682945,NapolesOdalis,44,0,2,2,0.873441,0.601672,0.000486,"#6c241e"
1107592838894809088,JuanCar97741174,44,0,1,1,0.957346,0.631183,0,"#6c241e"
1317152453197025284,y_editorial,44,0,2,2,0.874974,0.599158,0.000486,"#6c241e"
1116764693115428865,cubano_libro,44,2,2,4,0.853726,0.596671,0.001459,"#6c241e"
921355475777617920,cuba_literaria,44,10,5,15,0.80086,0.585998,0.006809,"#6c241e"
881120266587426816,detria57,1,0,1,1,0.433702,0.64379,0,"#b6cb00"
1048208597841338368,895Fahrenheit,13,6,9,15,0.440169,0.49889,0.006809,"#3bec00"
1124238252595142656,MVRColombia,38,1,3,4,0.425334,0.345784,0.001459,"#662859"
978656265428701186,SLASLatAm,38,4,8,12,0.484703,0.405206,0.00535,"#662859"
1006807011172999169,FBA_UAQ,13,1,0,1,0.399809,0.464611,0,"#3bec00"
860163882853289984,msilosr,13,0,2,2,0.423918,0.503495,0.000486,"#3bec00"
893981062229102592,reubenalfredo,37,0,1,1,0.372076,0.321763,0,"#006032"
1127887029663092736,ugrlenguaesp,1,2,1,3,0.509574,0.57966,0.000973,"#b6cb00"
914592235777331204,ReGROC_,1,0,2,2,0.445625,0.670903,0.000486,"#b6cb00"
1288608789655105538,AleHm92,30,0,1,1,0.48146,0.684921,0,"#ff77ff"
1217152875119480832,juanrguezicl1,44,0,1,1,0.863795,0.599165,0,"#6c241e"
1313245829264801792,oportunidadesdh,14,0,2,2,0.621819,0.521654,0.000486,"#00eeff"
932371880497025024,QueenGalera,1,0,1,1,0.36388,0.741801,0,"#b6cb00"
1179826998635618304,Ermitanjo,1,0,1,1,0.365049,0.744123,0,"#b6cb00"
1189245689450110976,GLAM_labs,34,1,3,4,0.45836,0.503464,0.001459,"#ff0d69"
1208001938341728256,AlbitrePaula,1,0,1,1,0.349914,0.734788,0,"#b6cb00"
4871408776,GutCarrasco,1,0,4,4,0.489765,0.673936,0.001459,"#b6cb00"
1115684863900708864,SandraS10662636,44,0,1,1,0.969525,0.624639,0,"#6c241e"
1259908340433510401,KnowEquityLab,49,0,3,3,0.510532,0.478117,0.000973,"#ff7007"
1248489341346709504,ImaginaViral,13,2,4,6,0.471629,0.450108,0.002432,"#3bec00"
1247894684699000833,gischatbot,42,0,1,1,0.619044,0.400804,0,"#66e087"
1178094128183332864,Alejand13644412,14,0,1,1,0.573645,0.469481,0,"#00eeff"
1328793725347258368,LuisDeossa,49,4,0,4,0.446457,0.490301,0.001459,"#ff7007"
1217556943453077504,hegelretweets,14,0,3,3,0.458662,0.598165,0.000973,"#00eeff"
1329181648953470980,Romiaguirre851,8,0,7,7,0.397657,0.622633,0.002918,"#00ed5d"
4889716576,farodigitalok,8,1,0,1,0.293342,0.674167,0,"#00ed5d"
1145548724233543680,abichuelx,41,0,4,4,0.402487,0.418969,0.001459,"#697b00"
1308777065395748864,HiddenDeventer,36,0,1,1,0.765323,0.517392,0,"#825403"
1203285016282841089,pandoradps,14,0,1,1,0.639424,0.591407,0,"#00eeff"
1067640385831387136,VernicaCer,13,0,1,1,0.432926,0.403645,0,"#3bec00"
1303092496633921536,CreatioUnicosta,7,0,4,4,0.414072,0.404159,0.001459,"#ffb800"
1303348545114845184,ErikaMo69530763,41,0,2,2,0.390756,0.412486,0.000486,"#697b00"
904707254032760832,quatrocincoum,49,1,0,1,0.425295,0.458363,0,"#ff7007"
1065576048883056641,AleJosiowicz,36,24,28,52,0.49948,0.365528,0.024805,"#825403"
1078852701683937281,itsrenebastos,36,2,0,2,0.466098,0.308009,0.000486,"#825403"
1277000123680260098,anajuliagsouza,36,2,1,3,0.465969,0.312923,0.000973,"#825403"
1354080703009464322,tainfarias5,36,2,0,2,0.470037,0.309403,0.000486,"#825403"
1064941453284163584,GFC_UAB,30,0,1,1,0.47264,0.683681,0,"#ff77ff"
1166799167114698753,cltvovelhanegra,49,2,0,2,0.568034,0.330934,0.000486,"#ff7007"
4348664712,castells_manuel,30,1,0,1,0.589191,0.567726,0,"#ff77ff"
858636077267136513,PMarmolAvila,30,1,3,4,0.52188,0.553499,0.001459,"#ff77ff"
1235986757562372097,LiaRocha_,36,0,1,1,0.49895,0.283634,0,"#825403"
1017393123541049345,cele_unileon,37,1,2,3,0.547998,0.622199,0.000973,"#006032"
932698067052191744,MarceloVitores,49,8,9,17,0.460345,0.520661,0.007782,"#ff7007"
1075737016904704001,Luzespena1,38,0,1,1,0.1793,0.435478,0,"#662859"
854383039333494784,CNDSD_,0,1,0,1,0.62318,0.247873,0,"#8ecfec"
1111387660973756416,RadioVozAndina,34,4,1,5,0.421041,0.473046,0.001946,"#ff0d69"
1308553644648861696,apgh_upf,36,2,0,2,0.541872,0.379818,0.000486,"#825403"
1259536082192019456,JaramilloGLaura,38,0,1,1,0.167812,0.437693,0,"#662859"
958667793838329856,PensarEducacao,36,4,0,4,0.503741,0.388189,0.001459,"#825403"
931927067171721221,yamiliocampo,38,0,1,1,0.173693,0.439914,0,"#662859"
4542468681,cabinaliteraria,38,0,1,1,0.161043,0.439708,0,"#662859"
1072106657373659138,UniboDHDK,14,1,0,1,0.558856,0.456838,0,"#00eeff"
986272941208997888,Seec_Salamanca,58,0,1,1,0.820031,0.453507,0,"#005076"
1228366027760766979,FaventiaUAB,58,0,1,1,0.823062,0.457067,0,"#005076"
1302295776039755783,KaterinZapata17,34,0,2,2,0.362691,0.427263,0.000486,"#ff0d69"
1271577761371639809,pensareducar,3,3,0,3,0.30285,0.563331,0.000973,"#ffb3ff"
1324417356337131521,dasilvarrenato,36,0,5,5,0.522056,0.224179,0.001946,"#825403"
713028058207358976,AliciaCastroAR,49,0,1,1,0.409206,0.512433,0,"#ff7007"
727163763242209280,rachellstarry,34,0,3,3,0.410792,0.427666,0.000973,"#ff0d69"
1114540561871114242,dialogyca,14,0,1,1,0.647759,0.593201,0,"#00eeff"
1101577699720601600,2020Aiso,14,6,1,7,0.49164,0.512281,0.002918,"#00eeff"
843857369708793856,Gr_PASO,14,1,0,1,0.582504,0.50056,0,"#00eeff"
1300517482655100929,KarenZa73530086,13,0,1,1,0.449238,0.240185,0,"#3bec00"
786873943298805760,TIC_CFIEVA,2,0,4,4,0.677727,0.451293,0.001459,"#ffa64e"
786873128089706496,convivem_CFIEVA,2,0,5,5,0.688768,0.455655,0.001946,"#ffa64e"
784385907214446592,conviven_CFIEVA,2,0,2,2,0.677395,0.371863,0.000486,"#ffa64e"
4852215574,GermanIvanMtz,13,3,12,15,0.451004,0.368958,0.006809,"#3bec00"
708792232757829632,carmenpascua4,2,0,2,2,0.689851,0.373952,0.000486,"#ffa64e"
1052827743568711680,SorayaBuey,2,0,2,2,0.680181,0.376324,0.000486,"#ffa64e"
722496881281134592,IDAH_IU,42,1,0,1,0.612176,0.40041,0,"#66e087"
786875080592744448,Social_CFIEVA,2,0,4,4,0.686151,0.450009,0.001459,"#ffa64e"
786874743521697792,lengua_CFIEVA,2,0,5,5,0.694896,0.453995,0.001946,"#ffa64e"
786870268362944512,sociales_CFIEVA,2,4,7,11,0.672392,0.443127,0.004864,"#ffa64e"
716959739888971776,lenguae_CFIEVA,2,1,5,6,0.695814,0.458159,0.002432,"#ffa64e"
926428329598648321,frances_CFIEVA,2,0,4,4,0.68796,0.448838,0.001459,"#ffa64e"
789044827874787328,tecno_CFIEVA,2,0,4,4,0.684382,0.445633,0.001459,"#ffa64e"
1169070053163061248,Giovanni_Psic,13,1,1,2,0.419885,0.310608,0.000486,"#3bec00"
915695485322776576,iesuuaemex,13,1,0,1,0.416033,0.290063,0,"#3bec00"
1128743719576977408,Langoni16,36,0,1,1,0.497131,0.332581,0,"#825403"
1108741094605537280,CImplifica,36,1,1,2,0.546749,0.260711,0.000486,"#825403"
924961711597277184,BiblioAmSeRebis,13,0,1,1,0.549484,0.393943,0,"#3bec00"
917784634720649216,PUEDJSUNAM,7,0,3,3,0.143823,0.558512,0.000973,"#ffb800"
1352796670191403011,DialogosUNAM,7,2,0,2,0.144927,0.634617,0.000486,"#ffb800"
1219239665380839424,AnaCelesteGlri1,36,0,2,2,0.525989,0.372374,0.000486,"#825403"
712642114681704448,NISOInfo,49,5,2,7,0.519555,0.39128,0.002918,"#ff7007"
861553448654966784,libnova_es,13,0,2,2,0.453522,0.409291,0.000486,"#3bec00"
1103637295134113792,NUBILUMsmartDOC,22,0,3,3,0.486209,0.575733,0.000973,"#00e8b2"
702564560608370688,sontohi,34,0,2,2,0.555964,0.356709,0.000486,"#ff0d69"
1275899320311611392,dandomingx,36,2,2,4,0.481921,0.29728,0.001459,"#825403"
1297742372407738371,cdasilvajnr,36,2,2,4,0.481644,0.300431,0.001459,"#825403"
958733805497540608,geohumanidades,55,10,26,36,0.548038,0.535112,0.017023,"#cb3f32"
1293701733084991490,Contexturas_ORG,34,1,0,1,0.612298,0.380052,0,"#ff0d69"
850775928322088960,GrlpwrNyx,30,0,1,1,0.694633,0.618765,0,"#ff77ff"
913518111072059393,merlo56919921,49,0,1,1,0.410045,0.516922,0,"#ff7007"
1282756442039234562,INPREAN_,49,0,1,1,0.409301,0.526598,0,"#ff7007"
1118282354315993093,FacundoJCarmona,49,0,1,1,0.402097,0.522653,0,"#ff7007"
1311216886286254080,PurpleMorsh,49,0,1,1,0.40422,0.515192,0,"#ff7007"
1300444429732532225,ArJuridicas,49,0,8,8,0.428363,0.510586,0.003405,"#ff7007"
726185048047804416,kariricaurte,34,0,1,1,0.588199,0.320784,0,"#ff0d69"
1315457762000855040,hancerjuanterc1,34,0,1,1,0.618334,0.378812,0,"#ff0d69"
791400712186003458,mariav_coach,34,0,1,1,0.582705,0.321669,0,"#ff0d69"
4357578261,yobenj1,34,0,1,1,0.609276,0.32096,0,"#ff0d69"
1054460344838619136,womanscroquets,1,0,4,4,0.465951,0.60933,0.001459,"#b6cb00"
1278029375137439744,paleografianov1,30,0,1,1,0.678229,0.618717,0,"#ff77ff"
1244627223900020737,asaihistoria,49,0,4,4,0.436384,0.430853,0.001459,"#ff7007"
4795017121,CulturaUANL,45,11,0,11,0.634713,0.246273,0.004864,"#00e8ff"
1220051525256396800,Carolin43463205,13,1,0,1,0.528079,0.393689,0,"#3bec00"
810843371837083648,Gabriel77873368,13,0,1,1,0.436302,0.304436,0,"#3bec00"
1150181695670444035,McLitosOficial,38,0,1,1,0.772069,0.378811,0,"#662859"
1481257982964944896,pasdexcuse,38,2,0,2,0.699465,0.383045,0.000486,"#662859"
1011235359588605952,jmcastellanom,15,0,3,3,0.506274,0.607557,0.000973,"#008ebb"
986755274122891265,moirapez,49,0,1,1,0.195349,0.540583,0,"#ff7007"
899941847811928064,luisa_monclova,1,0,3,3,0.455858,0.605167,0.000973,"#b6cb00"
1121406574143123458,Aline_LaraG,1,0,4,4,0.453264,0.518564,0.001459,"#b6cb00"
743820166174248961,pigmeocosmico,34,0,1,1,0.348178,0.455068,0,"#ff0d69"
943911426695008256,gatoenterito,49,0,3,3,0.380402,0.507211,0.000973,"#ff7007"
1085148003944534018,RevistasUv,49,8,2,10,0.417947,0.487756,0.004377,"#ff7007"
984874914447536128,raulrey0,13,0,1,1,0.553161,0.389008,0,"#3bec00"
1135389897009893376,IAppearMissing1,38,0,1,1,0.619119,0.408474,0,"#662859"
1181012990096748545,IacceptTandC,21,0,1,1,0.285212,0.502073,0,"#c6cc85"
1162023906384982022,volveralfuturok,49,6,1,7,0.484381,0.452352,0.002918,"#ff7007"
1016744722004627456,CARLOSP77422997,49,0,1,1,0.33107,0.484988,0,"#ff7007"
1150883865302589441,profanelize,36,4,0,4,0.509003,0.378786,0.001459,"#825403"
1262315674338295810,garcia_mingo_e,22,1,3,4,0.839918,0.721672,0.001459,"#00e8b2"
1307648135095898112,mminves,22,2,0,2,0.876989,0.744939,0.000486,"#00e8b2"
1012848706524246016,Narratic2020,38,1,0,1,0.156407,0.571734,0,"#662859"
1049681827802357761,Lindapatino12,38,1,0,1,0.153192,0.575968,0,"#662859"
923198359099379712,GBaipi,49,0,1,1,0.382867,0.526728,0,"#ff7007"
943721652386516993,dolarizacionEc,34,1,0,1,0.686401,0.36706,0,"#ff0d69"
930745718834376704,janasinakeck,36,0,5,5,0.473801,0.502292,0.001946,"#825403"
1292447934563454976,MetaJournalist,36,0,5,5,0.464204,0.501181,0.001946,"#825403"
970697452352430084,CulturalAnalyt,36,1,0,1,0.480886,0.583779,0,"#825403"
1272897522462269441,hicpan,14,4,7,11,0.576412,0.522124,0.004864,"#00eeff"
782069481120014337,Mlle_Kwaii,7,0,3,3,0.442251,0.405272,0.000973,"#ffb800"
796145525095546880,nan_nangelica,36,2,0,2,0.4768,0.194807,0.000486,"#825403"
826835078546354176,FLUP_UP,36,1,0,1,0.557589,0.329074,0,"#825403"
1309333833028960256,roberio94233442,36,0,2,2,0.50987,0.342967,0.000486,"#825403"
1267480989678305283,GAvenoza,14,0,5,5,0.537039,0.571484,0.001946,"#00eeff"
769225030408376320,raydavaloss,14,0,2,2,0.479616,0.498356,0.000486,"#00eeff"
1070088190550335488,LetrasLima,14,0,2,2,0.62628,0.441102,0.000486,"#00eeff"
1290328760361930752,LaClasicoteca,22,4,1,5,0.724811,0.304894,0.001946,"#00e8b2"
4545645977,eramos_pobres,22,0,2,2,0.703978,0.373843,0.000486,"#00e8b2"
877258038561910784,NCDrusus38,30,1,2,3,0.595168,0.524597,0.000973,"#ff77ff"
846785652133900291,KevinMarsto1,2,0,1,1,0.668588,0.376265,0,"#ffa64e"
764248244348157952,holasoclemma,14,0,4,4,0.576604,0.488715,0.001459,"#00eeff"
1125295697652264960,ExtensionUex,30,1,1,2,0.594942,0.654863,0.000486,"#ff77ff"
1240702979600257025,teresabnoguer,58,0,1,1,0.794277,0.574528,0,"#005076"
1272858613569200128,SQuintslr,36,0,2,2,0.531567,0.251608,0.000486,"#825403"
1144777548955561985,KodamaKaori,36,0,2,2,0.538161,0.253655,0.000486,"#825403"
1296081151623397376,GiseleSanglard,36,0,2,2,0.545018,0.25134,0.000486,"#825403"
993506420313255939,UCNRevistas,49,7,0,7,0.433531,0.486939,0.002918,"#ff7007"
984074890365071360,jean_gajardo,49,0,3,3,0.390226,0.505632,0.000973,"#ff7007"
1138219960503812098,f_alva02,36,0,2,2,0.524565,0.411041,0.000486,"#825403"
741319002719289344,_BarbaraCabrera,46,11,1,12,0.499014,0.223057,0.00535,"#403538"
1120368470653394945,Margot73610306,46,0,1,1,0.483233,0.147768,0,"#403538"
1282049799055970305,DfDocente,46,0,1,1,0.495693,0.137938,0,"#403538"
829825988561231872,retuitero_soy,46,0,1,1,0.491886,0.144719,0,"#403538"
786719372144472065,msamperc,31,0,1,1,0.616275,0.600822,0,"#3e93ff"
1306034487772487681,ColmecasA,7,0,1,1,0.396587,0.347131,0,"#ffb800"
939197847215460353,AirForceuse123,31,0,1,1,0.619819,0.594873,0,"#3e93ff"
1231629475231752192,ValSChamorro,31,0,1,1,0.622848,0.598784,0,"#3e93ff"
1252935470113325058,SeccEduAteneoM,31,0,1,1,0.6272,0.592586,0,"#3e93ff"
1108131062901813249,aliziaherrera21,13,0,2,2,0.452944,0.362086,0.000486,"#3bec00"
835794020257447938,LectorDeAyer,15,0,3,3,0.549772,0.636095,0.000973,"#008ebb"
1233209757047148548,joaocezar1965,36,1,0,1,0.521494,0.308093,0,"#825403"
1103232323632418816,histopoler,31,0,1,1,0.632869,0.587627,0,"#3e93ff"
1237986518930726912,gustav0_r0,31,0,1,1,0.631408,0.590326,0,"#3e93ff"
4774567545,PersianaJune,31,0,1,1,0.618381,0.593856,0,"#3e93ff"
839821268299972614,bibloterapias,49,0,20,20,0.447992,0.612523,0.009241,"#ff7007"
743655181879914496,gadnamx,34,0,3,3,0.524894,0.414122,0.000973,"#ff0d69"
1071926978708729862,_Akanek_,7,0,1,1,0.400421,0.349615,0,"#ffb800"
1148381028630839297,samuel21226744,38,0,1,1,0.276847,0.61735,0,"#662859"
1306657038588674050,JuanPab95557384,7,0,2,2,0.403427,0.324667,0.000486,"#ffb800"
1115660729435033600,ToplapMx,0,0,1,1,0.275604,0.504557,0,"#8ecfec"
1113158372940034048,LaColmenaTLX,0,1,1,2,0.346066,0.526045,0.000486,"#8ecfec"
1282890370104332289,grethellrod,38,0,1,1,0.271737,0.620351,0,"#662859"
1260998584113258497,HerancasE,34,1,0,1,0.437388,0.426855,0,"#ff0d69"
1135323510161719299,marianaduzzi,36,0,2,2,0.525884,0.358947,0.000486,"#825403"
1280930981348888583,revistarca,36,0,1,1,0.526697,0.177089,0,"#825403"
1275481228444041217,ElciAzevedo,49,0,1,1,0.494332,0.35557,0,"#ff7007"
1115649350267363328,INEFOPoficial,14,1,3,4,0.684843,0.546841,0.001459,"#00eeff"
1132832819418423296,TecMonterrey,14,1,0,1,0.744699,0.552162,0,"#00eeff"
1179224371472281600,AndresC31425043,38,0,3,3,0.498056,0.484659,0.000973,"#662859"
806481186839298048,SPEC_UCLM,15,0,4,4,0.519856,0.530398,0.001459,"#008ebb"
1163758118549016576,historiapublik,19,1,3,4,0.542604,0.570588,0.001459,"#00d3ff"
1040369748020797440,maskmenezes,36,0,1,1,0.532451,0.277426,0,"#825403"
1090001022154620930,vacultura,38,0,1,1,0.314878,0.523366,0,"#662859"
746366878768074752,cefestellita1,49,0,1,1,0.497567,0.353627,0,"#ff7007"
1249332555599491072,CulturasDeModa,50,2,0,2,0.56955,0.193489,0.000486,"#ff76c3"
1137899861687377922,BicentenarioCo1,38,0,2,2,0.495194,0.498621,0.000486,"#662859"
1018639680869462016,AraucaJoropera,38,0,1,1,0.307364,0.527817,0,"#662859"
824298069755883525,aransangines,31,3,8,11,0.654033,0.529044,0.004864,"#3e93ff"
723945810027798528,GrancherCarine,34,0,1,1,0.330283,0.401657,0,"#ff0d69"
1229858271806271489,F3l1p3_R,36,0,2,2,0.455662,0.3417,0.000486,"#825403"
878741760695975936,DEmiliopics,30,0,5,5,0.504993,0.568043,0.001946,"#ff77ff"
1270934354089385984,Apolo21_UP,22,0,2,2,0.718905,0.497452,0.000486,"#00e8b2"
874397252537790464,UPInstitucional,22,1,0,1,0.788456,0.508964,0,"#00e8b2"
716896681237864448,_FundacionVT,19,1,0,1,0.647536,0.771087,0,"#00d3ff"
702762029032054784,FlynnTron1982,14,0,2,2,0.417281,0.55255,0.000486,"#00eeff"
1241002570698625025,IAI_Bibliothek,49,6,5,11,0.458276,0.524787,0.004864,"#ff7007"
882953575164502016,adrianvaruna,58,0,4,4,0.555303,0.459992,0.001459,"#005076"
1085992801110765568,JavierR98704032,17,0,1,1,0.716064,0.807903,0,"#ff9cc7"
836914364234018816,grupohieart,14,0,1,1,0.570891,0.467999,0,"#00eeff"
1203141284552159232,Ferpnce0,38,0,1,1,0.219209,0.577365,0,"#662859"
1009962360155537408,constantyesnaby,37,0,2,2,0.45922,0.49788,0.000486,"#006032"
836052061968027651,angela__moreira,36,0,2,2,0.514919,0.305873,0.000486,"#825403"
941577097671307264,Michelkobelinsk,49,0,1,1,0.50049,0.35441,0,"#ff7007"
1225559400670285824,rhcUFRJ,36,0,1,1,0.556431,0.321389,0,"#825403"
745244474176049152,AnaAbede,49,0,1,1,0.485558,0.352091,0,"#ff7007"
1046159262601367552,_ally1025,49,0,1,1,0.361737,0.462343,0,"#ff7007"
1156602840363786240,lopezmartinzpaz,58,0,1,1,0.576357,0.171426,0,"#005076"
1111691244403597317,gdielizondo,13,0,1,1,0.438096,0.244122,0,"#3bec00"
795778872428163072,AlmaXochihua,13,0,1,1,0.429552,0.237661,0,"#3bec00"
935314908278939648,china_taboada,13,0,1,1,0.450391,0.234993,0,"#3bec00"
1252078919123111936,gbritocaruso,36,0,2,2,0.530819,0.305631,0.000486,"#825403"
810047065401262080,florgarramuno,36,1,0,1,0.506289,0.279916,0,"#825403"
1220862124873764864,jfrfoficial,17,0,1,1,0.731831,0.814245,0,"#ff9cc7"
1087782837795749889,SariPerezCantu,17,0,1,1,0.730585,0.808304,0,"#ff9cc7"
1266133633389060097,CodeGnuts,36,0,2,2,0.462003,0.336984,0.000486,"#825403"
1067319796361035776,anataelgaray,22,0,1,1,0.65519,0.521494,0,"#00e8b2"
1197602130032549888,HistoriaMales,36,1,0,1,0.485509,0.295103,0,"#825403"
905160243079995399,CienciaQueSomos,13,2,2,4,0.380795,0.269103,0.001459,"#3bec00"
1223798260218974211,YennyGiraldoM1,38,0,1,1,0.525481,0.315377,0,"#662859"
986251835269726208,DiannaMarc3la,38,0,1,1,0.523386,0.317163,0,"#662859"
1261328263902826498,juanherrerazaa,38,0,1,1,0.544391,0.317429,0,"#662859"
859944808747601920,suescun_john,38,0,1,1,0.536059,0.323695,0,"#662859"
798279155813072896,juandav19274689,38,0,1,1,0.533155,0.314508,0,"#662859"
1084692549959380992,astrea_yuki,38,0,1,1,0.525687,0.318565,0,"#662859"
1037877086214602753,Mugraay,38,0,1,1,0.521043,0.311992,0,"#662859"
1123625763369029633,Divulgatiooo,19,1,0,1,0.603669,0.782864,0,"#00d3ff"
1091345414769520640,Oaps_saude,36,0,2,2,0.517137,0.288487,0.000486,"#825403"
1082283893527662593,isc_ufba,36,1,0,1,0.521223,0.215998,0,"#825403"
880593281834463233,yoli_maga,30,0,1,1,0.590332,0.563736,0,"#ff77ff"
993069278759915520,Revistas_Cult,34,15,36,51,0.462671,0.487323,0.024319,"#ff0d69"
822354309857902593,UNIR_Ecuador,14,4,1,5,0.441211,0.582247,0.001946,"#00eeff"
811947115513581569,MerQuake,14,0,1,1,0.402504,0.536244,0,"#00eeff"
1099114897655431168,EdPFMA,2,0,2,2,0.365026,0.480223,0.000486,"#ffa64e"
1308609188520775681,busa_de,34,2,0,2,0.487867,0.403941,0.000486,"#ff0d69"
908471082197372933,carlaodara,36,1,0,1,0.483142,0.29496,0,"#825403"
798854429977911298,IntFilol,14,1,0,1,0.406127,0.535571,0,"#00eeff"
1251244370084454411,tortugamarina64,13,1,0,1,0.493104,0.383261,0,"#3bec00"
975437131408642048,daphretamozo,34,1,13,14,0.479129,0.506518,0.006323,"#ff0d69"
1264673168213639178,griseluna00,36,5,0,5,0.507468,0.470066,0.001946,"#825403"
880142233563000832,romulopredes,36,0,4,4,0.496537,0.337014,0.001459,"#825403"
1044962021861724160,Cfiro5,30,0,1,1,0.190142,0.586955,0,"#ff77ff"
1088629200997752832,Janus_Clusivius,13,0,1,1,0.484912,0.393762,0,"#3bec00"
1064305929330528256,der_zeitgeist_,34,0,4,4,0.497225,0.426709,0.001459,"#ff0d69"
738869304490332160,elenamartinlpz,14,2,0,2,0.635664,0.718245,0.000486,"#00eeff"
1049418506347909121,emilioquintanap,34,0,1,1,0.36331,0.38759,0,"#ff0d69"
882010602662658049,pinol_daniel,14,0,1,1,0.639491,0.599453,0,"#00eeff"
1219791028070338560,HugoDanieLopezH,14,0,1,1,0.638787,0.594909,0,"#00eeff"
926499211293724678,paquialb,0,0,1,1,0.908977,0.328338,0,"#8ecfec"
965590611150671874,MadridTrc,58,0,4,4,0.582253,0.390538,0.001459,"#005076"
1129872865375989762,PammellaG,36,0,1,1,0.472064,0.19703,0,"#825403"
1007518859979579392,SprintbaseB,38,0,1,1,0.543182,0.401237,0,"#662859"
958316906003554306,CRAI_RCUB,15,0,1,1,0.446928,0.660111,0,"#008ebb"
778835135563268096,FonsidelasHeras,14,0,2,2,0.44201,0.631023,0.000486,"#00eeff"
1416088449258598407,pibegeek,38,3,0,3,0.539036,0.460706,0.000973,"#662859"
1220093610185633792,caroecheverri,38,2,3,5,0.52954,0.472738,0.001946,"#662859"
1174676725520830470,lbdudc,14,0,3,3,0.512842,0.578837,0.000973,"#00eeff"
1278127266103353345,jardin_lac,31,1,3,4,0.686484,0.540561,0.001459,"#3e93ff"
4549323046,eye_sandsand,31,0,2,2,0.618086,0.556212,0.000486,"#3e93ff"
4745098462,Arturo4jorge,58,0,2,2,0.592872,0.30022,0.000486,"#005076"
1263167069455081473,stereolabs1,58,0,2,2,0.60621,0.292983,0.000486,"#005076"
1045345561812054016,CarmenL12649528,58,0,2,2,0.586916,0.308472,0.000486,"#005076"
1090944524522803200,GeohumanDARIAH,55,1,4,5,0.587159,0.572285,0.001946,"#cb3f32"
841661873489641473,ortes_pin,30,0,1,1,0.549246,0.673529,0,"#ff77ff"
1229167678591504388,MrBananaTweets,49,0,3,3,0.458525,0.552934,0.000973,"#ff7007"
907896125256073216,UkNatArcRes,36,1,0,1,0.449352,0.296125,0,"#825403"
4783725632,GiovannaPoloni,48,0,2,2,0.275072,0.561547,0.000486,"#ff7a78"
1116727565060902912,mariaclarapaixs,48,7,0,7,0.261927,0.610717,0.002918,"#ff7a78"
1196201949743452161,euzaguirre,14,0,2,2,0.640278,0.569431,0.000486,"#00eeff"
786268952083050496,romero_calles,7,0,1,1,0.775205,0.632631,0,"#ffb800"
4588448793,MireiaSalgot,14,1,8,9,0.616688,0.537431,0.003891,"#00eeff"
933682070731313152,MapModern,14,1,1,2,0.589491,0.528763,0.000486,"#00eeff"
1245827498849570817,brennovich,36,2,0,2,0.462307,0.407083,0.000486,"#825403"
790552376117714944,ChristianeBirr,49,0,6,6,0.451883,0.505398,0.002432,"#ff7007"
1062358028740124672,R_Hesselbach,30,1,2,3,0.524337,0.5799,0.000973,"#ff77ff"
1233844525858197504,naniagudelo,49,2,8,10,0.467075,0.513369,0.004377,"#ff7007"
1267674930159800320,aadriarrieta,38,0,1,1,0.538739,0.391455,0,"#662859"
946731498970992640,tec_en_SL,49,1,1,2,0.43229,0.517243,0.000486,"#ff7007"
790284570079920132,FedeMolinaMagne,14,1,0,1,0.766558,0.505327,0,"#00eeff"
755781289240911876,RECoD_ok,49,0,5,5,0.502214,0.529172,0.001946,"#ff7007"
827970147100921856,vmvazquez19,49,0,1,1,0.374839,0.531734,0,"#ff7007"
1190726565073522694,UnderTheCROod,36,0,1,1,0.499623,0.288465,0,"#825403"
1245016870585016322,ceticoetriste,36,0,1,1,0.547743,0.285074,0,"#825403"
867755404012511232,MIreneDelgado,49,0,1,1,0.37703,0.53133,0,"#ff7007"
4616382814,JulietaAlmada9,49,0,1,1,0.37961,0.533581,0,"#ff7007"
818132133776592898,etothczifra,49,14,3,17,0.45002,0.501498,0.007782,"#ff7007"
1239863981818380290,IndUned,49,1,0,1,0.400154,0.638197,0,"#ff7007"
1267516516024623104,ernest_Idict,22,0,1,1,0.647317,0.612771,0,"#00e8b2"
1241520995443322881,Cristin35371414,49,0,2,2,0.512209,0.528333,0.000486,"#ff7007"
741250928309854208,luminaufjf,36,1,0,1,0.450404,0.329025,0,"#825403"
1197901462262702080,MuseoMemoria_Co,38,2,0,2,0.292905,0.547526,0.000486,"#662859"
1270507734383943680,AmandaItza,13,0,1,1,0.436266,0.501766,0,"#3bec00"
891296900145713153,RCSalvarezza,49,1,0,1,0.382272,0.676658,0,"#ff7007"
1192874831546650625,mardefuego21,47,0,1,1,0.604674,0.188778,0,"#a091c4"
891699908054581249,magugo33,55,0,5,5,0.528733,0.683666,0.001946,"#cb3f32"
805466528875429888,mc_lxpez,15,0,1,1,0.531777,0.741322,0,"#008ebb"
1157445271133085696,appneatech,55,0,2,2,0.60164,0.497595,0.000486,"#cb3f32"
4911507329,PattyMartinhe,0,0,1,1,0.359022,0.553157,0,"#8ecfec"
943791170966220800,CFIELeonInglesP,31,0,1,1,0.81918,0.528751,0,"#3e93ff"
749907166950264832,Cepli_uclm,15,1,3,4,0.62797,0.558341,0.001459,"#008ebb"
865167009247633408,didacticae,31,0,1,1,0.813338,0.522627,0,"#3e93ff"
1280334427504234496,ClaudiaCaamao5,58,0,1,1,0.545375,0.182354,0,"#005076"
4774680706,monsamga,31,0,1,1,0.818449,0.520612,0,"#3e93ff"
1253705533992943617,radihum20,36,1,0,1,0.440644,0.291396,0,"#825403"
1111263564147421185,mamutesciencia,48,0,2,2,0.267535,0.559566,0.000486,"#ff7a78"
1185062435084013568,SamuelEliudOso1,15,0,1,1,0.483633,0.734848,0,"#008ebb"
914948188464930816,mrcosan_ramir,34,0,13,13,0.499023,0.468256,0.005837,"#ff0d69"
847045340167589888,OceanicEx,13,13,2,15,0.471278,0.456991,0.006809,"#3bec00"
1238239751284678658,lilyleo_ruiz,58,0,1,1,0.602055,0.174725,0,"#005076"
781331251441655808,Lala_yubarta,13,4,0,4,0.482536,0.410074,0.001459,"#3bec00"
1196779573628805120,XimGutierrez,13,0,2,2,0.459754,0.417875,0.000486,"#3bec00"
1083728790369509377,cimbage,49,10,3,13,0.418046,0.532603,0.005837,"#ff7007"
1190335409928183808,Patycamacho51,58,0,1,1,0.558403,0.162005,0,"#005076"
1226160956050432000,coralincolors,38,0,1,1,0.429137,0.767273,0,"#662859"
1200260040118145025,AndreaA17054922,38,0,1,1,0.441404,0.774263,0,"#662859"
1248080811766829058,VivianaMedinaM3,38,0,1,1,0.440258,0.779015,0,"#662859"
1175882365048168448,Carcosalife,38,0,1,1,0.469884,0.786982,0,"#662859"
1211826649878020096,lopezvargaslind,58,0,1,1,0.583189,0.184225,0,"#005076"
1260422139972222977,Cielo_Guz_,58,0,1,1,0.578536,0.174358,0,"#005076"
1173630361995268096,magotita93,58,0,1,1,0.558805,0.176098,0,"#005076"
906039763756396544,caralvap26,13,0,1,1,0.506843,0.395719,0,"#3bec00"
1287437384574021632,PaulaCruzSoto,58,0,1,1,0.546891,0.165037,0,"#005076"
1075554062572142592,UaemexComunidad,41,1,0,1,0.364407,0.390883,0,"#697b00"
1142182488560807936,Machado_revista,36,0,1,1,0.444148,0.367061,0,"#825403"
981691992408186881,viridiana_saray,58,0,1,1,0.544971,0.162792,0,"#005076"
737737232128352256,lcarrion80,0,0,1,1,0.348599,0.580539,0,"#8ecfec"
1235728402960855040,PettinaVanni,13,1,0,1,0.518031,0.395407,0,"#3bec00"
1200878637618212865,guadalupe_ranir,58,0,1,1,0.578762,0.168939,0,"#005076"
1218908872007651328,azucenagm_,58,0,1,1,0.5652,0.173393,0,"#005076"
727911688452870144,EugenioApple,58,0,1,1,0.586289,0.179355,0,"#005076"
1271570415454912513,pesquisadoraexp,48,62,2,64,0.276724,0.659552,0.030642,"#ff7a78"
856999084313505792,CatiaAmorim5,48,0,3,3,0.2276,0.667603,0.000973,"#ff7a78"
1124245818356187136,UspRevista,36,1,0,1,0.45387,0.317766,0,"#825403"
1168368394695041024,historalcast,36,1,0,1,0.446349,0.315562,0,"#825403"
999716923637190656,PpghisU,36,1,0,1,0.456198,0.319784,0,"#825403"
742400383016804352,rcmidura,36,1,0,1,0.432664,0.32551,0,"#825403"
1273247054874193920,AntonioCriadoM1,14,0,2,2,0.436324,0.53702,0.000486,"#00eeff"
863924620705103872,IsabelA39422151,15,0,1,1,0.519987,0.689572,0,"#008ebb"
999035393180872704,lasaeducacion,37,0,2,2,0.447907,0.372217,0.000486,"#006032"
1176258873935695872,fuckyahcarol,48,0,1,1,0.233144,0.730521,0,"#ff7a78"
880474370124242944,MalaJine,48,0,1,1,0.225015,0.725764,0,"#ff7a78"
1226041826760634368,sonpioneras,31,0,2,2,0.640487,0.588611,0.000486,"#3e93ff"
774625747524841472,donosti_tik,18,0,1,1,0.762435,0.640062,0,"#5456a6"
836412937652830209,camilopjXIX,34,6,43,49,0.489864,0.483732,0.023346,"#ff0d69"
898198568883957760,OU_DigLearn,34,0,3,3,0.463718,0.432849,0.000973,"#ff0d69"
1108565691509153793,DigiLabour,36,7,3,10,0.496724,0.268294,0.004377,"#825403"
1082861533535842304,grohmann_rafael,36,0,2,2,0.489962,0.213403,0.000486,"#825403"
885187242947379205,ChenXi_aqs,14,0,2,2,0.479608,0.567932,0.000486,"#00eeff"
928659582800539648,cienperros,13,0,1,1,0.645081,0.98431,0,"#3bec00"
1117517442182414338,HelioAl02325222,36,0,1,1,0.495147,0.277572,0,"#825403"
1197981630268350464,GenerousDona,14,0,1,1,0.594791,0.457479,0,"#00eeff"
988100900920156160,FPE_UFV,15,7,2,9,0.516529,0.691519,0.003891,"#008ebb"
1153973022480576517,UBExtremadura,14,0,1,1,0.652809,0.591241,0,"#00eeff"
1262412140268392449,CarmenTorija2,15,0,2,2,0.529184,0.697443,0.000486,"#008ebb"
1066033657809436672,pmondragon_,15,0,3,3,0.577241,0.692492,0.000973,"#008ebb"
1268099601103454209,MarMir58616220,34,0,4,4,0.384987,0.427907,0.001459,"#ff0d69"
1266150170904997888,Lourdes02477803,13,1,0,1,0.514859,0.278145,0,"#3bec00"
1258185154515947522,UnInPublica,31,1,1,2,0.573959,0.487462,0.000486,"#3e93ff"
883876602211442688,frasesdeeugenio,48,0,1,1,0.23337,0.717396,0,"#ff7a78"
1222258530289442823,nepat_br,48,0,1,1,0.25225,0.720755,0,"#ff7a78"
976825858383073281,times_serif,34,0,4,4,0.474161,0.431385,0.001459,"#ff0d69"
963273918336458752,FernandaSousa_8,36,8,1,9,0.475039,0.234158,0.003891,"#825403"
1144313728357326849,DH2020_Ottawa,13,1,1,2,0.541168,0.469647,0.000486,"#3bec00"
1094608003817443329,ianvazaraujo,36,1,1,2,0.540606,0.307796,0.000486,"#825403"
767406438255849472,KimJoaoUn,36,1,4,5,0.53825,0.275287,0.001946,"#825403"
1124869914966351872,la_libelula82,38,0,2,2,0.651934,0.402066,0.000486,"#662859"
1177627494964486144,maishistoriapf,48,0,1,1,0.197977,0.72285,0,"#ff7a78"
1137881685931057153,picveis,49,17,3,20,0.530349,0.457264,0.009241,"#ff7007"
708434851200962560,PameSantii78,38,0,2,2,0.643957,0.404226,0.000486,"#662859"
1270368925172334594,Miguel_Marti_,15,0,3,3,0.539068,0.676961,0.000973,"#008ebb"
1009108603146571776,Mabepedu,49,0,1,1,0.342639,0.557656,0,"#ff7007"
980851231831752704,ndharari,49,0,1,1,0.343658,0.566016,0,"#ff7007"
1163571870408552449,slowUTEC,10,0,2,2,0.487925,0.505889,0.000486,"#52d7c0"
1216436872060207104,inclusiongob,31,7,0,7,0.596873,0.592109,0.002918,"#3e93ff"
1155890195339681792,Margari16286812,31,0,1,1,0.649642,0.496743,0,"#3e93ff"
1228023295552913408,onlineUFV,15,0,1,1,0.530455,0.722499,0,"#008ebb"
961004241274966018,76AMuller,36,0,1,1,0.544546,0.29093,0,"#825403"
1032066592732053504,ReginaMartnezC1,37,0,2,2,0.459524,0.367186,0.000486,"#006032"
961298026634629121,SOMM_alliance,30,1,0,1,0.593834,0.549308,0,"#ff77ff"
1216767575608233984,TeodoraMartinS2,31,0,3,3,0.634774,0.597227,0.000973,"#3e93ff"
790952148922163200,FAM_SORIA,31,0,3,3,0.629458,0.593259,0.000973,"#3e93ff"
1278889453977731072,talivre1,48,0,1,1,0.218605,0.701386,0,"#ff7a78"
1207139681508438017,punanny7,48,0,1,1,0.235005,0.71154,0,"#ff7a78"
1081718713802465280,paulonavasconi,48,0,1,1,0.243645,0.723195,0,"#ff7a78"
1013523249605562369,Keshi,48,0,1,1,0.240274,0.716002,0,"#ff7a78"
1053319446192893952,roana____,48,0,1,1,0.220406,0.711783,0,"#ff7a78"
1038478186026344448,senapisa,48,0,1,1,0.244837,0.72848,0,"#ff7a78"
1281337410333351937,catilusilveira,48,0,1,1,0.238915,0.713977,0,"#ff7a78"
1265625190232457216,ClaraPe49745716,55,0,1,1,0.798471,0.518109,0,"#cb3f32"
1012087412946821120,briennetreta,48,0,1,1,0.218189,0.713914,0,"#ff7a78"
1230114552748089352,TempoHistorias,48,0,1,1,0.248604,0.711618,0,"#ff7a78"
1165371915797745664,medievalMB,36,1,0,1,0.502635,0.330457,0,"#825403"
1131264194345676800,VCalsoni,48,0,1,1,0.230016,0.701441,0,"#ff7a78"
1279601711963914242,robrubinstein,48,0,1,1,0.218915,0.721841,0,"#ff7a78"
1014828441487757313,toputaaaa,48,0,1,1,0.239179,0.709127,0,"#ff7a78"
1164384589068083201,gabxmb,48,0,1,1,0.207709,0.712736,0,"#ff7a78"
1235394524383506432,EscenariosUdeSA,3,1,0,1,0.402729,0.750251,0,"#ffb3ff"
1101146937175224321,BandasCreativas,3,1,0,1,0.403469,0.753776,0,"#ffb3ff"
1267913463688560641,FedericoHernn5,3,0,1,1,0.471864,0.667464,0,"#ffb3ff"
1017054883017617413,CarlotaFTrav,14,0,2,2,0.542626,0.566987,0.000486,"#00eeff"
1265591198460321793,Magali94720842,37,0,1,1,0.441917,0.667058,0,"#006032"
1122174650484703232,shavasanna,14,0,1,1,0.603805,0.575487,0,"#00eeff"
1077734311799984128,saudadepc,13,0,3,3,0.523242,0.456125,0.000973,"#3bec00"
806446407708188672,fefcoll,14,0,2,2,0.441795,0.527307,0.000486,"#00eeff"
1252966455404085248,Mariela06061979,36,1,0,1,0.499753,0.27769,0,"#825403"
1271997238928199680,LanksyPaulo,38,1,1,2,0.59453,0.328633,0.000486,"#662859"
1125739287067222017,bibliodataWG,14,0,3,3,0.452706,0.52713,0.000973,"#00eeff"
748155599452536832,HistoconUgr,31,1,1,2,0.622257,0.569955,0.000486,"#3e93ff"
1007791841239068674,UAinvestigacion,31,0,2,2,0.581846,0.50647,0.000486,"#3e93ff"
988787965441794048,labrec_br,34,1,0,1,0.427567,0.435916,0,"#ff0d69"
1189639978466381824,RevistaUrbanocl,31,0,2,2,0.595817,0.503221,0.000486,"#3e93ff"
983775631149293570,CuadernosdelSur,13,20,2,22,0.485451,0.308655,0.010214,"#3bec00"
893463332136656896,Novoa_Sp,34,0,3,3,0.46036,0.44182,0.000973,"#ff0d69"
738364549376704512,mcapdevilat,31,0,2,2,0.585081,0.51049,0.000486,"#3e93ff"
929020636126744576,izrego,2,0,1,1,0.753619,0.518954,0,"#ffa64e"
1220488917264236544,aprototipeira,36,0,1,1,0.52916,0.293531,0,"#825403"
1026589695478771712,Ricardo52288879,41,3,3,6,0.379818,0.40962,0.002432,"#697b00"
1096069584640270337,RemediosLuisA,41,1,2,3,0.351977,0.394905,0.000973,"#697b00"
1133329034367131648,EOB_editorial,30,2,0,2,0.373965,0.500988,0.000486,"#ff77ff"
1223566485295157249,koldobizkar,30,0,2,2,0.333215,0.539887,0.000486,"#ff77ff"
1159607002278051840,Aide22530720,41,1,0,1,0.300251,0.390204,0,"#697b00"
4833033172,Rojaskrmen1,13,0,4,4,0.482531,0.475544,0.001459,"#3bec00"
1423008611127660552,NayeGmez12,41,1,0,1,0.341543,0.38507,0,"#697b00"
893682445475655680,AmaeraniLL,41,1,0,1,0.314584,0.380862,0,"#697b00"
780353835046932480,Caro_Escarlata,1,2,7,9,0.481222,0.504137,0.003891,"#b6cb00"
904806253649698816,tellesjornal,36,4,0,4,0.516855,0.408752,0.001459,"#825403"
851160531138473984,HumanitatsUAB,14,4,7,11,0.54762,0.511741,0.004864,"#00eeff"
780604255312805889,PortilloBsAs,8,0,1,1,0.251445,0.258383,0,"#00ed5d"
1240909521763151872,EMOOC_emergya,49,1,0,1,0.408989,0.673389,0,"#ff7007"
875233780180582400,ImpressoProject,36,1,0,1,0.507933,0.332717,0,"#825403"
1262925759749947393,diecallevin,2,0,1,1,0.739224,0.52872,0,"#ffa64e"
1115686179771256832,Paulodass,36,1,0,1,0.507438,0.332237,0,"#825403"
831644138755997696,Naxolotzin,13,0,1,1,0.424611,0.406179,0,"#3bec00"
1084843565979783169,UNIRescuelaprof,14,0,1,1,0.408612,0.534341,0,"#00eeff"
722326045500837888,Gorikortin,3,1,0,1,0.617988,0.580104,0,"#ffb3ff"
1265309676939423746,GraceCaldevilla,8,0,1,1,0.236223,0.267406,0,"#00ed5d"
758042097442254849,Disoriented_Me,38,0,1,1,0.560097,0.709592,0,"#662859"
4623129268,esdagb,49,1,0,1,0.388028,0.66464,0,"#ff7007"
949833126204837893,CiberEticArg,49,1,3,4,0.580826,0.607516,0.001459,"#ff7007"
1177988181934956544,santamarcanda,0,0,3,3,0.447971,0.501213,0.000973,"#8ecfec"
974364900809216001,ComunicacaoIfch,36,0,1,1,0.544881,0.246065,0,"#825403"
912205008359260161,Josepmdiaz,8,0,1,1,0.238717,0.272375,0,"#00ed5d"
928410118051549184,PuertasMLuis,0,0,1,1,0.361965,0.559991,0,"#8ecfec"
1095730566329188352,bio_sintesis,30,0,2,2,0.571087,0.556005,0.000486,"#ff77ff"
930093080660848645,EducacioUAB,14,4,0,4,0.521896,0.486098,0.001459,"#00eeff"
1006107832498966528,TraduccioUAB,14,4,0,4,0.514209,0.484584,0.001459,"#00eeff"
4870395965,ASCC__7,1,0,1,1,0.369691,0.539632,0,"#b6cb00"
1072576580814364673,MmwProject,1,1,0,1,0.520165,0.654378,0,"#b6cb00"
1267399193523601408,_Andoniog,8,0,1,1,0.261421,0.25327,0,"#00ed5d"
796297530854281216,CerezuelaG,8,0,1,1,0.26864,0.270814,0,"#00ed5d"
1065901036273983488,annetakh,41,0,2,2,0.377074,0.398164,0.000486,"#697b00"
1172904203326578690,PatriciaCarabel,8,0,1,1,0.273571,0.257604,0,"#00ed5d"
1270021961528348672,l_demagalhaes,36,1,4,5,0.547177,0.319991,0.001946,"#825403"
778707995660214272,AE_Educacion,30,3,0,3,0.599801,0.762178,0.000973,"#ff77ff"
978092708224032768,cerdajuanma,49,0,2,2,0.565726,0.452589,0.000486,"#ff7007"
897422271190585345,mbroullon,30,5,3,8,0.495818,0.608908,0.003405,"#ff77ff"
920401629949710336,laurabelru,50,1,2,3,0.570052,0.328932,0.000973,"#ff76c3"
1267801303713021954,fashionista_uk1,49,0,1,1,0.327995,0.323811,0,"#ff7007"
1245070078548348928,brazil_gale,49,7,1,8,0.381302,0.379739,0.003405,"#ff7007"
1026682520979550208,AyookMarco,13,0,1,1,0.512604,0.231143,0,"#3bec00"
1143616801395187712,tsapmaatsa,13,0,1,1,0.515402,0.233597,0,"#3bec00"
1034208783034200069,kumoontun,51,2,3,5,0.497361,0.249405,0.001946,"#c44aac"
1017536844114857984,osscarlopezzA,14,1,0,1,0.445356,0.332129,0,"#00eeff"
1226929198931025921,powerbi_pros,49,0,2,2,0.571891,0.451528,0.000486,"#ff7007"
1232109292309950465,trincaseis,36,1,0,1,0.526571,0.140303,0,"#825403"
811652188414033921,gaqueirolo,49,0,3,3,0.519851,0.47429,0.000973,"#ff7007"
865488862750965761,e_health_,22,0,5,5,0.55967,0.433495,0.001946,"#00e8b2"
997311241830977536,RaicesGen,34,0,1,1,0.531236,0.342208,0,"#ff0d69"
889959973987516416,TheUrbanmetre,36,0,1,1,0.565711,0.2415,0,"#825403"
1246909563506483209,chains_mr,0,0,1,1,0.421168,0.519715,0,"#8ecfec"
1267867464836296704,coruja_digital,0,0,4,4,0.445751,0.510784,0.001459,"#8ecfec"
853173463074430976,nico19965,8,0,1,1,0.250034,0.267025,0,"#00ed5d"
1207334054338547712,rhizomes1848,36,0,1,1,0.376542,0.486435,0,"#825403"
758561835897479168,SantillanaLAB,2,8,1,9,0.642672,0.573562,0.003891,"#ffa64e"
1049609691972730882,bydcanarias,22,0,1,1,0.609128,0.611325,0,"#00e8b2"
1174736312643063810,Theo189Theo,2,0,1,1,0.749519,0.521365,0,"#ffa64e"
1134981506131267584,MerlinaZM,13,0,1,1,0.41766,0.414909,0,"#3bec00"
4803733827,Pavasal,0,1,2,3,0.646403,0.631491,0.000973,"#8ecfec"
796316345658933248,carmelomayorv,2,0,2,2,0.649045,0.658818,0.000486,"#ffa64e"
854068171040575489,yolandaiwebsoc,2,1,1,2,0.683051,0.669027,0.000486,"#ffa64e"
4654578857,fathermarch,0,0,1,1,0.785042,0.695027,0,"#8ecfec"
747259161121980416,Claudio49186037,2,0,1,1,0.456284,0.654004,0,"#ffa64e"
1050233128537735170,TicEducativas,14,0,1,1,0.658335,0.494485,0,"#00eeff"
958387229734383616,GoienUrka,18,0,2,2,0.757033,0.620369,0.000486,"#5456a6"
859515072355463168,EstherdelBrio,2,0,2,2,0.488977,0.638935,0.000486,"#ffa64e"
1256700295809302540,inah_covatlao,13,1,0,1,0.535541,0.234358,0,"#3bec00"
4870512071,tewoba_,2,0,2,2,0.562837,0.633603,0.000486,"#ffa64e"
819193702514049025,MarielaPzSz,2,0,1,1,0.748355,0.516678,0,"#ffa64e"
1229723007008071681,RosarioRothamel,2,0,1,1,0.739176,0.511036,0,"#ffa64e"
779297814169972737,raqueldelengua,2,0,2,2,0.67262,0.505945,0.000486,"#ffa64e"
1181170841196859392,redplanea,2,0,1,1,0.741881,0.524441,0,"#ffa64e"
878900642210869249,ALTautores,2,0,2,2,0.641123,0.6227,0.000486,"#ffa64e"
892430462307758080,bib_fadacademia,13,0,1,1,0.421692,0.239968,0,"#3bec00"
800051491499376642,utopianluv,31,0,1,1,0.62383,0.561184,0,"#3e93ff"
769173528058990592,DrGSEspinosa,14,0,12,12,0.541907,0.458916,0.00535,"#00eeff"
1043440968652021760,dia_supe,19,2,0,2,0.558167,0.620588,0.000486,"#00d3ff"
4506649642,HistoriaAstur,19,1,0,1,0.614207,0.792896,0,"#00d3ff"
1158853886544887808,mlaumeza1,8,0,1,1,0.256171,0.252364,0,"#00ed5d"
783031727275081728,ydonosomeisel,34,0,3,3,0.601293,0.366693,0.000973,"#ff0d69"
1264150556744060928,cema_investiga,22,0,1,1,0.59121,0.606746,0,"#00e8b2"
1129467463853387776,GFlownew,8,0,1,1,0.274938,0.247333,0,"#00ed5d"
1106174388628537347,welcomedwelling,49,0,1,1,0.330447,0.330764,0,"#ff7007"
991160475432968192,IvanParro1,58,0,6,6,0.527057,0.480562,0.002432,"#005076"
1045610530021486592,ConsejoSUPO,1,0,1,1,0.475452,0.621102,0,"#b6cb00"
907639025095376897,angeles_heras,30,1,0,1,0.590205,0.560009,0,"#ff77ff"
1025387888693968897,nosoyross,58,0,2,2,0.619052,0.312528,0.000486,"#005076"
748817125171531776,gatopormadrid,58,0,2,2,0.582517,0.304737,0.000486,"#005076"
1213147483200577536,LazyBot6,0,0,1,1,0.240402,0.545046,0,"#8ecfec"
4820804277,machinelearnflx,0,4,1,5,0.315983,0.550792,0.001946,"#8ecfec"
1091051827913805824,MLecturas,39,0,1,1,0.694706,0.763376,0,"#ff77f7"
1072185188384497664,ArqueologiaI,19,1,0,1,0.637678,0.776795,0,"#00d3ff"
999147932082409477,HistorieEnFotos,19,1,0,1,0.674021,0.759526,0,"#00d3ff"
916016690420420609,_epidat,49,0,1,1,0.350143,0.46637,0,"#ff7007"
1101208942842122242,historiadelmov1,19,2,0,2,0.619803,0.771282,0.000486,"#00d3ff"
928052246272708613,CabezaDincendio,13,0,2,2,0.452151,0.419924,0.000486,"#3bec00"
835245892311613440,dan_rudmann,49,1,4,5,0.437683,0.534378,0.001946,"#ff7007"
1033745802341097472,PDiazRubio,49,1,0,1,0.386221,0.529109,0,"#ff7007"
1219941855871356928,eeb_ove,0,0,1,1,0.27544,0.487422,0,"#8ecfec"
898211674167050245,jvalenciamolano,49,2,0,2,0.436318,0.53184,0.000486,"#ff7007"
902084381405323264,MariaVidriero,15,12,3,15,0.514928,0.582656,0.006809,"#008ebb"
1257080033551753220,geronisala,15,0,1,1,0.53203,0.670147,0,"#008ebb"
861530116618432512,archivo_uah,15,0,1,1,0.528131,0.667932,0,"#008ebb"
1051658162019950592,peu441,36,1,0,1,0.499724,0.294726,0,"#825403"
750852818181971968,PokemonGoRJ,36,1,0,1,0.471474,0.298958,0,"#825403"
1260394816199888904,BotHumDig,36,3,0,3,0.519502,0.348408,0.000973,"#825403"
960617534293716992,wikidata_es,30,4,0,4,0.405688,0.499077,0.001459,"#ff77ff"
1058466528952225792,mariabdrozf,8,0,1,1,0.235902,0.263181,0,"#00ed5d"
1096559171644915713,AndreaNielsen00,8,0,1,1,0.297036,0.254125,0,"#00ed5d"
1246560570611990528,Vir_AIV,8,0,1,1,0.258638,0.262777,0,"#00ed5d"
748038240289054720,Dianejael,49,1,0,1,0.340517,0.553249,0,"#ff7007"
1006847900842971137,albgonpon,14,0,1,1,0.430613,0.525042,0,"#00eeff"
825814191114182657,Joseido4098,49,1,8,9,0.456991,0.485864,0.003891,"#ff7007"
1255530865674895361,revmicrotext,13,0,1,1,0.431596,0.403883,0,"#3bec00"
1200284639119708160,sebsr_,34,0,5,5,0.543192,0.444984,0.001946,"#ff0d69"
805900894474825730,jluwrites,49,0,2,2,0.377554,0.494195,0.000486,"#ff7007"
1062168589376147457,CidadaoComum3,36,0,2,2,0.51956,0.359024,0.000486,"#825403"
1477305022203502593,Ascun1,49,2,0,2,0.411029,0.586938,0.000486,"#ff7007"
1252621947273428993,Cristian_GM93,37,0,1,1,0.564584,0.45762,0,"#006032"
1107745523983925255,GMelindrosa,37,0,1,1,0.690133,0.503662,0,"#006032"
1143717971539288064,ManuelJessTova1,30,0,1,1,0.596749,0.565472,0,"#ff77ff"
1182617887569334274,LenguasY,22,0,4,4,0.519157,0.577452,0.001459,"#00e8b2"
915948076946411520,inctdd,36,4,0,4,0.523314,0.351694,0.001459,"#825403"
821150881953542145,dprieto_,51,0,1,1,0.482798,0.197294,0,"#c44aac"
1192848641771393027,Colmixe,51,4,1,5,0.456883,0.272412,0.001946,"#c44aac"
1258246814572167168,Lula00385313,36,2,0,2,0.521503,0.343233,0.000486,"#825403"
813836389947150340,lellyjz,34,0,3,3,0.387905,0.417007,0.000973,"#ff0d69"
746274797462691840,MiguelCornejoSE,1,0,2,2,0.649493,0.438022,0.000486,"#b6cb00"
1101836495391023110,voces73405127,22,0,1,1,0.659117,0.531279,0,"#00e8b2"
1019178767586086912,PRPROBiblioteca,49,1,2,3,0.494892,0.287166,0.000973,"#ff7007"
902968555855003648,dh2018cdmx,49,59,28,87,0.461521,0.461984,0.041829,"#ff7007"
910596497355321344,MarteArtemis,13,0,3,3,0.455956,0.355998,0.000973,"#3bec00"
801630392000225281,RedTDPC,13,3,1,4,0.442914,0.43296,0.001459,"#3bec00"
816067669233373184,TassoInMusic,34,2,0,2,0.519277,0.411512,0.000486,"#ff0d69"
1100172769575063552,SemanticScholar,3,1,0,1,0.304429,0.569931,0,"#ffb3ff"
1240591329052299266,UGRenCasa,31,13,3,16,0.576015,0.524433,0.007296,"#3e93ff"
749546837917523968,juliarsct,34,0,2,2,0.492709,0.406908,0.000486,"#ff0d69"
4549154235,i_ortega2,18,0,3,3,0.702959,0.529004,0.000973,"#5456a6"
1119702342864130048,Anthony96075706,14,0,1,1,0.637873,0.598946,0,"#00eeff"
719935781326954496,MBCP_UB,14,1,0,1,0.635655,0.594721,0,"#00eeff"
837751580845801472,ulpgcresearch,30,7,4,11,0.572474,0.571761,0.004864,"#ff77ff"
958107568324448256,data_smarts,49,1,0,1,0.356399,0.618059,0,"#ff7007"
1131214586730942464,technetempire,36,6,8,14,0.501242,0.412927,0.006323,"#825403"
948781476207673349,random_hash_tag,36,0,4,4,0.521935,0.363442,0.001459,"#825403"
1227500224219951104,humd1920t1,13,0,8,8,0.464435,0.451323,0.003405,"#3bec00"
1134549909854720000,sehcyt,15,1,3,4,0.55098,0.628586,0.001459,"#008ebb"
977634608148832257,Player__8,49,1,0,1,0.377413,0.62638,0,"#ff7007"
1225260777759821825,ceelabn,41,0,3,3,0.381482,0.406481,0.000973,"#697b00"
1088574835180142593,DuceMinerva,14,0,1,1,0.403911,0.532025,0,"#00eeff"
824380117304668162,labingranada,31,3,4,7,0.588706,0.551822,0.002918,"#3e93ff"
1158743593424752640,AnaisEmile,41,1,0,1,0.354042,0.374764,0,"#697b00"
1228149556564463621,AideCuarenta,41,1,4,5,0.376373,0.405065,0.001946,"#697b00"
996456084343836672,GP_comcultdig,13,1,0,1,0.407238,0.419959,0,"#3bec00"
4923331377,Adricollage,31,0,1,1,0.594535,0.479936,0,"#3e93ff"
1199615646042140672,ACI_Chile,49,0,3,3,0.414646,0.54449,0.000973,"#ff7007"
1227642241570820103,tei_publisher,49,3,1,4,0.387736,0.505337,0.001459,"#ff7007"
1302422896644632577,PaolaRicaurte,13,86,0,86,0.477437,0.510674,0.041342,"#3bec00"
1110694569908338688,JuanGomez1495,31,0,7,7,0.565671,0.506453,0.002918,"#3e93ff"
815251678341591040,lucioarreolab,13,0,2,2,0.448622,0.422636,0.000486,"#3bec00"
1244027878326644736,cabrerapommiez,49,0,1,1,0.304038,0.467857,0,"#ff7007"
907360541143965696,godinez4punto0,13,0,7,7,0.472422,0.442207,0.002918,"#3bec00"
785573501717491713,MironvaVirginia,13,0,2,2,0.442191,0.424499,0.000486,"#3bec00"
1025884545621606404,Oscar4_,13,0,2,2,0.443435,0.428863,0.000486,"#3bec00"
1078846183672565761,tania_tangerine,13,0,2,2,0.444548,0.431668,0.000486,"#3bec00"
1043268537261932544,magazine_hh,13,0,2,2,0.443659,0.428642,0.000486,"#3bec00"
1436503266771279873,IngridSolana,13,2,0,2,0.378029,0.394498,0.000486,"#3bec00"
1062691338230075392,Vea64369339,21,0,2,2,0.438453,0.488623,0.000486,"#c6cc85"
987353133654437888,libromecanico,30,1,0,1,0.559523,0.583517,0,"#ff77ff"
1189552378829246465,MaraJosamigo1,14,0,3,3,0.455498,0.545027,0.000973,"#00eeff"
935899604159291392,Alexand30973651,22,0,1,1,0.705937,0.629331,0,"#00e8b2"
782974112754982913,Angelpasoapaso,14,0,1,1,0.421353,0.630281,0,"#00eeff"
1250910763461550080,rubiales46,14,0,4,4,0.457136,0.531479,0.001459,"#00eeff"
1251999457266335750,relace_org,13,1,1,2,0.447496,0.434092,0.000486,"#3bec00"
1255174282818342912,CRenumar,22,0,1,1,0.703137,0.622039,0,"#00e8b2"
1152951115304095744,uv_pedagogia,31,0,5,5,0.578715,0.492505,0.001946,"#3e93ff"
830912090084876288,DaniC_Dantas,49,0,1,1,0.417667,0.524255,0,"#ff7007"
1087999978688131072,BiblioFyLUVa,30,0,2,2,0.52868,0.602066,0.000486,"#ff77ff"
1117153847963734018,patweets2,30,0,2,2,0.551886,0.473813,0.000486,"#ff77ff"
1183208563617026048,ElZapatinn,34,0,1,1,0.533705,0.339027,0,"#ff0d69"
1164906225986936832,HistoriaPC,22,0,1,1,0.715974,0.617381,0,"#00e8b2"
730266085107228672,YurkaPetrov,34,0,1,1,0.550813,0.345908,0,"#ff0d69"
769930125462872064,GladysVasquezz,19,0,1,1,0.631999,0.636459,0,"#00d3ff"
1003670298045108225,latecnotitlan,13,0,1,1,0.377813,0.382535,0,"#3bec00"
1198453350905384960,EnBiciA1,34,0,1,1,0.594371,0.316288,0,"#ff0d69"
760120892831563779,KUafs,41,1,0,1,0.349436,0.448504,0,"#697b00"
963794355806003201,EBarrosoCruz,19,0,4,4,0.559347,0.479172,0.001459,"#00d3ff"
4709931749,fyluniovi,22,5,5,10,0.584809,0.55904,0.004377,"#00e8b2"
1244720102014099460,ArchivoMolina,19,0,1,1,0.643617,0.630926,0,"#00d3ff"
4785810380,Jenny2345678k,30,0,2,2,0.524514,0.602991,0.000486,"#ff77ff"
779918847889506304,guillellabrador,38,0,2,2,0.496051,0.358943,0.000486,"#662859"
1254799059350626311,UNEDFacCiencias,30,0,2,2,0.508269,0.607055,0.000486,"#ff77ff"
750659787654832129,ahpourense,19,0,2,2,0.655473,0.618769,0.000486,"#00d3ff"
861901393237618694,MIGRAVIT1,22,0,1,1,0.697855,0.626361,0,"#00e8b2"
1241038802971512834,DocuLabUniovi,22,0,1,1,0.709164,0.628368,0,"#00e8b2"
785110444008673280,chabe_ruiz_pena,22,0,6,6,0.60487,0.584169,0.002432,"#00e8b2"
704096480726880256,aleeconedoble,22,0,1,1,0.711851,0.614062,0,"#00e8b2"
791200322630848512,AleAscaso,30,0,2,2,0.518286,0.607111,0.000486,"#ff77ff"
1101530762971623425,ku_philosophy,41,1,0,1,0.338674,0.440734,0,"#697b00"
965990070162423811,Lawrencetalks18,41,1,0,1,0.350115,0.448258,0,"#697b00"
1230384496098390017,PNotfor,22,0,1,1,0.701555,0.624858,0,"#00e8b2"
907700657641193472,Elsa_Punky,13,0,1,1,0.426163,0.504792,0,"#3bec00"
860154557741092864,FacDerecho_UNED,30,0,2,2,0.513895,0.602009,0.000486,"#ff77ff"
1232363728642957312,ManuelConceio18,36,0,1,1,0.54546,0.361368,0,"#825403"
1186449957705912320,Mesoltelmechero,38,0,1,1,0.439615,0.33062,0,"#662859"
4787185227,pgarcia611,30,0,2,2,0.521097,0.607554,0.000486,"#ff77ff"
1226562714140643336,AnaVillaescusa4,31,0,1,1,0.64134,0.494389,0,"#3e93ff"
1046649622196772865,KU_orcas,36,0,2,2,0.465688,0.498218,0.000486,"#825403"
824994425692647424,LaTiaPompom,30,0,2,2,0.506113,0.603414,0.000486,"#ff77ff"
1105567148192206851,Maldon86343980,49,0,1,1,0.387587,0.604811,0,"#ff7007"
1017401037978648578,FAILUREPROJECT1,35,0,7,7,0.641409,0.470201,0.002918,"#00faff"
1011529528370499584,GradoUam,35,0,4,4,0.655716,0.463222,0.001459,"#00faff"
1116063720512327680,ciencias_cuba,49,0,1,1,0.400201,0.514723,0,"#ff7007"
733367253299761153,david_a_pata,38,0,2,2,0.813575,0.43398,0.000486,"#662859"
1049965256733335552,reire_idp,31,5,1,6,0.556673,0.519222,0.002432,"#3e93ff"
791013645497016320,eizagaetxeberri,22,0,3,3,0.556756,0.619614,0.000973,"#00e8b2"
889876098447814656,ocpemdp,49,0,1,1,0.419542,0.524545,0,"#ff7007"
1227490838797783040,hum1920,49,0,1,1,0.415281,0.51605,0,"#ff7007"
1241198688632016899,OseznoW,17,1,0,1,0.714558,0.187062,0,"#ff9cc7"
1047644138848497664,ElenaBuylla,17,1,0,1,0.740943,0.193314,0,"#ff9cc7"
831828773226082304,laladyoracle,34,1,0,1,0.43649,0.340809,0,"#ff0d69"
986057766379728896,MarieDimanche1,17,0,2,2,0.665928,0.266356,0.000486,"#ff9cc7"
825113008938614784,NadsonFabio,36,0,1,1,0.54259,0.284544,0,"#825403"
1242427849874735106,anaphrase,37,0,2,2,0.466125,0.522584,0.000486,"#006032"
1239224919596118017,igs2609,37,0,2,2,0.469256,0.519977,0.000486,"#006032"
1068775497100873728,martaxlibertad,58,0,1,1,0.565791,0.173819,0,"#005076"
1128989210864738305,HildaHartmann,31,0,1,1,0.592203,0.465858,0,"#3e93ff"
1140307935886811138,janeth_chavezES,3,0,1,1,0.62699,0.575617,0,"#ffb3ff"
735069735797329920,JssPla,30,1,0,1,0.575876,0.569064,0,"#ff77ff"
752531655936577536,Arcdelahistori,19,1,0,1,0.681251,0.774924,0,"#00d3ff"
1131507013970780161,prensaentrans,19,1,0,1,0.642149,0.770133,0,"#00d3ff"
1187761814769225729,TransyPrensaEsp,19,1,0,1,0.647644,0.779579,0,"#00d3ff"
1143991363781840896,DrNicte,49,1,0,1,0.380451,0.490746,0,"#ff7007"
1147051146080653312,DanielRRivera3,34,0,6,6,0.493983,0.442861,0.002432,"#ff0d69"
700744042695360513,JAulesti,1,0,2,2,0.668681,0.443306,0.000486,"#b6cb00"
798566411157303296,IUMemoria,19,3,5,8,0.61875,0.751002,0.003405,"#00d3ff"
831883550613991424,pirovello,49,0,3,3,0.448428,0.569468,0.000973,"#ff7007"
1472765289196630017,AndreaG1086,34,1,0,1,0.546875,0.310221,0,"#ff0d69"
973165741171146752,HiCRepublicanas,19,1,0,1,0.611463,0.777486,0,"#00d3ff"
1223677511554535424,SociologiaY,1,0,3,3,0.643975,0.469652,0.000973,"#b6cb00"
928100725422526464,carlos_chaccour,1,0,2,2,0.644579,0.451464,0.000486,"#b6cb00"
1243924761463398400,rebecayyo,1,0,2,2,0.658369,0.445126,0.000486,"#b6cb00"
927949794647138305,arcoUNAV,1,0,2,2,0.653945,0.450274,0.000486,"#b6cb00"
908160835381612544,Gonzlz57,1,0,2,2,0.65788,0.456649,0.000486,"#b6cb00"
1029744522237018114,CatalinaDeFoix,1,0,2,2,0.646278,0.444811,0.000486,"#b6cb00"
741193493348024320,IruritaInes,1,0,2,2,0.671453,0.445255,0.000486,"#b6cb00"
1043515020397748227,i_pania,41,0,1,1,0.350219,0.383064,0,"#697b00"
1229333342258106369,dhum1920g2,13,2,0,2,0.436138,0.426921,0.000486,"#3bec00"
910691374244225025,MartinSzy,49,1,2,3,0.445471,0.461651,0.000973,"#ff7007"
1131562763686481921,AleGarVarg,3,0,1,1,0.322053,0.510343,0,"#ffb3ff"
1140583094862385152,euqueropublicar,3,0,1,1,0.316391,0.517886,0,"#ffb3ff"
1153032056651337728,LuisSnc10471321,41,0,3,3,0.384911,0.40364,0.000973,"#697b00"
1224720829000355840,Mariana16107991,41,2,3,5,0.405335,0.437256,0.001946,"#697b00"
1030969720323768321,UAEMexFCPyS,41,1,0,1,0.371442,0.392048,0,"#697b00"
1015198003592908800,libnamic,34,3,0,3,0.41903,0.511743,0.000973,"#ff0d69"
1114132333182029827,IDACOR2,49,1,2,3,0.447714,0.591851,0.000973,"#ff7007"
887818786396672000,foster_ivanoo,41,1,3,4,0.37366,0.414744,0.001459,"#697b00"
709798672284983296,bastiald13,38,0,2,2,0.695095,0.583571,0.000486,"#662859"
1112475692153884673,historiayvideo1,38,22,2,24,0.671729,0.577843,0.011187,"#662859"
4782423354,visotosa13,0,0,2,2,0.440448,0.578162,0.000486,"#8ecfec"
972128453557448704,OpenFutureArg,0,0,2,2,0.43309,0.584305,0.000486,"#8ecfec"
995749004787974145,six20brownie,34,0,1,1,0.377448,0.45373,0,"#ff0d69"
900647688030625793,BBK_Behatokia,49,1,0,1,0.388663,0.613141,0,"#ff7007"
4854351471,conectados2p,34,0,5,5,0.551495,0.451182,0.001946,"#ff0d69"
1226245727640342536,plopezhd,13,0,1,1,0.430331,0.418117,0,"#3bec00"
1047184098236743680,enrillescas,38,0,1,1,0.812784,0.654249,0,"#662859"
800631048744759296,agdelamunoza,38,0,1,1,0.826401,0.634783,0,"#662859"
1002101528466001920,AlbaNavajasG,38,0,1,1,0.811017,0.651621,0,"#662859"
768030638511448064,Gasolina1976,38,0,1,1,0.807963,0.632964,0,"#662859"
844287316181078017,khawz_,38,0,1,1,0.823737,0.646483,0,"#662859"
1133283659329490945,lovesvagrxnt,38,0,1,1,0.822738,0.643729,0,"#662859"
1083719578130227202,laiadiezg,38,0,1,1,0.813065,0.641333,0,"#662859"
954013887023730688,iamlaflores,14,2,0,2,0.604733,0.580407,0.000486,"#00eeff"
732320522860695553,CamaradaPatxi,38,0,2,2,0.694497,0.579585,0.000486,"#662859"
1035488556700127232,arboloria,38,1,2,3,0.715717,0.576246,0.000973,"#662859"
1169183101110706176,Roco30661999,14,0,1,1,0.687345,0.525418,0,"#00eeff"
983301360241307648,SICAU_UMA,14,0,1,1,0.695928,0.523982,0,"#00eeff"
1176432886230278145,phylosgou,14,0,2,2,0.643746,0.532794,0.000486,"#00eeff"
4422275902,BardoCientifico,31,0,2,2,0.59112,0.505996,0.000486,"#3e93ff"
971340693569441793,RCEstrategicas,14,7,2,9,0.658855,0.534438,0.003891,"#00eeff"
1224041249323307009,facundoroj,38,3,0,3,0.456891,0.361308,0.000973,"#662859"
920275494972600320,celiamarquez_,31,0,2,2,0.620463,0.587967,0.000486,"#3e93ff"
1186378413415763975,JuanGVerano,31,2,1,3,0.599634,0.574317,0.000973,"#3e93ff"
1227702569990049793,l_p_digitales,49,2,0,2,0.408151,0.558293,0.000486,"#ff7007"
768129621820932097,uleatlas,31,0,2,2,0.593757,0.499795,0.000486,"#3e93ff"
1202417500673191941,DiegoEstevamC,34,0,1,1,0.41152,0.352179,0,"#ff0d69"
712180408625078272,kitodo_org,34,1,0,1,0.35482,0.380032,0,"#ff0d69"
1017878369973743616,TsiolisVassilis,15,2,2,4,0.564816,0.607872,0.001459,"#008ebb"
1102636829554196480,FacultadTeIUVa,22,6,3,9,0.681143,0.496608,0.003891,"#00e8b2"
1234921626422140929,StortiVivi,36,0,1,1,0.521553,0.257855,0,"#825403"
4819240061,MiPropiaMusa,31,0,2,2,0.620695,0.4702,0.000486,"#3e93ff"
1153228268532830211,CREARIcongreso,31,56,9,65,0.545925,0.50014,0.031128,"#3e93ff"
1109518128864788480,rnavsany,30,0,1,1,0.723993,0.61005,0,"#ff77ff"
1188157686254309378,selat_org,30,6,0,6,0.663817,0.578206,0.002432,"#ff77ff"
950793816495349762,compos24horas,49,1,0,1,0.35182,0.658428,0,"#ff7007"
726686819807576064,PubliAcademicas,8,0,1,1,0.750482,0.378813,0,"#00ed5d"
788387505271898112,iristriv,31,0,2,2,0.613486,0.465803,0.000486,"#3e93ff"
892365564085235714,conozcositios,38,0,1,1,0.569279,0.701612,0,"#662859"
1237141641133162496,UnColombia,38,25,6,31,0.522621,0.458412,0.014591,"#662859"
1296878243094683654,vivelabbogota,38,3,0,3,0.56227,0.430525,0.000973,"#662859"
1075830675931049984,irenejvaldivia,30,0,3,3,0.481609,0.570439,0.000973,"#ff77ff"
1162422496987156482,Urbana_Madrid,31,0,2,2,0.620101,0.466645,0.000486,"#3e93ff"
1148557615464689664,NETSU_Cons,31,0,2,2,0.616009,0.47094,0.000486,"#3e93ff"
1481213247713861632,AndaluciaDig,30,6,0,6,0.450944,0.589464,0.002432,"#ff77ff"
889920833594032129,feminisciencia,19,1,0,1,0.644589,0.798003,0,"#00d3ff"
906084186557214721,CampusdeSoria,22,1,1,2,0.723929,0.489941,0.000486,"#00e8b2"
926858999315787777,Edgoan1,30,0,1,1,0.60914,0.436283,0,"#ff77ff"
909420958087294978,MRMCnl,30,0,1,1,0.602993,0.442518,0,"#ff77ff"
986285578030379008,Manu_K_tala,30,0,1,1,0.617019,0.442634,0,"#ff77ff"
875955133871534080,SaxCrooner,30,0,1,1,0.606617,0.443231,0,"#ff77ff"
750805774285307904,DespertaFerro11,30,0,1,1,0.607391,0.439871,0,"#ff77ff"
899728690917105665,johierfer,30,0,1,1,0.5921,0.438493,0,"#ff77ff"
1075900327562543105,bondiacarla,30,0,1,1,0.614213,0.442154,0,"#ff77ff"
914107198795546626,Ref1Oct17,30,0,1,1,0.592933,0.43413,0,"#ff77ff"
924758453138141184,JaimeZubero,30,0,1,1,0.604545,0.432685,0,"#ff77ff"
1219882765543510016,Canig6,30,0,1,1,0.598763,0.43646,0,"#ff77ff"
1059086562389082112,RosaEscardo,30,0,1,1,0.597103,0.441221,0,"#ff77ff"
4803237142,subealsur,30,0,3,3,0.47074,0.549116,0.000973,"#ff77ff"
1064835018298744832,fpabloiglesias,19,2,0,2,0.61576,0.757499,0.000486,"#00d3ff"
838066554218610689,Historiatwiter,19,1,0,1,0.640291,0.773343,0,"#00d3ff"
1166869737856524288,Avila_Unica,31,0,4,4,0.583733,0.497745,0.001459,"#3e93ff"
984716531006431234,Inaki_nav,31,0,4,4,0.585052,0.498028,0.001459,"#3e93ff"
1225073646185721856,UPM_Press,31,0,2,2,0.532076,0.637959,0.000486,"#3e93ff"
1215334093203935235,UccMexican,30,0,1,1,0.608795,0.435721,0,"#ff77ff"
1056877998207627264,telamiel,49,1,0,1,0.379873,0.5183,0,"#ff7007"
1155084044004143104,DHSIatlantic,30,10,1,11,0.553444,0.440259,0.004864,"#ff77ff"
929521143681253376,robertoreyagudo,13,0,1,1,0.369745,0.460415,0,"#3bec00"
828315346557816832,ivansanmartinc,37,0,1,1,0.377308,0.325709,0,"#006032"
973426250650824704,mckzenteno,37,0,1,1,0.375535,0.325571,0,"#006032"
824213229698224129,archivoarovite,19,1,0,1,0.65853,0.777653,0,"#00d3ff"
749238807971651584,MemorialVT,19,1,0,1,0.68457,0.782668,0,"#00d3ff"
1079498425727676421,Dilogritando,34,0,1,1,0.638707,0.324071,0,"#ff0d69"
847406638822707200,Camacho_Atos,14,0,1,1,0.56769,0.638801,0,"#00eeff"
1013769733601157121,FulgencioJS,31,0,1,1,0.568395,0.620488,0,"#3e93ff"
768935220695470080,videorganica1,38,1,1,2,0.270123,0.381859,0.000486,"#662859"
959400852057411585,Neofitasdelcafe,22,0,2,2,0.641881,0.601049,0.000486,"#00e8b2"
731517694353281024,crewsproject,22,0,3,3,0.52826,0.594149,0.000973,"#00e8b2"
1054032045075247104,KatiusciaDarici,14,3,1,4,0.530685,0.52449,0.001459,"#00eeff"
703641894253928451,SalesMenAndre,49,1,0,1,0.362209,0.673227,0,"#ff7007"
1119717266554281985,BrentanJunior,36,0,1,1,0.518849,0.263345,0,"#825403"
1181433481945128961,Antoniohfaria,36,0,1,1,0.506613,0.26126,0,"#825403"
847591188332990466,JEP_Colombia,38,4,0,4,0.549763,0.423045,0.001459,"#662859"
990271545355403264,karlcch1919,38,0,2,2,0.558513,0.392933,0.000486,"#662859"
4894088709,MariaEmmaWills1,38,1,0,1,0.544569,0.361285,0,"#662859"
1114001391540822017,RepDeFiFidonia,13,4,0,4,0.439082,0.280885,0.001459,"#3bec00"
1065381758286336000,memoriademexico,13,11,3,14,0.468773,0.401598,0.006323,"#3bec00"
748834841043542016,concepmartin,49,1,0,1,0.316339,0.620736,0,"#ff7007"
874129671935463425,larevistacr,49,1,0,1,0.369719,0.657427,0,"#ff7007"
4794220096,PuertalsolMad,58,1,2,3,0.601737,0.251715,0.000973,"#005076"
861560936162832384,notisdemadrid,58,2,0,2,0.6003,0.196467,0.000486,"#005076"
829788121004900352,amzapat2,41,1,0,1,0.384448,0.399597,0,"#697b00"
1228504805905137664,victori12025360,14,0,1,1,0.644129,0.589788,0,"#00eeff"
1219970713383206912,SusanaR57214308,31,0,1,1,0.603392,0.470851,0,"#3e93ff"
805366899806760960,Milena_D89,13,0,1,1,0.426665,0.40537,0,"#3bec00"
908755706077212673,JuSilvaOfficial,36,0,1,1,0.546812,0.288049,0,"#825403"
1032592911442038784,DeBeijingaTokio,37,0,2,2,0.56132,0.499516,0.000486,"#006032"
1077634225493475330,Tediato1,49,0,1,1,0.382624,0.605354,0,"#ff7007"
4417466061,zanaines,49,0,1,1,0.38671,0.517074,0,"#ff7007"
4703167472,k_bravo1,21,0,2,2,0.378631,0.498975,0.000486,"#c6cc85"
946022581374775296,UrcaInstitute,36,3,5,8,0.548381,0.382449,0.003405,"#825403"
749911783398408192,igrezan,38,2,5,7,0.614232,0.449785,0.002918,"#662859"
788781514830049280,MasterAntigua,37,4,3,7,0.587527,0.533223,0.002918,"#006032"
794257878244851712,IndustrialAndes,38,1,0,1,0.675846,0.487211,0,"#662859"
1201922159041536000,AdjuntaEgrem,44,0,1,1,0.86083,0.60665,0,"#6c241e"
1166002260377317377,ArtexCarlitos,44,0,1,1,0.859558,0.601901,0,"#6c241e"
1169322629007888387,VigoaDe,44,0,1,1,0.864282,0.604115,0,"#6c241e"
1218559612204482560,feria_habana,44,1,0,1,0.865798,0.59642,0,"#6c241e"
815691308358631426,anathesoares,36,0,3,3,0.509373,0.356425,0.000973,"#825403"
1092356840845967360,saharasoundsca2,31,2,7,9,0.581869,0.526516,0.003891,"#3e93ff"
1197305882146746368,GestaVentures,49,1,0,1,0.323087,0.674403,0,"#ff7007"
4296417136,ETSIIT_UGR,31,9,4,13,0.590543,0.528682,0.005837,"#3e93ff"
831973105904078849,aranohtar,2,8,3,11,0.518869,0.53793,0.004864,"#ffa64e"
913462171979468801,Mamirology,22,1,1,2,0.510096,0.647909,0.000486,"#00e8b2"
955529490154733568,Dvaronac1984,14,0,7,7,0.508699,0.486255,0.002918,"#00eeff"
807691348505743360,HelwiB,14,0,1,1,0.646413,0.590767,0,"#00eeff"
1140778724767358976,PixarSoul,3,1,0,1,0.308903,0.568112,0,"#ffb3ff"
1137828229971087361,dani_schutte,21,2,1,3,0.39198,0.478018,0.000973,"#c6cc85"
944238703106494464,jrhentschke,38,1,4,5,0.477059,0.35657,0.001946,"#662859"
901882312622825473,ErikaNa13945882,0,0,5,5,0.45919,0.515588,0.001946,"#8ecfec"
868493031380484097,elourenco13,36,0,2,2,0.538415,0.295785,0.000486,"#825403"
870417945591205889,YolandaMahecha4,28,0,1,1,0.891247,0.389999,0,"#cd5700"
1173782604782477312,CongresoPrctic1,9,1,0,1,0.741661,0.718713,0,"#008f7b"
1456693818007433216,SilvaMoyano,9,1,0,1,0.740536,0.721278,0,"#008f7b"
1160977945474871296,UCaldasFAH,9,5,4,9,0.698953,0.620957,0.003891,"#008f7b"
1220367036787937280,cientistasoc,36,2,0,2,0.560894,0.405848,0.000486,"#825403"
1218479742917148672,paolaperat,22,0,1,1,0.49659,0.67271,0,"#00e8b2"
1223731393345282049,PaoloScala9,49,1,0,1,0.355436,0.637767,0,"#ff7007"
823935710856093698,YosoyGordillo,28,0,1,1,0.88599,0.394775,0,"#cd5700"
984181974549127168,SlisStaFeCand,28,0,1,1,0.893854,0.39239,0,"#cd5700"
1115305543399350272,SlisRafaelUU,28,0,1,1,0.884723,0.399882,0,"#cd5700"
4427029599,NiampiraAlex,28,0,1,1,0.880347,0.392213,0,"#cd5700"
1170891304223612930,Revista_Limite,49,1,0,1,0.344885,0.673179,0,"#ff7007"
986226055227863041,SLISUsmeSumapaz,28,0,1,1,0.88376,0.387765,0,"#cd5700"
1105939531600224257,ERC_LiLa,22,1,1,2,0.498602,0.647135,0.000486,"#00e8b2"
731702285529546754,123xjulio,13,0,1,1,0.39669,0.43122,0,"#3bec00"
926471850334486528,MaraMoraV,41,0,1,1,0.359206,0.39287,0,"#697b00"
1210665450784350215,epic_of_uruk,22,0,1,1,0.4042,0.616195,0,"#00e8b2"
1136165088791056385,BNEscolar,30,1,0,1,0.582903,0.565559,0,"#ff77ff"
786855538894200834,FormacionUCM,30,1,0,1,0.587891,0.563429,0,"#ff77ff"
1179532332476305408,AnnaBentes,36,0,1,1,0.468086,0.216938,0,"#825403"
1039584430606569472,CUPIUAQ,13,1,0,1,0.374319,0.488035,0,"#3bec00"
866610838756622340,OCMDigiDoc,31,1,4,5,0.595973,0.531279,0.001946,"#3e93ff"
855788550922670080,AelcoSpain,15,0,1,1,0.485002,0.726813,0,"#008ebb"
1219639925898981377,iued_unihd,49,0,1,1,0.375087,0.466034,0,"#ff7007"
745818638981173249,labogad,36,1,0,1,0.573742,0.309829,0,"#825403"
4734111393,Tibannez,22,0,1,1,0.547151,0.681254,0,"#00e8b2"
879294604285227008,BeMoralzarzal,0,0,1,1,0.223131,0.633386,0,"#8ecfec"
924714834616311810,PropylaeumAnt,58,5,12,17,0.515364,0.551592,0.007782,"#005076"
1003315708581892097,Santolaria_A,31,0,3,3,0.55532,0.597847,0.000973,"#3e93ff"
1102490656763756545,infoSELing,15,0,1,1,0.494917,0.733161,0,"#008ebb"
961955936666619904,trincheracult,31,0,2,2,0.578461,0.600082,0.000486,"#3e93ff"
4903901621,GrupElcis,15,0,1,1,0.481247,0.723891,0,"#008ebb"
4867109321,hmuex,13,0,1,1,0.449071,0.397502,0,"#3bec00"
1119257918057086976,SEOdeCanarias,31,0,2,2,0.642823,0.554464,0.000486,"#3e93ff"
1219963561377697793,UCC_DH,30,0,3,3,0.543176,0.440506,0.000973,"#ff77ff"
1189668096619012096,Eva24270131,30,0,3,3,0.556074,0.439813,0.000973,"#ff77ff"
914948731170115584,HagopianAlice,30,0,3,3,0.549323,0.441858,0.000973,"#ff77ff"
987343338184630272,BJokers_Esports,49,1,0,1,0.311946,0.64106,0,"#ff7007"
957851988175159298,rottamotta,0,0,5,5,0.455195,0.508134,0.001946,"#8ecfec"
1227933884375011328,LatamHD,38,2,0,2,0.529419,0.416331,0.000486,"#662859"
1102846276520026115,Aunclicdelastic,0,4,0,4,0.291082,0.585578,0.001459,"#8ecfec"
811609620661800960,EugenioVMerinoD,49,0,1,1,0.321416,0.537524,0,"#ff7007"
4440011897,UGRemprendedora,31,0,3,3,0.625501,0.549832,0.000973,"#3e93ff"
1213680893262385154,LaMenteBolivia1,13,0,1,1,0.479272,0.343788,0,"#3bec00"
918965304893599745,debasmachado,36,11,1,12,0.516808,0.280905,0.00535,"#825403"
1025105061926629381,DFescol,38,0,3,3,0.563572,0.47167,0.000973,"#662859"
1148609824088895490,fescomunica,38,0,3,3,0.563229,0.4694,0.000973,"#662859"
1182478072009900033,Rosas13_rosas,49,1,0,1,0.394854,0.667464,0,"#ff7007"
1100832645662076928,ngelPrezCastel2,22,0,2,2,0.226428,0.57484,0.000486,"#00e8b2"
1070640462174806017,mrtollens,36,0,1,1,0.521368,0.200041,0,"#825403"
1033657173463711745,TripsSpanish,22,0,2,2,0.220464,0.572357,0.000486,"#00e8b2"
1033661121872449538,ECoursesSpanish,22,0,2,2,0.223835,0.567304,0.000486,"#00e8b2"
882916639603396609,bodyplanetAR,49,0,1,1,0.323457,0.295614,0,"#ff7007"
826855556979761152,Ps_Digitales,49,12,0,12,0.324621,0.369861,0.00535,"#ff7007"
902748309718257664,adelangelesc,13,0,1,1,0.473969,0.344504,0,"#3bec00"
1069244811776065536,juanmfdez18,0,0,1,1,0.276238,0.571675,0,"#8ecfec"
799276653738397696,mjnegueruela1,8,0,1,1,0.725943,0.183874,0,"#00ed5d"
1049279099867463683,TSpace2019,36,0,3,3,0.523984,0.395205,0.000973,"#825403"
4927303929,heloamparo,36,0,1,1,0.471954,0.20676,0,"#825403"
858331235407495168,DelirioKt,36,0,1,1,0.48773,0.206736,0,"#825403"
1067463028034215936,DigitalHumMIT,36,1,0,1,0.543025,0.311135,0,"#825403"
832648418950393857,ire_ub,22,6,7,13,0.449837,0.521868,0.005837,"#00e8b2"
1118801176307347456,VIAEmpresa_es,8,0,1,1,0.690197,0.345423,0,"#00ed5d"
990031363129606145,RaquelJorgeR,49,2,2,4,0.463112,0.562985,0.001459,"#ff7007"
945616199521591296,KoreFormacion,49,2,0,2,0.424428,0.611353,0.000486,"#ff7007"
865411120353300480,elprofe_santana,36,0,1,1,0.359908,0.446472,0,"#825403"
735866981614813184,merce_mag,1,0,2,2,0.413931,0.601387,0.000486,"#b6cb00"
735896673193447424,HistoriaUam,31,0,1,1,0.658154,0.570166,0,"#3e93ff"
823561612737003522,JT_kaizoku,14,0,1,1,0.598782,0.589571,0,"#00eeff"
995034693568532480,ficcines,58,0,2,2,0.557962,0.628428,0.000486,"#005076"
1109876157334413320,ins_dept,14,0,1,1,0.600939,0.594668,0,"#00eeff"
958461195945697280,MaEsL_UA,14,2,2,4,0.52839,0.601983,0.001459,"#00eeff"
829091882189856768,AlfonsoBoix,14,0,1,1,0.601491,0.587503,0,"#00eeff"
888417430825046016,TherkasTeatre,14,0,1,1,0.597661,0.588847,0,"#00eeff"
773223472478597120,AgendaUNAM,13,1,0,1,0.491264,0.339421,0,"#3bec00"
871964938465550336,AlmaMacurs,13,0,2,2,0.444379,0.411126,0.000486,"#3bec00"
1143980291905720322,MiamiMundo,49,1,0,1,0.362821,0.678717,0,"#ff7007"
717134280640606208,dracmmp,30,0,3,3,0.552142,0.50644,0.000973,"#ff77ff"
4483186763,FacMagisteri,31,1,0,1,0.627406,0.511807,0,"#3e93ff"
1212820535811301376,PepaMachado,31,0,1,1,0.5979,0.475838,0,"#3e93ff"
1184434297350119425,VCiberseg,0,0,1,1,0.374162,0.553181,0,"#8ecfec"
1057066588736774144,25Horasde,49,1,0,1,0.419614,0.643379,0,"#ff7007"
764234024466452480,Carnaina,22,1,0,1,0.521141,0.670379,0,"#00e8b2"
951256594896973824,sinsurrapa,49,1,0,1,0.38394,0.665754,0,"#ff7007"
1357246786797068292,Mithik2,49,1,0,1,0.35536,0.608138,0,"#ff7007"
1024618446670258176,LuisEspinGomez,0,0,1,1,0.36964,0.545971,0,"#8ecfec"
729345030230552577,DaniFVMotor,0,0,1,1,0.369876,0.553884,0,"#8ecfec"
1004735029258448897,taparak_u,22,0,1,1,0.754352,0.692955,0,"#00e8b2"
4625706267,desingedic,30,16,19,35,0.472596,0.534569,0.016537,"#ff77ff"
870321203864641537,DiscursosEyP,49,0,1,1,0.395651,0.51276,0,"#ff7007"
1211528306664673280,zanbatha,13,0,1,1,0.37706,0.436892,0,"#3bec00"
1011333893763432448,metodologialite,30,0,3,3,0.543933,0.543781,0.000973,"#ff77ff"
1115879423138521089,hdh2019,15,32,13,45,0.538652,0.593703,0.021401,"#008ebb"
738453283577139200,hsoveros,34,0,3,3,0.45543,0.467679,0.000973,"#ff0d69"
4485900214,JuanaGranado3,0,0,1,1,0.257414,0.578505,0,"#8ecfec"
1184136619814731777,EditoraEx,0,1,2,3,0.328238,0.56163,0.000973,"#8ecfec"
725973556018987008,JuntaEx_Cultura,0,1,0,1,0.256319,0.575624,0,"#8ecfec"
1081219293046599682,JTallei,49,1,0,1,0.40927,0.685296,0,"#ff7007"
1182019793592950784,molina_elorza,30,0,1,1,0.601766,0.669145,0,"#ff77ff"
1137059446071468039,MaluMar71683932,25,0,4,4,0.580351,0.100106,0.001459,"#f4a2ff"
922547528796725248,ramoncortiu,15,0,2,2,0.64211,0.425761,0.000486,"#008ebb"
864786801591975936,revdesbandada,14,0,2,2,0.610446,0.569309,0.000486,"#00eeff"
1146818113549275143,egevtec,10,2,2,4,0.36561,0.523522,0.001459,"#52d7c0"
860858045751939072,EducadorBlanco,10,0,3,3,0.563266,0.653928,0.000973,"#52d7c0"
1126421043374186496,emlexmundus,55,2,3,5,0.594904,0.440327,0.001946,"#cb3f32"
996341413762732032,acadcienciaslx,55,3,4,7,0.597873,0.413744,0.002918,"#cb3f32"
1386460246730756100,_daq_,0,5,0,5,0.41157,0.55899,0.001946,"#8ecfec"
914081253279899648,reiet77,22,0,1,1,0.236861,0.686067,0,"#00e8b2"
957871931155468288,entelequiacult,14,0,2,2,0.610209,0.572987,0.000486,"#00eeff"
910138422827929600,MoixRamon,31,0,1,1,0.642938,0.50381,0,"#3e93ff"
730484762205425664,daniInnerarity,31,1,1,2,0.618039,0.505322,0.000486,"#3e93ff"
1017415040993918983,PaulinaFrean,0,0,1,1,0.387792,0.55738,0,"#8ecfec"
728468990641639424,tornilloarqui,22,0,2,2,0.428834,0.497233,0.000486,"#00e8b2"
962343359204483072,valerylefay,37,1,0,1,0.672554,0.299163,0,"#006032"
1180956372839669764,Vidersen1,34,0,3,3,0.499889,0.431875,0.000973,"#ff0d69"
1166018955254882305,AlbertNogueraF,36,1,0,1,0.659865,0.358688,0,"#825403"
4898447549,iggnattius,0,0,1,1,0.390548,0.573174,0,"#8ecfec"
1107502706262839296,DavidFdezSchez,0,0,1,1,0.368989,0.563647,0,"#8ecfec"
1136300754728366081,BgaJose,30,1,0,1,0.59207,0.564528,0,"#ff77ff"
1229443529866387456,dhpaulspence,30,31,0,31,0.523952,0.482194,0.014591,"#ff77ff"
913739227644485632,CRAI_CEDI,22,0,2,2,0.573185,0.613507,0.000486,"#00e8b2"
1112793208663105537,MomoAprilsFool,30,0,1,1,0.591188,0.674113,0,"#ff77ff"
1187736734982922241,Teatrosigloxx,30,0,1,1,0.635336,0.663596,0,"#ff77ff"
1041375857410039808,blureddoor,0,0,3,3,0.415705,0.548173,0.000973,"#8ecfec"
1182388163744014342,SoySonia91,13,0,1,1,0.428989,0.417629,0,"#3bec00"
775386484710969344,LisabelCabrera,3,0,1,1,0.68602,0.696812,0,"#ffb3ff"
1165548234888142849,FerAriasGuillen,30,0,1,1,0.463324,0.598461,0,"#ff77ff"
873656021977268225,SomDataEs,49,1,0,1,0.33718,0.684037,0,"#ff7007"
1023487660000768000,AsetelTeoria,58,14,1,15,0.538297,0.635805,0.006809,"#005076"
959505932018438145,Congreso_JAM,22,0,1,1,0.284833,0.720831,0,"#00e8b2"
1113792875228278784,JulsSav,22,0,2,2,0.548515,0.718,0.000486,"#00e8b2"
969707723632750594,aviles_mgl,0,0,3,3,0.433069,0.552418,0.000973,"#8ecfec"
1125453346947653634,LDranca,22,0,2,2,0.552311,0.710713,0.000486,"#00e8b2"
1051933081425326080,emprendiMTO,10,1,0,1,0.323306,0.489685,0,"#52d7c0"
1089647202690060288,MasterBigData1,22,0,2,2,0.549036,0.715416,0.000486,"#00e8b2"
777821538556973056,JMDLatina,58,0,1,1,0.604752,0.265407,0,"#005076"
772589247488417792,ProtobotsMx,0,0,1,1,0.375193,0.566699,0,"#8ecfec"
1042493594362368001,de_propios,0,0,1,1,0.385312,0.568757,0,"#8ecfec"
700670591011926017,visgraflab,36,1,5,6,0.513926,0.365821,0.002432,"#825403"
831123936591171585,androsDoxai,49,0,3,3,0.420698,0.502204,0.000973,"#ff7007"
913467902300483585,MrVivariense90,30,0,1,1,0.585647,0.660272,0,"#ff77ff"
1051407278694428673,DelphMontoliu,49,0,3,3,0.417446,0.503223,0.000973,"#ff7007"
874613714682609664,Asocolhistoria1,38,3,0,3,0.50436,0.386864,0.000973,"#662859"
940277853375090688,lanoficcion,38,1,2,3,0.539946,0.415432,0.000973,"#662859"
1182003478786277376,Orchid212X1,58,0,1,1,0.474299,0.656481,0,"#005076"
815917666108051458,mecarrillo2017,58,0,4,4,0.519163,0.55755,0.001459,"#005076"
943140308514234368,hartlemh,13,0,1,1,0.396495,0.486183,0,"#3bec00"
988806663783239680,fortext_catma,13,5,2,7,0.456453,0.479747,0.002918,"#3bec00"
832723349553811457,MariaPaula_Ed,34,0,1,1,0.590231,0.280368,0,"#ff0d69"
1061470083329994752,ApologiaDlLapiz,13,1,0,1,0.388068,0.38108,0,"#3bec00"
769293081434873857,DILAC_GT,34,0,4,4,0.468816,0.443031,0.001459,"#ff0d69"
1077737359666544644,ArgaizZurita,7,0,1,1,0.390071,0.726543,0,"#ffb800"
1159735436694228992,UNISERSA_,14,0,2,2,0.652197,0.506034,0.000486,"#00eeff"
1138595275818356736,gerescobar_,3,0,1,1,0.728576,0.626777,0,"#ffb3ff"
1076172179178487809,drahmadbazzi,15,0,1,1,0.577674,0.614496,0,"#008ebb"
1120390661398827009,taimisosa1,43,0,1,1,0.707502,0.547375,0,"#fcae7e"
1098996903432409093,CideHistoria,34,3,1,4,0.542466,0.265504,0.001459,"#ff0d69"
906025199186804736,JJLPGL,34,0,1,1,0.534953,0.188848,0,"#ff0d69"
981332760181837824,LopezAketzaly,41,1,1,2,0.355218,0.396159,0.000486,"#697b00"
1159658953497698305,arc_lopezt,41,2,5,7,0.38145,0.417113,0.002918,"#697b00"
872853677987344384,ALEJDRO_ROA,41,0,1,1,0.344819,0.446546,0,"#697b00"
1097663442536857605,alexamontielm,41,0,1,1,0.347187,0.391026,0,"#697b00"
910289559455457280,chavador360,41,1,1,2,0.326897,0.386996,0.000486,"#697b00"
912365571588726785,UV_DGRI,52,4,2,6,0.923945,0.753904,0.002432,"#b56eed"
925142712730472448,PilarViviente,22,3,1,4,0.697669,0.26991,0.001459,"#00e8b2"
1033611482716459008,JTejashwi,22,0,1,1,0.729251,0.201748,0,"#00e8b2"
856447539066933248,educaugr,31,1,0,1,0.676989,0.61346,0,"#3e93ff"
995450717992255489,aydemitilde,14,0,2,2,0.580967,0.553342,0.000486,"#00eeff"
1055405592091729920,FilosofiaUCM,0,1,0,1,0.840724,0.440702,0,"#8ecfec"
792040878193905666,diegoraa10,14,0,2,2,0.621126,0.677281,0.000486,"#00eeff"
791946015695790082,ConcepcioRosRos,31,0,1,1,0.636675,0.514182,0,"#3e93ff"
1072821085048053761,ANnovationspace,30,0,1,1,0.476591,0.627664,0,"#ff77ff"
830645004452237312,WGH_UCDavis,34,0,2,2,0.346054,0.409084,0.000486,"#ff0d69"
835895680828866561,facultadcero,31,1,1,2,0.618309,0.522835,0.000486,"#3e93ff"
822684498739331072,TeachHistConf,34,0,2,2,0.356671,0.410073,0.000486,"#ff0d69"
1123197929186037760,IEXCUL1,37,6,3,9,0.617316,0.485599,0.003891,"#006032"
4897818739,AASLH_EHP,34,0,2,2,0.337045,0.422031,0.000486,"#ff0d69"
933009376239063040,mavi_mestre,31,10,0,10,0.540982,0.493667,0.004377,"#3e93ff"
732425458826936322,redsalmonarts,34,0,2,2,0.341352,0.419362,0.000486,"#ff0d69"
1121099387680247810,GalavitzRowena,34,0,3,3,0.430989,0.404191,0.000973,"#ff0d69"
926508187821527042,SJHalka,30,0,1,1,0.688561,0.620951,0,"#ff77ff"
742981648761925633,DerechoTEC,22,0,1,1,0.715641,0.361518,0,"#00e8b2"
988781221005201410,EgresadxsFIC,55,0,1,1,0.7192,0.659644,0,"#cb3f32"
742765245920366596,HistoriaMachado,30,0,1,1,0.698128,0.614206,0,"#ff77ff"
1135551819906736128,loppbarr,55,0,1,1,0.711182,0.652754,0,"#cb3f32"
1159095657258504192,dhCenter_,53,4,0,4,0.457642,0.524473,0.001459,"#008bdd"
708007315287445504,ICTKasia,31,0,4,4,0.514362,0.558754,0.001459,"#3e93ff"
970783788556013570,LetrasUM,22,7,0,7,0.54839,0.67016,0.002918,"#00e8b2"
774869507131203584,susannapujolcli,15,0,1,1,0.532264,0.676459,0,"#008ebb"
940672922678693888,LopezToranJM,15,4,11,15,0.567277,0.60378,0.006809,"#008ebb"
4493714483,martinrpenaloza,15,0,1,1,0.551053,0.745641,0,"#008ebb"
1347544818088628225,EduardoMonfort,49,3,0,3,0.423992,0.606985,0.000973,"#ff7007"
739425932088381440,Carlos_Gut10,49,0,1,1,0.304935,0.298513,0,"#ff7007"
707773752344494081,_aide_29,15,0,1,1,0.563176,0.743358,0,"#008ebb"
843911463165202432,MaiteTocino,49,0,1,1,0.309457,0.301278,0,"#ff7007"
1138799571147153408,SPecesVoladores,49,0,1,1,0.301389,0.304222,0,"#ff7007"
1166847492153061376,Dianacvirguez,15,0,1,1,0.555026,0.750267,0,"#008ebb"
1188514119445553152,DelvisOReilly,30,0,1,1,0.604759,0.384983,0,"#ff77ff"
834205130392231936,Isabel29784233,34,0,1,1,0.389157,0.458332,0,"#ff0d69"
4610877448,mabel_graneros,15,0,1,1,0.571457,0.749418,0,"#008ebb"
1108099307704590340,pepanarvaez,15,0,1,1,0.572024,0.74558,0,"#008ebb"
1139940410254594048,Flaneando1,34,0,1,1,0.386749,0.460756,0,"#ff0d69"
758029170383421440,episodiosn,34,1,0,1,0.381163,0.453125,0,"#ff0d69"
4472246573,AnaRiquilla,15,0,2,2,0.600106,0.617087,0.000486,"#008ebb"
1008379470129090562,MangasNatalia,58,0,4,4,0.539024,0.575772,0.001459,"#005076"
921320001847611392,ulefhyc,15,0,1,1,0.563371,0.676653,0,"#008ebb"
1090150149983223808,digitalUMU,22,2,1,3,0.588117,0.686698,0.000973,"#00e8b2"
845372126114787328,pedromruiz1,22,0,2,2,0.530217,0.672534,0.000486,"#00e8b2"
801772516444372993,Ocnos_revista,22,0,4,4,0.579937,0.557377,0.001459,"#00e8b2"
902971478714589184,golestvcom,49,1,0,1,0.365163,0.603337,0,"#ff7007"
1176544374257307650,MOWLAC_unesco,38,1,0,1,0.536022,0.370018,0,"#662859"
1353835024672579584,CLMpressDigital,49,2,0,2,0.406331,0.586425,0.000486,"#ff7007"
1010596706977796097,shotsdeciencia,38,1,0,1,0.43983,0.327176,0,"#662859"
778551161481732097,sgpsccl,15,0,2,2,0.571222,0.543408,0.000486,"#008ebb"
1004288981503238144,cemartorell,15,0,2,2,0.566354,0.542345,0.000486,"#008ebb"
901432333844316161,Nuria47955578,15,0,2,2,0.60011,0.697325,0.000486,"#008ebb"
777440648966336512,GRENPoC,22,0,2,2,0.640538,0.562028,0.000486,"#00e8b2"
1146349020564135938,humanitats,22,0,2,2,0.641802,0.557877,0.000486,"#00e8b2"
737994585142665216,PatrimonioDocUN,38,1,0,1,0.542966,0.35946,0,"#662859"
838879264246226944,CECLM_UCLM,15,6,5,11,0.573227,0.606645,0.004864,"#008ebb"
988244072015056897,Avril_8084,15,0,1,1,0.618197,0.635691,0,"#008ebb"
1114143884081283072,Alberdi_Ausente,49,0,1,1,0.74512,0.786807,0,"#ff7007"
803945753077022720,Doxarquia,49,0,1,1,0.743867,0.789272,0,"#ff7007"
975773502245662723,ConectarseOk,49,0,1,1,0.741642,0.791506,0,"#ff7007"
793243455124156416,ciena_nz,22,0,1,1,0.582879,0.616887,0,"#00e8b2"
4927174383,EducacionUsal,58,0,6,6,0.502083,0.589682,0.002432,"#005076"
731981587068391425,alcala_aalcala,15,0,2,2,0.598058,0.685819,0.000486,"#008ebb"
703592212593025030,teo_castano,15,0,2,2,0.599165,0.698376,0.000486,"#008ebb"
4321161454,jacastellanosl,15,0,5,5,0.53469,0.5776,0.001946,"#008ebb"
964866675396038657,DavidMolero2018,15,0,2,2,0.586113,0.697165,0.000486,"#008ebb"
854413279841705986,Francis63842654,15,0,2,2,0.609149,0.695361,0.000486,"#008ebb"
1179494890490736642,difusion_la,15,0,2,2,0.584207,0.696903,0.000486,"#008ebb"
4517893702,uclm_inter,15,1,9,10,0.561475,0.578463,0.004377,"#008ebb"
885890951834726401,Jesuspachecoprz,22,0,1,1,0.458957,0.670886,0,"#00e8b2"
921440890165571585,mamen61m,15,0,2,2,0.596119,0.695923,0.000486,"#008ebb"
746592867372703744,mariajoselop1,15,0,1,1,0.624734,0.634017,0,"#008ebb"
1119698516102787079,IUnisabaneta,9,2,2,4,0.663526,0.923926,0.001459,"#008f7b"
772203134269652992,RLadiesMAD,30,0,1,1,0.519647,0.629443,0,"#ff77ff"
4535475034,lola_larasa,22,0,1,1,0.584089,0.721212,0,"#00e8b2"
1142714334352760832,SevillaPAC,1,0,1,1,0.667083,0.60304,0,"#b6cb00"
751427214630064128,numeteris,49,4,0,4,0.48828,0.480451,0.001459,"#ff7007"
917346226399596544,know_gap,49,1,0,1,0.373002,0.525976,0,"#ff7007"
1040362947246284804,mejia_salguero,9,0,3,3,0.721421,0.701818,0.000973,"#008f7b"
1075213140659449856,metaterritorio,9,1,0,1,0.747545,0.775901,0,"#008f7b"
1181422752085020672,ColoquioHDMzles,9,0,8,8,0.722928,0.663553,0.003405,"#008f7b"
725665508478046208,OTRI_UCLM,49,1,0,1,0.378146,0.691919,0,"#ff7007"
975837834056732672,MiltonVelsquez3,9,0,3,3,0.720186,0.705406,0.000973,"#008f7b"
1039184170004688897,CCFJC,9,3,0,3,0.705958,0.681397,0.000973,"#008f7b"
1142554350184751104,milomb08,9,0,1,1,0.727396,0.677577,0,"#008f7b"
826946827673071616,donramondieta,7,0,1,1,0.393701,0.306589,0,"#ffb800"
1157009147851726848,weytlatuani,22,0,1,1,0.390409,0.603651,0,"#00e8b2"
728608124081348609,PrismaRU,7,4,5,9,0.435298,0.332356,0.003891,"#ffb800"
732870088718745600,Musarqgranada,31,0,1,1,0.659473,0.537174,0,"#3e93ff"
1088817493320318978,CSICmasI,22,19,1,20,0.605743,0.498133,0.009241,"#00e8b2"
1073742015337123840,GMarquezColin,7,4,0,4,0.445055,0.359199,0.001459,"#ffb800"
961856300811411459,MUAnalytics,18,2,0,2,0.737347,0.639291,0.000486,"#5456a6"
971058769990967296,CristinaHdeL,49,1,0,1,0.302508,0.657304,0,"#ff7007"
815169124322201600,Datascience__,14,12,0,12,0.697842,0.083378,0.00535,"#00eeff"
1225174588381958148,andretta_pedro,13,1,0,1,0.404428,0.433027,0,"#3bec00"
777943803479019522,cursorenla,49,1,0,1,0.400326,0.645983,0,"#ff7007"
1174710991118131203,CastroLeha,22,0,2,2,0.654528,0.482136,0.000486,"#00e8b2"
871771924824813568,osirionbella,22,0,2,2,0.649289,0.480589,0.000486,"#00e8b2"
1165405454991679488,VanDenEnden3,13,2,0,2,0.465077,0.399119,0.000486,"#3bec00"
954006833185918976,BiobancoLaFe,22,0,2,2,0.640355,0.474785,0.000486,"#00e8b2"
1169259971546140674,AlfonsodelRey1,22,0,2,2,0.643884,0.47951,0.000486,"#00e8b2"
779251818488590336,IBBTEC,22,0,2,2,0.650037,0.4868,0.000486,"#00e8b2"
749944718528831488,IFCA_CSIC_UC,22,0,2,2,0.632918,0.478425,0.000486,"#00e8b2"
1049592781256167424,scie_inform,22,0,3,3,0.657149,0.484984,0.000973,"#00e8b2"
1033955641411493888,BabaCirculo,38,0,11,11,0.505037,0.44554,0.004864,"#662859"
963747675479986177,Ant_Bahamonde,22,0,2,2,0.664547,0.487639,0.000486,"#00e8b2"
801962927305564160,IntrusaDocument,13,0,7,7,0.584305,0.393287,0.002918,"#3bec00"
948150883359092736,mjvicentedo,30,0,1,1,0.288608,0.233319,0,"#ff77ff"
767675409336897536,NVSData,14,0,1,1,0.714461,0.049036,0,"#00eeff"
814388513269489665,jnavarrolop,30,0,1,1,0.28686,0.235796,0,"#ff77ff"
992911186499919872,AfroPython,36,0,1,1,0.523215,0.209416,0,"#825403"
1121720262226075649,JulianCerezo2,22,0,2,2,0.593031,0.333417,0.000486,"#00e8b2"
1121792032530259968,GerardCasablan1,22,0,2,2,0.610933,0.333458,0.000486,"#00e8b2"
943139401558839299,Madrid_IAS,35,6,4,10,0.612183,0.49372,0.004377,"#00faff"
707131283495854080,farmamarketing1,22,0,2,2,0.604149,0.331274,0.000486,"#00e8b2"
975452621522853890,e_nterdiscipl,14,0,1,1,0.711115,0.046797,0,"#00eeff"
985310593333776385,taller_edi_rm,49,0,1,1,0.349661,0.559814,0,"#ff7007"
1115375807596244994,XVIIIWSREBIUN,31,3,2,5,0.520505,0.650062,0.001946,"#3e93ff"
966450091417591809,feuaq,13,1,0,1,0.351054,0.495509,0,"#3bec00"
866701758961266690,CCexperimentUFV,22,0,1,1,0.426848,0.550062,0,"#00e8b2"
1057649180209020935,acunill86,22,0,1,1,0.65233,0.461217,0,"#00e8b2"
728902836206063616,Miar_UB,14,0,1,1,0.54396,0.692921,0,"#00eeff"
4849181554,ecoinf_aeet,22,0,1,1,0.662161,0.480766,0,"#00e8b2"
993786184571719681,CientifEnDatos,22,0,1,1,0.663507,0.470393,0,"#00e8b2"
1104156737895100416,EleD_Concepcion,22,0,1,1,0.670463,0.476918,0,"#00e8b2"
4732637128,ope_ucm,22,4,1,5,0.620322,0.49574,0.001946,"#00e8b2"
1178646551004110848,AZTbiowine,22,0,2,2,0.660427,0.482914,0.000486,"#00e8b2"
894486273896960000,sujetoshibridos,36,0,1,1,0.745749,0.305466,0,"#825403"
1080450389231763456,Isaac_MRM,14,1,2,3,0.444877,0.594186,0.000973,"#00eeff"
1163863211109695494,JMLMarquesSilva,36,0,2,2,0.539326,0.377248,0.000486,"#825403"
803979551068028929,ElQueretano_,49,1,0,1,0.35189,0.635506,0,"#ff7007"
936068021168336896,sol_terlizzi,21,0,1,1,0.328599,0.451222,0,"#c6cc85"
1109437450013806592,bentospinozabot,21,0,1,1,0.305585,0.45365,0,"#c6cc85"
822185179477315584,wandavazquezg,49,1,0,1,0.505495,0.204647,0,"#ff7007"
831876261291122688,FCEinvestiga,49,1,0,1,0.386137,0.628285,0,"#ff7007"
1002715510096752640,Alkehbulan,36,0,2,2,0.461766,0.159549,0.000486,"#825403"
839932869447401472,nyazkywalker,36,0,2,2,0.464613,0.157282,0.000486,"#825403"
1060572862686355456,oieusouofabio,36,0,3,3,0.51389,0.213757,0.000973,"#825403"
1174436529151840256,plottingpoetry,30,1,0,1,0.518703,0.625771,0,"#ff77ff"
916441429806903296,FCSC_EU,31,0,2,2,0.562126,0.541181,0.000486,"#3e93ff"
4858084511,RaspberryPMedia,34,1,0,1,0.461773,0.207445,0,"#ff0d69"
907616464101879808,RIGA_LATAM,49,0,1,1,0.36443,0.486786,0,"#ff7007"
822826632671010816,Pinzon_Fuchs,38,0,5,5,0.524212,0.455725,0.001946,"#662859"
933191908750487553,JuanCar10931644,31,0,2,2,0.629918,0.455123,0.000486,"#3e93ff"
739809139942129664,YoconKindle,55,1,0,1,0.480034,0.740364,0,"#cb3f32"
1032607982092267520,QuinqueLab,3,0,1,1,0.610398,0.764466,0,"#ffb3ff"
830007823065034752,paulapsobrino,3,5,0,5,0.592637,0.703479,0.001946,"#ffb3ff"
1138071962369089536,cemyr_uprrp,36,0,1,1,0.606993,0.415188,0,"#825403"
734506375204753408,KindleUnlimiEsp,55,3,0,3,0.548413,0.488597,0.000973,"#cb3f32"
997900947190886401,MiguelBarradas7,31,0,1,1,0.621736,0.460968,0,"#3e93ff"
1039610777290899456,MBustosRubio,14,0,2,2,0.434624,0.527477,0.000486,"#00eeff"
852880173338959880,CONNAC_,37,0,1,1,0.45029,0.286506,0,"#006032"
1355303991643492353,zoom_us,36,2,0,2,0.529461,0.368341,0.000486,"#825403"
4444608192,veckst,13,1,0,1,0.398144,0.414353,0,"#3bec00"
963896575679434752,EsriEcu,49,1,0,1,0.34734,0.651686,0,"#ff7007"
4462314507,xaxaiateacher,48,0,1,1,0.264885,0.529319,0,"#ff7a78"
1014901823440908289,MPlanetarias,30,0,6,6,0.460672,0.510101,0.002432,"#ff77ff"
718609204957851649,VaniaFigueroaI,21,0,1,1,0.342921,0.450558,0,"#c6cc85"
944245138728960000,RetahilaLa,7,0,2,2,0.373851,0.367727,0.000486,"#ffb800"
1156962391042736129,charaguenisima,7,0,1,1,0.709106,0.490507,0,"#ffb800"
1082515976896372737,KarinSaavedraR,21,0,1,1,0.30972,0.446582,0,"#c6cc85"
1113640592842600448,platom___,13,1,0,1,0.580101,0.430899,0,"#3bec00"
1135992289808068609,Innova_UV,21,0,1,1,0.328864,0.454543,0,"#c6cc85"
1138169113241706496,ideshchile,21,0,1,1,0.309368,0.438763,0,"#c6cc85"
806206471461597185,bastias_adriana,21,0,1,1,0.289804,0.433767,0,"#c6cc85"
987109443048439808,ConocimientoRD,21,0,1,1,0.339809,0.443479,0,"#c6cc85"
1026503754261127169,plataformasdt,21,0,1,1,0.317613,0.451222,0,"#c6cc85"
798165447300485121,RedInvestChile,49,6,5,11,0.384983,0.46502,0.004864,"#ff7007"
784442472910946304,Lib11Lib,21,0,3,3,0.448768,0.495717,0.000973,"#c6cc85"
794753884778532864,thinmexduke,34,0,1,1,0.546095,0.346626,0,"#ff0d69"
1375443614751354881,chi_max,13,2,0,2,0.481564,0.405561,0.000486,"#3bec00"
957210401380405248,proyectognis,31,0,1,1,0.601362,0.418695,0,"#3e93ff"
821878972170510336,congresoepac,31,0,1,1,0.596943,0.420505,0,"#3e93ff"
776092194474262529,JRRIManchester,36,1,0,1,0.537848,0.300149,0,"#825403"
1051551804192899072,JuarezAyer,5,0,1,1,0.635014,0.303669,0,"#b2dd44"
921781423601803265,grhluna24,58,0,1,1,0.509226,0.65469,0,"#005076"
903963111643865091,collbaix63,7,0,1,1,0.714798,0.487453,0,"#ffb800"
976797238646247425,cortesrelloe50,49,1,0,1,0.343951,0.394022,0,"#ff7007"
1167007701622317057,DrRaulEspinal1,13,1,0,1,0.455436,0.385929,0,"#3bec00"
1325517383113428992,rod_sands,54,3,0,3,0.357348,0.737001,0.000973,"#ff332c"
4492337592,Maleta_Ilegal,54,0,2,2,0.324649,0.821557,0.000486,"#ff332c"
892587675114500096,gazetagt,54,3,0,3,0.312421,0.875211,0.000973,"#ff332c"
1130480393977655296,GonzalezMoraJL,34,0,1,1,0.539479,0.341774,0,"#ff0d69"
770383459697254400,SiteEmRede,49,0,1,1,0.567355,0.325448,0,"#ff7007"
1165892152670466048,States_AI_IA,49,1,0,1,0.34978,0.635979,0,"#ff7007"
965543117263958016,_rodrigo_dg,49,0,1,1,0.494843,0.353348,0,"#ff7007"
741264387349094400,IrasemaRivasG05,49,1,1,2,0.472296,0.643424,0.000486,"#ff7007"
817452806252724224,unamglobal,13,1,1,2,0.460961,0.415122,0.000486,"#3bec00"
1087512328051060737,PrensaUnam,13,1,0,1,0.479513,0.339278,0,"#3bec00"
1136026943126724608,gvillegasgomez,38,0,1,1,0.740985,0.447637,0,"#662859"
1084875459278573568,AkalArgentina,38,0,1,1,0.729608,0.446381,0,"#662859"
919957704503889920,bailia_1966,38,0,1,1,0.733949,0.443936,0,"#662859"
1089604367429312512,ECUDIE1,34,26,8,34,0.515656,0.47263,0.016051,"#ff0d69"
826519260197482496,mmmmmm3c,22,0,1,1,0.230866,0.674073,0,"#00e8b2"
866348561960771584,FacSalud_UCLM,15,0,2,2,0.582376,0.657006,0.000486,"#008ebb"
1035464479516045313,CajoRuben,15,0,2,2,0.574077,0.654963,0.000486,"#008ebb"
848827142901248000,Biblioteca_RJB,22,1,0,1,0.669849,0.566671,0,"#00e8b2"
1099072812864675841,AndLinbi,22,1,0,1,0.661437,0.568057,0,"#00e8b2"
784421263779430400,AjuntamentVLC,31,1,0,1,0.378643,0.541282,0,"#3e93ff"
722362236912734209,KarinaSMCoach,0,0,1,1,0.358194,0.584356,0,"#8ecfec"
707957760697212929,UOC_research,14,1,0,1,0.590075,0.456831,0,"#00eeff"
1008161287539445761,lablibredigital,3,0,1,1,0.62596,0.581106,0,"#ffb3ff"
826499427011473408,jaigon1192,13,0,1,1,0.463277,0.391215,0,"#3bec00"
866681638574542849,summa_edu,31,2,2,4,0.659839,0.702229,0.001459,"#3e93ff"
969760122690940928,CaroGomezRaya,7,0,1,1,0.644562,0.373138,0,"#ffb800"
906177698497798144,RebecaG24996757,7,0,1,1,0.632693,0.375418,0,"#ffb800"
753630276937322496,CLAUDIAMTZL1,7,0,1,1,0.63231,0.36855,0,"#ffb800"
1073373080737734657,CasasolaIlcely,7,0,1,1,0.649705,0.374405,0,"#ffb800"
779033789079048194,coleccionesUNAM,7,3,1,4,0.645313,0.354888,0.001459,"#ffb800"
914938325043171331,Moviendo_Pumas,7,0,1,1,0.629771,0.374194,0,"#ffb800"
802214769574805504,depfeunam,7,0,1,1,0.636548,0.369292,0,"#ffb800"
995488571661287424,EdnaLauraGarca1,7,0,1,1,0.624692,0.382335,0,"#ffb800"
1033909546056445952,21Armyn,7,0,1,1,0.6481,0.368077,0,"#ffb800"
1064108650271309826,TheCuriousLuke,13,0,1,1,0.535514,0.394847,0,"#3bec00"
881809414143037441,quijoteduca,58,0,2,2,0.494671,0.524944,0.000486,"#005076"
1109039301046743040,FilosofiaNada,22,1,0,1,0.336985,0.581186,0,"#00e8b2"
905337991622733824,mcferny016,22,0,1,1,0.743426,0.441984,0,"#00e8b2"
1122783757130457088,mgdbsi,13,0,1,1,0.532461,0.418814,0,"#3bec00"
992666334839308288,Inmaculada_1975,49,1,0,1,0.328191,0.675484,0,"#ff7007"
938009624007139329,ArnauBaroMas,14,2,3,5,0.557898,0.590942,0.001946,"#00eeff"
773860826931400704,stars4all_es,22,0,2,2,0.568602,0.667435,0.000486,"#00e8b2"
1035422540166967296,Khattiy74899201,3,0,3,3,0.441894,0.606213,0.000973,"#ffb3ff"
1042937122938937344,desapabullada,22,0,1,1,0.498923,0.674115,0,"#00e8b2"
877810175511494656,GSK_ES,49,1,0,1,0.377447,0.687331,0,"#ff7007"
1035169781568163841,DianaPalardy,13,6,3,9,0.409222,0.496625,0.003891,"#3bec00"
841192923957993472,infospherelab,42,0,1,1,0.811941,0.418876,0,"#66e087"
1006597011288870915,antropohackers,42,1,2,3,0.755818,0.437142,0.000973,"#66e087"
1154417542280228870,RehusoS,9,0,2,2,0.618306,0.567367,0.000486,"#008f7b"
1151593387319074816,andedh_chile,21,0,2,2,0.287497,0.243241,0.000486,"#c6cc85"
902923970516840449,ReVisionGuelph,36,1,0,1,0.458135,0.293675,0,"#825403"
776093579395600385,ProFuturo_,31,1,0,1,0.63661,0.526163,0,"#3e93ff"
997031968402563072,martaherrer0,31,1,3,4,0.403197,0.519435,0.001459,"#3e93ff"
1140718077463670786,HumanismoD,49,1,0,1,0.38754,0.694127,0,"#ff7007"
1108370080205819904,EpsiSandra,31,0,1,1,0.599295,0.463773,0,"#3e93ff"
1137800975962578944,CarranzaGuije,49,0,1,1,0.356396,0.485446,0,"#ff7007"
1068915858817409025,FVicenteRisco,0,2,0,2,0.436393,0.650493,0.000486,"#8ecfec"
823640124525281285,EliasMoscoso,7,0,1,1,0.775587,0.628287,0,"#ffb800"
1135996793685250050,HistoriaRegion,7,0,1,1,0.396414,0.242531,0,"#ffb800"
1149016871267708929,SeecValladolid,58,4,0,4,0.770778,0.541111,0.001459,"#005076"
910455709317390337,HansSiegen,31,0,1,1,0.606882,0.477314,0,"#3e93ff"
869716535908196352,assadarino,7,0,1,1,0.783732,0.630392,0,"#ffb800"
913135418551435264,Eligregl,7,0,1,1,0.771681,0.637574,0,"#ffb800"
742992646730330113,RdH_UNED,30,5,2,7,0.5616,0.609117,0.002918,"#ff77ff"
1029040722744356865,BravardDr,34,0,1,1,0.314266,0.420713,0,"#ff0d69"
4442814388,ZeroZR0,22,0,1,1,0.403209,0.595789,0,"#00e8b2"
4833000750,Alterverso_,22,0,1,1,0.400809,0.604324,0,"#00e8b2"
950137378341052416,Pilaralezeia,58,0,1,1,0.830149,0.53968,0,"#005076"
1069214378145271808,GrupoLiel,49,1,0,1,0.353705,0.638266,0,"#ff7007"
721419296723857413,guidogiamba,49,1,0,1,0.444679,0.662196,0,"#ff7007"
713817378354814977,AyeToscano,49,1,0,1,0.438751,0.657791,0,"#ff7007"
1136332882769784837,FilosofiaCalle,58,0,1,1,0.833886,0.53768,0,"#005076"
776379402305273856,EducacioUB,31,1,0,1,0.456571,0.586413,0,"#3e93ff"
1150757998043815937,FECPanama,9,0,1,1,0.711857,0.663863,0,"#008f7b"
920660335308271618,Cifu1979,22,0,1,1,0.380163,0.593795,0,"#00e8b2"
845662107899191296,JuanRiveraTrad,22,0,1,1,0.406389,0.599384,0,"#00e8b2"
1475664870653579265,SanHarom,31,3,0,3,0.594545,0.510042,0.000973,"#3e93ff"
943975647193464833,B_Espinoso,22,0,1,1,0.378119,0.598466,0,"#00e8b2"
887024572247224320,mvrciegalo,22,0,1,1,0.397891,0.597222,0,"#00e8b2"
770350217883447297,curdadelimon,22,0,1,1,0.386501,0.596248,0,"#00e8b2"
990304283143884800,V546486,22,0,1,1,0.379721,0.589974,0,"#00e8b2"
1122253382381645824,aVersIMEduraS,22,0,1,1,0.386073,0.599504,0,"#00e8b2"
920043918347194368,JordiCucurullOf,22,0,1,1,0.395667,0.60657,0,"#00e8b2"
716993414483542016,SaraK27247244,22,0,1,1,0.410196,0.597977,0,"#00e8b2"
1064296823886630912,Emriver_Spain,22,0,1,1,0.389523,0.6081,0,"#00e8b2"
928007677078376449,CarrelProfe,3,2,1,3,0.601743,0.605629,0.000973,"#ffb3ff"
985911017770246145,eliza_lavenza,22,0,1,1,0.365547,0.589354,0,"#00e8b2"
923552227071070210,AULC_Languages,30,0,1,1,0.574209,0.438189,0,"#ff77ff"
772915065691500544,evafajarnes1,30,0,3,3,0.627093,0.62302,0.000973,"#ff77ff"
777886853508792320,bumeranlibros,38,0,1,1,0.596442,0.347471,0,"#662859"
1131182600062742529,Luiscarlosbehe,38,0,1,1,0.635779,0.361054,0,"#662859"
836222725798547456,pcabrera7,30,0,5,5,0.551836,0.585868,0.001946,"#ff77ff"
1066257207384260608,iskocongresosp1,22,3,0,3,0.489872,0.590598,0.000973,"#00e8b2"
895659447103651845,ulla_gomez,55,0,1,1,0.34802,0.534629,0,"#cb3f32"
719779458635456512,ci_usc,0,0,2,2,0.439166,0.60458,0.000486,"#8ecfec"
961520527675416576,feijoo_costa,30,2,4,6,0.426408,0.581889,0.002432,"#ff77ff"
860743102751002624,Marta_Vergara13,38,0,2,2,0.611542,0.391509,0.000486,"#662859"
976728152507600896,DH2019_NL,13,7,0,7,0.507689,0.490755,0.002918,"#3bec00"
1139340509036650500,FlamminiRoxana,37,0,1,1,0.639528,0.345735,0,"#006032"
782647665234292736,amoralesrondan,37,12,45,57,0.597267,0.423733,0.027237,"#006032"
723225761356750848,ciberindex,31,0,1,1,0.721379,0.539345,0,"#3e93ff"
1068864587519406082,AvinainJ,22,0,1,1,0.596007,0.607852,0,"#00e8b2"
1092246588066578432,EducativaRd,37,0,1,1,0.438771,0.672871,0,"#006032"
1148392174444306432,Alejand55397644,7,0,2,2,0.16124,0.699173,0.000486,"#ffb800"
778176348938440705,Cultura_FiloUSC,22,4,0,4,0.469656,0.600177,0.001459,"#00e8b2"
1032553496179040263,InformacionUSC,30,1,0,1,0.359561,0.591668,0,"#ff77ff"
906087537881513984,projet_bretez,22,0,1,1,0.578423,0.622991,0,"#00e8b2"
911599419367272448,mylene_pardoen,58,0,2,2,0.533406,0.578229,0.000486,"#005076"
1109870449956188167,martin_juanpe,37,0,2,2,0.678779,0.430894,0.000486,"#006032"
1069567809695428609,helenasilvahist,36,0,2,2,0.562467,0.375985,0.000486,"#825403"
746018167852568576,encontrociencia,36,3,0,3,0.571615,0.403977,0.000973,"#825403"
1006519148535566336,fizcatus,22,1,0,1,0.594101,0.603715,0,"#00e8b2"
867679923162542082,ramonmorros_upc,22,1,0,1,0.48506,0.676866,0,"#00e8b2"
913010630566834176,DeepLearningBCN,22,1,0,1,0.498118,0.679179,0,"#00e8b2"
710476297332506624,DotCSV,22,1,0,1,0.502227,0.667781,0,"#00e8b2"
1144709735473504256,JoseRamonMexico,13,0,2,2,0.510988,0.356553,0.000486,"#3bec00"
1124113035516420096,HerdingTrish,34,0,4,4,0.485147,0.435769,0.001459,"#ff0d69"
1137739725580787712,GdSemes,31,0,1,1,0.724041,0.53673,0,"#3e93ff"
812204195138904068,RamiroAc_,31,0,1,1,0.726513,0.541564,0,"#3e93ff"
1104089988659056641,FerBaetaNeves,36,1,0,1,0.56099,0.203146,0,"#825403"
1145776527151439872,BlogJavima,49,3,0,3,0.433888,0.548504,0.000973,"#ff7007"
925680697922277376,PabloDuBar,22,0,1,1,0.522787,0.669743,0,"#00e8b2"
738382124139597824,elia_quiros,22,0,1,1,0.49435,0.677994,0,"#00e8b2"
843759038877843456,ISBSArchaeology,22,1,0,1,0.497021,0.682777,0,"#00e8b2"
997007980242468864,museoarqva,22,1,0,1,0.502312,0.675931,0,"#00e8b2"
912689036854165504,EdrasRT,36,1,0,1,0.294606,0.394058,0,"#825403"
1096870521046794240,DescobrintKemet,22,0,2,2,0.537652,0.695126,0.000486,"#00e8b2"
1139923253898686471,mundosantiguos,22,1,2,3,0.543156,0.636599,0.000973,"#00e8b2"
700819470143500289,PatronatoIBERO,13,0,1,1,0.445395,0.311178,0,"#3bec00"
969546447552118786,dhd2019,30,1,0,1,0.430738,0.531498,0,"#ff77ff"
1085728843711897600,smsociologia,7,40,0,40,0.753024,0.536349,0.018969,"#ffb800"
873927083579379712,YohannaUseda,38,0,1,1,0.601248,0.352806,0,"#662859"
960937800081334275,pasado_abierto,49,5,1,6,0.644302,0.418412,0.002432,"#ff7007"
1080601648551075840,hucalu2,34,0,1,1,0.400599,0.506542,0,"#ff0d69"
1010174038952603649,SUnmdp,49,0,1,1,0.711671,0.378299,0,"#ff7007"
758886357632626688,aquelarre_h,7,0,2,2,0.401029,0.387839,0.000486,"#ffb800"
1020385106727440384,CAPES_Oficial,36,5,0,5,0.547122,0.326679,0.001946,"#825403"
1113957707478777856,DHWollongong,36,1,0,1,0.430467,0.290903,0,"#825403"
899796658678104065,BalticoIdeas,38,0,5,5,0.675015,0.436854,0.001946,"#662859"
1067404991592349697,Disparidades_,22,0,1,1,0.509024,0.669473,0,"#00e8b2"
1088372235763617793,geoportalmadrid,58,1,2,3,0.563237,0.445707,0.000973,"#005076"
1034405140026077184,AngelesHerasC,30,3,0,3,0.585444,0.54213,0.000973,"#ff77ff"
1095315509703307265,AmericaSantosVM,43,1,0,1,0.742216,0.625823,0,"#fcae7e"
938906497362415621,PonsatiAgnes,22,1,0,1,0.640501,0.611773,0,"#00e8b2"
903146153675563009,Momope12,7,0,1,1,0.827046,0.558391,0,"#ffb800"
1132565453048602624,Tutu71946309,7,0,1,1,0.805352,0.548163,0,"#ffb800"
967127707187367936,YomellamoMario,7,0,1,1,0.843295,0.558571,0,"#ffb800"
1029086430931374087,EducacionET,38,1,0,1,0.595324,0.362151,0,"#662859"
906782590560030722,SL_Brandoni,30,0,1,1,0.884264,0.542081,0,"#ff77ff"
964498863632584707,dhinstitutes,34,2,3,5,0.487346,0.356803,0.001946,"#ff0d69"
968561556144447491,RosinTorres_DHL,34,2,0,2,0.517277,0.345984,0.000486,"#ff0d69"
1132423394136338433,Victoravila1313,30,0,1,1,0.656709,0.590786,0,"#ff77ff"
1100791084265947137,biblioteca_aceb,22,1,1,2,0.507469,0.646599,0.000486,"#00e8b2"
869155874014711808,AfiladorM21,58,2,3,5,0.581196,0.215778,0.001946,"#005076"
780096491729944578,M21madrid,58,1,0,1,0.575474,0.141557,0,"#005076"
846892004260794368,JaimesMendiet,5,0,1,1,0.615797,0.287946,0,"#b2dd44"
4473709342,JiFFi_UGR,31,0,1,1,0.66969,0.539364,0,"#3e93ff"
1139156465510490113,valtersmb,5,0,1,1,0.638144,0.301435,0,"#b2dd44"
1117462176619552769,Alejand506l,30,0,1,1,0.657866,0.593386,0,"#ff77ff"
4754704273,Byblos1968,5,0,1,1,0.629478,0.29283,0,"#b2dd44"
741612289971871744,johnrenardile01,14,0,2,2,0.650941,0.232042,0.000486,"#00eeff"
1053236455680696320,weareshifta,14,4,1,5,0.596347,0.399184,0.001946,"#00eeff"
715568678322978821,cultumatica,14,0,1,1,0.665766,0.341498,0,"#00eeff"
4889849212,Niyoltika,13,0,1,1,0.446725,0.308133,0,"#3bec00"
1109649249929588737,ivan_gundisalv,13,0,2,2,0.455092,0.341293,0.000486,"#3bec00"
810813142230061060,CIFerrol,30,1,0,1,0.887607,0.533343,0,"#ff77ff"
1124002404331073540,Yo69499084,34,0,1,1,0.553257,0.415904,0,"#ff0d69"
1007750881016795136,AscofadeCo,3,0,3,3,0.347456,0.53379,0.000973,"#ffb3ff"
994550846003302401,ForoAva,3,0,1,1,0.297072,0.567878,0,"#ffb3ff"
957810174756032513,Psicocely,38,0,1,1,0.623402,0.356325,0,"#662859"
1096097520843771904,Andrese244,41,2,2,4,0.375482,0.405561,0.001459,"#697b00"
1129867151681183745,fheargentina,49,1,0,1,0.372711,0.644414,0,"#ff7007"
1118067781969293312,gemmanpla,22,0,1,1,0.540761,0.697367,0,"#00e8b2"
1366866408844500997,ScriptaManent12,14,7,0,7,0.505548,0.572555,0.002918,"#00eeff"
984347859339431936,GobernanzaInd,0,1,1,2,0.256129,0.702513,0.000486,"#8ecfec"
759829490818228224,JoseGarVil10,58,0,2,2,0.589812,0.29647,0.000486,"#005076"
874601569735643137,dg_romance,14,3,2,5,0.479236,0.554708,0.001946,"#00eeff"
1113035931014049792,ArteAsri,13,10,0,10,0.519776,0.504066,0.004377,"#3bec00"
888325748276289536,fisicaUS,1,0,1,1,0.396361,0.709266,0,"#b6cb00"
1135367640187379713,JohannaLaralala,38,0,2,2,0.637272,0.441996,0.000486,"#662859"
941841031410192384,Albacru131420,38,0,1,1,0.607647,0.362005,0,"#662859"
994941054729285632,qgises,55,5,0,5,0.574139,0.505123,0.001946,"#cb3f32"
905213155659456512,GeochicasOSM,55,1,4,5,0.555029,0.50583,0.001946,"#cb3f32"
4847334674,MoocMates,34,0,3,3,0.570645,0.384991,0.000973,"#ff0d69"
706957608503083008,PcccOficial,38,0,1,1,0.60464,0.357982,0,"#662859"
1110172381144846336,asoartesu,38,0,1,1,0.602771,0.356892,0,"#662859"
1059207248113795072,PensionesLibro,49,1,0,1,0.417397,0.655204,0,"#ff7007"
1040262518793555968,gndnet,38,0,2,2,0.583826,0.438368,0.000486,"#662859"
702900243646586880,secctthh,15,7,0,7,0.534075,0.607855,0.002918,"#008ebb"
784111120390950912,gradespauva,30,2,1,3,0.487344,0.578406,0.000973,"#ff77ff"
954345993453162496,sidneysgoveia,34,0,2,2,0.477314,0.415523,0.000486,"#ff0d69"
720027998284562432,Supermancitoo,55,0,1,1,0.733654,0.652579,0,"#cb3f32"
985875694570926083,tecnoeduc_usc,55,4,3,7,0.306202,0.542566,0.002918,"#cb3f32"
1099982238995922944,group6thum18,34,0,8,8,0.45533,0.484974,0.003405,"#ff0d69"
985232807927648257,TercerOjoMedios,49,0,2,2,0.404202,0.389893,0.000486,"#ff7007"
851506489906933760,InvesAyH,49,6,2,8,0.389383,0.442909,0.003405,"#ff7007"
837219264679526401,Trans_Literacy,38,4,0,4,0.530243,0.422665,0.001459,"#662859"
1102286446382235648,HayajnehNadia,49,1,0,1,0.308763,0.603123,0,"#ff7007"
910606424903892993,TecNM_MX,34,1,0,1,0.616518,0.323354,0,"#ff0d69"
1118915895940796425,Yorick20435346,49,0,4,4,0.452211,0.538864,0.001459,"#ff7007"
1062182161363673088,EspinacasNelly,34,0,1,1,0.470777,0.261803,0,"#ff0d69"
938249796346941440,Seikilos1000,13,0,1,1,0.388502,0.320331,0,"#3bec00"
915558582971764738,Javipelasa,22,0,1,1,0.658075,0.475858,0,"#00e8b2"
763138124562046977,Revista_COLSAN,13,1,0,1,0.421224,0.344111,0,"#3bec00"
1002023910953701376,ignrbk,49,0,1,1,0.381046,0.307297,0,"#ff7007"
4897619507,RevistaRIITE,13,1,0,1,0.429044,0.493001,0,"#3bec00"
983629872365944833,theChrisChua,14,0,1,1,0.712735,0.043637,0,"#00eeff"
744648479805411329,MikelErecheta,14,0,1,1,0.720085,0.041626,0,"#00eeff"
730848414611718144,Tess_blue815,14,0,1,1,0.700446,0.044322,0,"#00eeff"
4556214443,noleas_,49,0,1,1,0.383442,0.610456,0,"#ff7007"
1072678256665653248,QuinteroZandra,38,0,1,1,0.552675,0.374416,0,"#662859"
993245149072412673,MarixaLasso1,38,0,1,1,0.536337,0.365726,0,"#662859"
868644240724807680,MemoriaUN,38,1,0,1,0.547643,0.375766,0,"#662859"
1058736233923391488,cidadao_urbano,36,0,1,1,0.55763,0.293428,0,"#825403"
1073980184766935041,juanasa96586050,13,0,4,4,0.451436,0.487939,0.001459,"#3bec00"
707599215736840193,JJ_Guz,38,0,1,1,0.536901,0.358988,0,"#662859"
818936775741685764,CCyTT_UMA,15,4,0,4,0.489444,0.599483,0.001459,"#008ebb"
1039965688000126977,MarkJ_ohnson,34,0,1,1,0.567102,0.415658,0,"#ff0d69"
1411492015750062082,985unradio,38,2,0,2,0.527741,0.429401,0.000486,"#662859"
1067903097727578112,ATHARProject,34,0,4,4,0.465631,0.444272,0.001459,"#ff0d69"
1041656551428120577,oaroer,34,1,0,1,0.47668,0.354364,0,"#ff0d69"
1083650314157182977,MaxwellMommsen,13,0,2,2,0.436049,0.51502,0.000486,"#3bec00"
873265200937545729,entrelineasling,22,2,0,2,0.361728,0.446613,0.000486,"#00e8b2"
796420180662484993,Carmencloud2,1,0,1,1,0.420256,0.595151,0,"#b6cb00"
738400264164675584,cisanhueza,13,0,2,2,0.448789,0.510973,0.000486,"#3bec00"
1099692000444641281,LuisdelaPinta,30,0,3,3,0.711412,0.668169,0.000973,"#ff77ff"
1003504549259366400,andresing1826,38,0,2,2,0.65342,0.423656,0.000486,"#662859"
1061897024411439104,dinaupohum,1,0,2,2,0.461879,0.598826,0.000486,"#b6cb00"
775670296657428480,deaymerichb,31,1,0,1,0.339601,0.520799,0,"#3e93ff"
863573257684910086,danielmbarragn,34,0,4,4,0.493105,0.425595,0.001459,"#ff0d69"
720382613446270977,EEColombia2020,38,1,0,1,0.538019,0.370338,0,"#662859"
732224195162148864,Pigmen666,49,0,3,3,0.476171,0.521838,0.000973,"#ff7007"
890488898454814720,rod_agomez,34,0,3,3,0.426196,0.45024,0.000973,"#ff0d69"
1007867765443530752,LChangoChilango,34,0,1,1,0.342486,0.400178,0,"#ff0d69"
868894665420009473,romel_anna,34,1,0,1,0.398919,0.191391,0,"#ff0d69"
833696723939815424,LuismaBeamonte,16,11,1,12,0.95016,0.665768,0.00535,"#c42c63"
4876564259,minimousejulio7,16,0,2,2,0.953004,0.657853,0.000486,"#c42c63"
850077291052969985,Triniunzue,16,0,2,2,0.946151,0.669613,0.000486,"#c42c63"
4398228316,popularesteruel,16,0,2,2,0.956452,0.663511,0.000486,"#c42c63"
765944724503093248,juanca11265,38,0,1,1,0.655062,0.361037,0,"#662859"
1031792747471142913,LauraBP21115130,30,0,1,1,0.438534,0.655039,0,"#ff77ff"
825463363929042944,MisticaVirtual,30,6,1,7,0.460219,0.587585,0.002918,"#ff77ff"
1050097840838590470,Angela61752348,16,0,2,2,0.959934,0.661027,0.000486,"#c42c63"
939950322608431104,Agrowoh,30,0,1,1,0.440104,0.653457,0,"#ff77ff"
4714150637,BrocateFelix,16,0,2,2,0.945483,0.655539,0.000486,"#c42c63"
902487847436943360,BarreirAurora,16,0,3,3,0.928009,0.678076,0.000973,"#c42c63"
959107809198657536,mafernandezguad,16,0,2,2,0.93097,0.660692,0.000486,"#c42c63"
1079445197417783297,inma12310203,16,0,2,2,0.929188,0.682655,0.000486,"#c42c63"
801411977314795520,DelegacionH,15,1,3,4,0.573359,0.583406,0.001459,"#008ebb"
1037949387442290688,e_nhka,51,0,1,1,0.357004,0.181993,0,"#c44aac"
773666887133720577,mtnoliver,49,0,1,1,0.297428,0.654047,0,"#ff7007"
860125316030894082,miyakiv,3,1,1,2,0.482418,0.566769,0.000486,"#ffb3ff"
1117133700989358082,NatashaReid95,14,0,1,1,0.694933,0.039549,0,"#00eeff"
853061770235260930,Merckxcycling,14,0,1,1,0.699929,0.041836,0,"#00eeff"
1050128939602063365,12horasToledo,15,0,1,1,0.569851,0.627969,0,"#008ebb"
4705633128,outwither,38,0,4,4,0.506294,0.434685,0.001459,"#662859"
873308336120352768,virginia_ahedo,37,4,0,4,0.661935,0.391715,0.001459,"#006032"
863418925811421188,cisnespardos,37,0,2,2,0.394132,0.339599,0.000486,"#006032"
1135504676353466368,uemadrid,14,1,0,1,0.207629,0.656056,0,"#00eeff"
720781885123629056,RevistaRelacso,14,0,1,1,0.575371,0.472523,0,"#00eeff"
4351493056,KSRInrap,14,0,3,3,0.539375,0.514891,0.000973,"#00eeff"
836558226011348992,JPDemoule,14,0,3,3,0.545964,0.51574,0.000973,"#00eeff"
900742401714774018,collective_dh,13,0,1,1,0.39278,0.441727,0,"#3bec00"
4922450361,_KarenHao,2,1,0,1,0.40244,0.556756,0,"#ffa64e"
736256190812848130,patrimonio_mex,41,4,1,5,0.305786,0.38003,0.001946,"#697b00"
905925847483285504,whaleandjaguar_,34,0,1,1,0.573093,0.335616,0,"#ff0d69"
909173661164347392,HistPartes,13,0,4,4,0.486254,0.432049,0.001459,"#3bec00"
1069351759691374592,frangarcera,22,0,2,2,0.583006,0.585711,0.000486,"#00e8b2"
875552762980913152,ErikaVG_SLP,13,0,4,4,0.473934,0.442209,0.001459,"#3bec00"
1313872849279627264,FoncaMx,13,2,0,2,0.42382,0.375181,0.000486,"#3bec00"
867287015938826240,SiamPDIUMA,14,0,2,2,0.617688,0.529331,0.000486,"#00eeff"
868065307214188544,FundacioCdM,34,1,0,1,0.260465,0.612903,0,"#ff0d69"
986231899998666752,jabanuelos2,34,0,1,1,0.575999,0.322741,0,"#ff0d69"
759982942034599941,corazontodito,13,0,2,2,0.450805,0.358029,0.000486,"#3bec00"
822625227628834817,LabMediosyTec,13,0,4,4,0.521003,0.442545,0.001459,"#3bec00"
889195797774032896,BelloArantxa,22,0,1,1,0.738098,0.419538,0,"#00e8b2"
752469784042889216,GagneLegal,34,0,1,1,0.413496,0.446319,0,"#ff0d69"
1068064999204184064,RealAcademiaAn,22,1,0,1,0.749544,0.423541,0,"#00e8b2"
891071616662351873,Siyofueraelsur,22,0,1,1,0.274641,0.445799,0,"#00e8b2"
722087419630206976,eureka_fyl,14,1,0,1,0.620092,0.552496,0,"#00eeff"
813109889123938305,Paramount_miss,22,0,1,1,0.259743,0.446368,0,"#00e8b2"
1067913912522297344,historiaparaque,34,0,1,1,0.477344,0.371079,0,"#ff0d69"
709053137680728068,SoniMili3001,22,0,1,1,0.262693,0.455298,0,"#00e8b2"
1100719308882231296,AMITMadrid_CLM,14,0,3,3,0.519685,0.489765,0.000973,"#00eeff"
1058063493998563332,FGodicheau,34,0,1,1,0.479688,0.37558,0,"#ff0d69"
1018773086982885376,BartolGutierrez,34,0,1,1,0.490984,0.379092,0,"#ff0d69"
805835064680607744,GrupGIEL,13,0,1,1,0.404669,0.479289,0,"#3bec00"
1096541624211927041,MurielBazaldua,17,0,6,6,0.781433,0.209131,0.002432,"#ff9cc7"
4923609207,EduTurismoAvila,58,0,1,1,0.464197,0.655805,0,"#005076"
924581599286648832,EsportsCatUMA,14,0,1,1,0.728463,0.518757,0,"#00eeff"
1099978545537970176,siran12061895,14,0,2,2,0.581275,0.507458,0.000486,"#00eeff"
997784680916246529,CheloPineda4,14,0,1,1,0.660188,0.557923,0,"#00eeff"
802140100255711232,EliasOrtigosa,14,0,1,1,0.656338,0.558439,0,"#00eeff"
1155934015943323651,AmazonESP,8,2,0,2,0.688435,0.240788,0.000486,"#00ed5d"
1054346276106579969,jeronimocarran3,38,0,1,1,0.532073,0.365584,0,"#662859"
956107431897194496,antoni_baena,14,0,3,3,0.570448,0.514096,0.000973,"#00eeff"
1060920268837867525,PeriegesisH,34,0,1,1,0.467691,0.380585,0,"#ff0d69"
1031654813870817281,vicpiwi,38,0,1,1,0.670559,0.70718,0,"#662859"
985809543916670981,tropeliasunizar,38,5,0,5,0.625264,0.648785,0.001946,"#662859"
999031882015789057,octimana,1,4,2,6,0.542318,0.667766,0.002432,"#b6cb00"
755241988149088256,DeaDoyle,49,1,0,1,0.521496,0.346096,0,"#ff7007"
858419305570070529,AnaP0958ap,9,0,2,2,0.656807,0.919741,0.000486,"#008f7b"
1042508699699478528,doc_et_bib,14,0,2,2,0.547619,0.480777,0.000486,"#00eeff"
709384412480335872,cvbrandoe,34,0,12,12,0.511188,0.491869,0.00535,"#ff0d69"
1013623640498335744,RafaelEhecatl,13,0,1,1,0.414932,0.424954,0,"#3bec00"
962457127632678912,luluchavez18,7,0,2,2,0.431795,0.365025,0.000486,"#ffb800"
1093882399459590149,QuotesHDsur,38,8,0,8,0.545159,0.453578,0.003405,"#662859"
1096484095205486592,EstudiosEconom,7,0,2,2,0.418682,0.369379,0.000486,"#ffb800"
1026867071664238592,Adecfin,7,0,2,2,0.410837,0.334854,0.000486,"#ffb800"
859443522029592576,des_igualdades,7,1,0,1,0.414304,0.322769,0,"#ffb800"
1022259818361483264,ConstainSylvia,38,2,0,2,0.643159,0.462888,0.000486,"#662859"
1088474302683496449,wanobros,14,0,1,1,0.585156,0.523277,0,"#00eeff"
863719296664563712,Micahr80,15,0,1,1,0.527504,0.675519,0,"#008ebb"
1084918226520133633,FresnoCristobal,13,0,1,1,0.392315,0.398036,0,"#3bec00"
1066343639692001282,camilofidel_,34,0,3,3,0.502491,0.422163,0.000973,"#ff0d69"
985368812743573506,DavilaROscar,7,0,1,1,0.397893,0.329036,0,"#ffb800"
758006606214918144,GallardBedmar,1,0,1,1,0.347861,0.748732,0,"#b6cb00"
965531807532900352,farto_david,36,0,1,1,0.557854,0.384637,0,"#825403"
996081023359311872,de_economica,7,0,1,1,0.40638,0.331215,0,"#ffb800"
781525610552258560,mokketch,7,0,1,1,0.417432,0.32662,0,"#ffb800"
804172410463232000,GeoBrujas,55,1,1,2,0.585402,0.551257,0.000486,"#cb3f32"
1081418799780372480,Arcoiris326,7,0,1,1,0.428519,0.323716,0,"#ffb800"
939812011159977984,tax_sociology,7,0,1,1,0.426945,0.321128,0,"#ffb800"
791706973372678144,CELLColmex,7,0,1,1,0.397321,0.32577,0,"#ffb800"
881698125668331522,RLadiesSantiago,49,1,0,1,0.355166,0.449009,0,"#ff7007"
899719025265041409,SergeMMuseum,7,0,1,1,0.411532,0.193878,0,"#ffb800"
829749537233330176,colabora_hd,55,32,14,46,0.549271,0.477996,0.021887,"#cb3f32"
827568002304446464,bicifastmun,38,0,2,2,0.540058,0.424809,0.000486,"#662859"
1063108464904331264,SmaccEducacion,7,0,1,1,0.427495,0.210792,0,"#ffb800"
1058381888023339009,Cahumada5,22,0,1,1,0.373564,0.20309,0,"#00e8b2"
1000098663547506688,DanWilhelmBA,34,0,2,2,0.460182,0.400242,0.000486,"#ff0d69"
1070971166641270785,GopalJi24188512,14,0,1,1,0.650366,0.609868,0,"#00eeff"
994053919092477953,LGZ33834109,14,0,1,1,0.635449,0.577984,0,"#00eeff"
1119167012398194690,canalull,22,24,0,24,0.623161,0.582106,0.011187,"#00e8b2"
4697130480,cest16vie,38,0,1,1,0.125546,0.818832,0,"#662859"
722080359689621504,manuoviedo15,38,0,1,1,0.150056,0.810187,0,"#662859"
731917608178593792,AyAlejita,38,0,1,1,0.143866,0.81689,0,"#662859"
1034856806252769280,soyvaljeje19,38,0,1,1,0.132112,0.814432,0,"#662859"
1035010392345522177,MariLudopata,38,0,1,1,0.119841,0.807906,0,"#662859"
830130240793899009,redmarsit1,34,0,2,2,0.472892,0.410483,0.000486,"#ff0d69"
1018404504138670081,Laura_AriasR,14,0,1,1,0.314131,0.707198,0,"#00eeff"
705321287959248900,ADiBa__,14,1,1,2,0.334657,0.701862,0.000486,"#00eeff"
750709075223179264,EditorialUTadeo,38,0,2,2,0.567379,0.403412,0.000486,"#662859"
1082600503001911296,IECanarios,22,1,3,4,0.603481,0.59431,0.001459,"#00e8b2"
1260216964359864327,itsarolsen,2,1,0,1,0.399718,0.550477,0,"#ffa64e"
944205640032976896,mig_cb,38,0,1,1,0.108894,0.807258,0,"#662859"
4308919169,Ramador72vico,22,0,2,2,0.629986,0.627071,0.000486,"#00e8b2"
1082584342621237250,sandra_boto,13,0,1,1,0.401346,0.484233,0,"#3bec00"
1000792948252999682,IEML_,9,0,1,1,0.790607,0.411406,0,"#008f7b"
943495770673688581,diegomezvenegas,14,0,2,2,0.568488,0.497086,0.000486,"#00eeff"
974302227497177090,AnRoro2,30,0,1,1,0.462227,0.617148,0,"#ff77ff"
1154309696888721408,cibera,30,1,0,1,0.426095,0.491109,0,"#ff77ff"
1044874796507508737,andreacobo_art,14,0,1,1,0.579598,0.452818,0,"#00eeff"
742363989670252545,cledlsp,19,0,3,3,0.569095,0.459081,0.000973,"#00d3ff"
1079786909835190272,DAH_Europe,19,3,0,3,0.55044,0.471536,0.000973,"#00d3ff"
958218534546534405,CarolineCaos,36,0,1,1,0.533721,0.308856,0,"#825403"
710123736175783938,sectest9,0,0,2,2,0.530823,0.429101,0.000486,"#8ecfec"
700416747229351936,epihum,30,37,2,39,0.558676,0.540333,0.018482,"#ff77ff"
885870624207491073,emepemperete,34,0,1,1,0.548174,0.348879,0,"#ff0d69"
778042183236542464,VictorLpezMtz,49,0,5,5,0.457686,0.461297,0.001946,"#ff7007"
929071471464538112,zurbaran_centre,22,0,1,1,0.512923,0.610083,0,"#00e8b2"
878517811219496960,Gonzohervas,22,0,3,3,0.542485,0.583414,0.000973,"#00e8b2"
1014875433521893379,OficinaEquidad,56,5,6,11,0.389153,0.162015,0.004864,"#384205"
1000792483935195136,abofemchile,56,0,1,1,0.376584,0.097359,0,"#384205"
1323299706211045378,Abofem1,56,1,0,1,0.38345,0.09939,0,"#384205"
741300005798051840,acelgatenues,14,0,1,1,0.78337,0.456004,0,"#00eeff"
4634988073,_perroTuerto,13,2,4,6,0.52471,0.494797,0.002432,"#3bec00"
1016774817419325442,Ameli_CA,49,1,0,1,0.348744,0.611151,0,"#ff7007"
1040262846549041152,mujermodernaUCM,30,8,3,11,0.483382,0.526928,0.004864,"#ff77ff"
710827854657929217,tirademarketing,30,0,1,1,0.51333,0.728268,0,"#ff77ff"
772719688497434624,CFIDT_UNED,30,8,16,24,0.518091,0.533737,0.011187,"#ff77ff"
828536712842313728,SCC_UNED,30,1,0,1,0.493749,0.653073,0,"#ff77ff"
883241073467944960,MartaCollFlorit,14,0,1,1,0.641206,0.581321,0,"#00eeff"
829782776463384576,IsisReneeCampos,34,7,1,8,0.41164,0.453892,0.003405,"#ff0d69"
900244494431531010,perufe10,1,0,1,1,0.410966,0.615191,0,"#b6cb00"
1066309163796570113,baena_melisa,30,0,2,2,0.477489,0.796417,0.000486,"#ff77ff"
1057184168419962880,cehme1,7,1,1,2,0.490349,0.09707,0.000486,"#ffb800"
731551301230809089,atilionqn,49,0,1,1,0.340829,0.54852,0,"#ff7007"
906154332445302784,Claousya,34,0,2,2,0.491188,0.408139,0.000486,"#ff0d69"
1046593589952811008,CelinaR11260790,34,0,2,2,0.365336,0.434216,0.000486,"#ff0d69"
906992618961358848,WHGazetteer,49,1,0,1,0.385105,0.539066,0,"#ff7007"
1060151720934825984,CEComparatistas,36,1,3,4,0.564068,0.484197,0.001459,"#825403"
782908894817517568,MKTP_expedition,37,1,0,1,0.618971,0.339603,0,"#006032"
965621075316035584,Universia,49,4,0,4,0.542222,0.498548,0.001459,"#ff7007"
1167973646272475136,ucavila,37,1,0,1,0.634405,0.34584,0,"#006032"
1013707692819599360,iArqUM,37,1,0,1,0.614119,0.334366,0,"#006032"
4736648201,postdoc_es,37,1,0,1,0.62654,0.347931,0,"#006032"
931971118516375552,FundacionPalarq,37,0,2,2,0.63998,0.404459,0.000486,"#006032"
823621524368293889,sunshinenini,38,0,1,1,0.671962,0.363321,0,"#662859"
999666791923290113,EstudiarEnEsp,37,1,0,1,0.623007,0.333139,0,"#006032"
705833096332124161,AJIenAE,37,1,0,1,0.61554,0.331451,0,"#006032"
762293491116441600,Alba_DFG,37,0,2,2,0.645674,0.410673,0.000486,"#006032"
929307954242904064,JuanCarCastil,58,0,1,1,0.567546,0.71821,0,"#005076"
768078412602826752,polifoniaurbana,58,0,1,1,0.560297,0.715926,0,"#005076"
1034359439866912768,SumaInnova,22,0,2,2,0.606709,0.520922,0.000486,"#00e8b2"
799976839104045057,SINDE_UCSG,22,0,1,1,0.602248,0.613637,0,"#00e8b2"
963986721514905600,LuluuuLil,14,0,2,2,0.569632,0.499015,0.000486,"#00eeff"
1019964088963817472,JaviMen85446969,13,0,3,3,0.458172,0.442351,0.000973,"#3bec00"
899738033087492100,MariaNievesVid1,20,0,2,2,0.42747,0.150491,0.000486,"#f0be45"
746319949858283521,danta_dany,30,0,1,1,0.621549,0.480999,0,"#ff77ff"
752062881487814656,imvectech,0,0,1,1,0.432296,0.378835,0,"#8ecfec"
804632977519112192,CongresoHDH2017,14,133,44,177,0.521591,0.542065,0.085603,"#00eeff"
787323204075393025,UncoveringC,14,0,5,5,0.540898,0.48265,0.001946,"#00eeff"
995018503605424128,morforetem,1,0,2,2,0.510452,0.689267,0.000486,"#b6cb00"
739100156721778688,NutriPatri360,14,0,1,1,0.612914,0.467972,0,"#00eeff"
1000481395821641731,giemmardelplata,49,1,1,2,0.835674,0.312028,0.000486,"#ff7007"
776579967060676608,RevMenocchio,34,1,5,6,0.470393,0.49911,0.002432,"#ff0d69"
1032695932939329536,BogotaNaranja,38,0,1,1,0.667294,0.361151,0,"#662859"
1025711423970848768,GeneracionNu,55,4,3,7,0.57476,0.508318,0.002918,"#cb3f32"
1063577470555836416,samaranto,35,0,1,1,0.418109,0.159888,0,"#00faff"
1244756976313212929,SirJaron,22,2,0,2,0.513379,0.558731,0.000486,"#00e8b2"
939366927335555072,Guarengue,49,1,0,1,0.3786,0.66827,0,"#ff7007"
773202019406516225,even_partners,49,1,0,1,0.373628,0.679972,0,"#ff7007"
976583424457756672,decanatofahe,42,2,0,2,0.744487,0.468358,0.000486,"#66e087"
4897204209,DPE_CSIC,22,4,4,8,0.580042,0.539646,0.003405,"#00e8b2"
911158053025828865,ModLangQMUL,13,1,0,1,0.341433,0.333225,0,"#3bec00"
938000555070427137,pau_riba,14,1,1,2,0.623562,0.585362,0.000486,"#00eeff"
763382415121346560,Aleccrin,14,0,4,4,0.532385,0.465468,0.001459,"#00eeff"
753168134526427136,onetandem,22,1,0,1,0.618798,0.639509,0,"#00e8b2"
4927222775,FilosofiaUsal,58,1,5,6,0.501658,0.589628,0.002432,"#005076"
4927160571,EconomiaUsal,58,0,5,5,0.502546,0.604422,0.001946,"#005076"
809870543109427200,cgonzalezroman,30,0,3,3,0.523118,0.595251,0.000973,"#ff77ff"
4827210033,ILG_USC,30,3,6,9,0.52628,0.542421,0.003891,"#ff77ff"
872751722300624896,CampCultDigital,22,0,1,1,0.602764,0.617802,0,"#00e8b2"
832008080384745476,BonaudiCecilia,49,0,5,5,0.425293,0.515805,0.001946,"#ff7007"
901150486103035905,ZulemaBeltrami,49,0,2,2,0.460731,0.718155,0.000486,"#ff7007"
1004769274450337792,CAUCrue,36,2,1,3,0.601053,0.455492,0.000973,"#825403"
1043769283740946437,CidRodrigoVivar,14,0,2,2,0.64951,0.56374,0.000486,"#00eeff"
717020586912980993,lacamaradelarte,14,1,1,2,0.658391,0.565606,0.000486,"#00eeff"
984906483413417990,yolbordajandi,14,1,0,1,0.316151,0.709673,0,"#00eeff"
1031567418433458177,andreamarti92,14,1,0,1,0.311154,0.702411,0,"#00eeff"
1047477664959881216,VerticeUNAM,7,2,0,2,0.532673,0.216022,0.000486,"#ffb800"
4496967314,GIS_Sharer,15,0,1,1,0.516857,0.696628,0,"#008ebb"
706134962756517889,GobAbiertoSF,49,0,1,1,0.402147,0.518915,0,"#ff7007"
845221137445474304,comicarchitect,7,1,0,1,0.788818,0.62837,0,"#ffb800"
930866749930688519,ImagenyMemoria,3,0,1,1,0.586064,0.709193,0,"#ffb3ff"
707664369883156480,DatalabUnr,49,0,2,2,0.421292,0.558657,0.000486,"#ff7007"
1049362890258632705,circulo_e,37,0,1,1,0.561886,0.62265,0,"#006032"
827156848478261248,fosterc_upv,22,3,1,4,0.624867,0.478947,0.001459,"#00e8b2"
704365692712329220,envejezando,22,0,2,2,0.647691,0.474209,0.000486,"#00e8b2"
893544491088568320,SilviaEP1972,14,0,1,1,0.650426,0.555943,0,"#00eeff"
907861206563729408,CatedraCTR,2,0,1,1,0.390819,0.547917,0,"#ffa64e"
721758002357866496,souto_esther,30,4,3,7,0.558969,0.55177,0.002918,"#ff77ff"
4325976913,LARRLASA,38,5,0,5,0.49958,0.443739,0.001946,"#662859"
756491211553251328,liberalazul,22,0,3,3,0.572504,0.578935,0.000973,"#00e8b2"
4363999037,diazfranciscoj6,42,6,2,8,0.779303,0.443162,0.003405,"#66e087"
846014785246367745,Fisher85M,8,5,0,5,0.668843,0.325538,0.001946,"#00ed5d"
708996369713905664,INDI_viladecans,8,5,11,16,0.668098,0.333905,0.007296,"#00ed5d"
921999862199128064,ElisendaCarrera,8,1,0,1,0.685885,0.262325,0,"#00ed5d"
764867611687542784,XavierLesauvage,8,1,0,1,0.687923,0.252479,0,"#00ed5d"
709014593826324480,thomashaensli,14,1,0,1,0.602594,0.461142,0,"#00eeff"
948536322226053120,gjescudero,22,3,5,8,0.494513,0.602488,0.003405,"#00e8b2"
1437675525611286529,satdeepgill,49,2,0,2,0.417203,0.479974,0.000486,"#ff7007"
960569458434760704,EUBlockchain,38,1,0,1,0.544265,0.371828,0,"#662859"
4879355015,balancedemasa,22,0,2,2,0.649054,0.473841,0.000486,"#00e8b2"
788495163039551488,Art_es_visuales,30,3,0,3,0.537593,0.642462,0.000973,"#ff77ff"
855126004301484036,PeriodicosMinas,36,0,1,1,0.528956,0.279576,0,"#825403"
968946380684300288,PENVenezuela,42,0,1,1,0.850993,0.426021,0,"#66e087"
824587705694687234,JosePingarro,30,1,0,1,0.587698,0.559325,0,"#ff77ff"
926098176456531968,GmoCoronado,10,0,1,1,0.318881,0.483036,0,"#52d7c0"
1001450135166111744,wsRebiun17,14,5,5,10,0.606645,0.572427,0.004377,"#00eeff"
768077613445373954,actuaeducacion,37,1,0,1,0.674793,0.390811,0,"#006032"
4823004303,PostRayo,13,0,3,3,0.409044,0.371094,0.000973,"#3bec00"
860496962222792705,Societies_HET,34,0,1,1,0.465737,0.376145,0,"#ff0d69"
943101339156041729,CaleidoscopeEye,13,0,1,1,0.624565,0.438813,0,"#3bec00"
961332696940208128,67Indo,42,0,4,4,0.734773,0.435813,0.001459,"#66e087"
834355206481727488,2020Galdos,30,0,1,1,0.576263,0.549868,0,"#ff77ff"
932371339968679941,MoNique_05018,13,0,1,1,0.340587,0.49765,0,"#3bec00"
847543632311836672,Amrosillo2017,13,0,1,1,0.399699,0.368668,0,"#3bec00"
966759765706756096,OISDMexico,7,0,2,2,0.542998,0.413485,0.000486,"#ffb800"
912774837659152384,CViCom_UNAM,7,0,1,1,0.699912,0.316135,0,"#ffb800"
1044528442476298242,iuqoem,22,0,2,2,0.545646,0.519086,0.000486,"#00e8b2"
4749643519,LorienTinuviel,34,0,4,4,0.491658,0.454316,0.001459,"#ff0d69"
1009229204628570113,laurasa91010767,38,0,1,1,0.677286,0.33994,0,"#662859"
913433610576900096,Isabelcortes72,22,0,3,3,0.574867,0.605852,0.000973,"#00e8b2"
950662568292610049,IDEESpain,22,0,1,1,0.594668,0.619704,0,"#00e8b2"
744162157223378945,ManuscritsMidi,22,0,1,1,0.376197,0.600963,0,"#00e8b2"
1009002213178519552,atalisfunding,22,13,1,14,0.609709,0.463503,0.006323,"#00e8b2"
747843141215064064,artecoles,42,11,14,25,0.625919,0.487045,0.011673,"#66e087"
1004609041870524417,rodriguezgafaro,42,0,1,1,0.901628,0.436611,0,"#66e087"
803363552643911681,JoseEnvirology,22,0,2,2,0.6473,0.469763,0.000486,"#00e8b2"
1004020685654691841,raicex_es,22,0,2,2,0.633144,0.465195,0.000486,"#00e8b2"
759459172614279172,edita_us,38,3,0,3,0.523539,0.472435,0.000973,"#662859"
721916342828343297,technofeminism,14,0,15,15,0.522289,0.478544,0.006809,"#00eeff"
1032326923991572480,CollMonton,22,0,2,2,0.628937,0.4669,0.000486,"#00e8b2"
734077157081812993,SHNB_BSHNB,22,0,2,2,0.605657,0.529087,0.000486,"#00e8b2"
964195560424198145,zemagj,22,0,1,1,0.663694,0.478308,0,"#00e8b2"
840859293096255492,ObservaUSAL,22,0,1,1,0.646121,0.459186,0,"#00e8b2"
906525317405298689,Datopersonal,34,0,1,1,0.556455,0.350008,0,"#ff0d69"
985173337184899072,espdercomercial,34,0,1,1,0.558483,0.351286,0,"#ff0d69"
852983958883237888,NelsonRemolina,34,0,1,1,0.543379,0.351892,0,"#ff0d69"
1008250478688374784,CulturaCDMX,7,9,0,9,0.681054,0.388605,0.003891,"#ffb800"
779299908515926017,BurmanPhD,34,0,6,6,0.370423,0.451745,0.002432,"#ff0d69"
769245416714039301,turizo_va,34,0,1,1,0.567414,0.338089,0,"#ff0d69"
884145923307302912,ideas_libertad,42,2,2,4,0.764726,0.46947,0.001459,"#66e087"
790680762987130880,HistoriaPublica,34,0,1,1,0.318794,0.414273,0,"#ff0d69"
742860255890157568,LacruzMaria,7,0,1,1,0.487417,0.69739,0,"#ffb800"
854454295890186240,aqmoncaleano,13,0,2,2,0.541686,0.429802,0.000486,"#3bec00"
837265565358129152,CompluL,30,0,1,1,0.622061,0.611509,0,"#ff77ff"
964349018170994688,JavierR61777086,34,0,3,3,0.475468,0.418992,0.000973,"#ff0d69"
1013449771892269056,adun_la,49,0,1,1,0.417727,0.782158,0,"#ff7007"
941771614487764992,MarionaGumpert,8,0,2,2,0.651765,0.293732,0.000486,"#00ed5d"
1227559057109798913,marionaral,8,1,0,1,0.655123,0.248812,0,"#00ed5d"
914487773356322819,BiblioGoyena,55,0,1,1,0.684513,0.633679,0,"#cb3f32"
790920450473766917,VinculacionTam,17,0,2,2,0.734005,0.35223,0.000486,"#ff9cc7"
825038278583779328,SEDECO_TLAXCALA,17,0,1,1,0.631523,0.285099,0,"#ff9cc7"
968103524117565441,CANIETI_Tabasco,17,0,1,1,0.623704,0.27576,0,"#ff9cc7"
948971961635438593,Amoyotl1,17,0,1,1,0.633054,0.275246,0,"#ff9cc7"
977941605624827904,agenciadecomun2,13,0,1,1,0.450066,0.372472,0,"#3bec00"
741985517810638849,BarcaFanCo,14,0,2,2,0.372955,0.459323,0.000486,"#00eeff"
956553133139914754,reflexiones_fcs,49,1,0,1,0.420568,0.641202,0,"#ff7007"
922922852885651456,luchodata,14,0,1,1,0.684752,0.516764,0,"#00eeff"
752066504829665280,ate_teologas,49,0,1,1,0.179926,0.635172,0,"#ff7007"
1002147850636185601,GrupoUhu,31,4,4,8,0.488279,0.640318,0.003405,"#3e93ff"
956581163916779520,josesucrep,49,0,2,2,0.296494,0.629542,0.000486,"#ff7007"
988603092890513408,SantiagoMacasv2,42,0,1,1,0.719582,0.449389,0,"#66e087"
704548944169332736,FFHistorians,30,0,1,1,0.435325,0.624505,0,"#ff77ff"
931558302651166720,presentacionami,22,0,1,1,0.569145,0.620569,0,"#00e8b2"
897658519666610176,PetrinaJackso,34,0,1,1,0.345779,0.431198,0,"#ff0d69"
884503786626195457,TurnedPageist,34,0,1,1,0.328464,0.425994,0,"#ff0d69"
1018198968981811201,tec_cb,34,0,3,3,0.443917,0.447901,0.000973,"#ff0d69"
940487377121939457,OriolMedieval,58,0,1,1,0.453297,0.64661,0,"#005076"
848857444671524866,PMedievistes,22,1,0,1,0.551269,0.649755,0,"#00e8b2"
818970347924049921,MaruTerrones,7,0,1,1,0.372437,0.299547,0,"#ffb800"
987469699662434306,Was_Ihr_Wollt,4,0,1,1,0.369228,0.437494,0,"#f4c8cf"
700985095335899137,LFG_Hist,4,0,1,1,0.371897,0.438428,0,"#f4c8cf"
917320811656163328,SomosFuturoUSAL,58,0,1,1,0.465513,0.652887,0,"#005076"
959052022526894081,LangstonReview,34,0,1,1,0.321828,0.414687,0,"#ff0d69"
1198985379015282690,frane_la,21,2,0,2,0.330173,0.495367,0.000486,"#c6cc85"
874036736766210048,mi_delta,1,0,1,1,0.413849,0.621934,0,"#b6cb00"
720597847050092544,Recogito,49,1,0,1,0.399236,0.526487,0,"#ff7007"
1029001489929461760,Jesus_QPro,49,1,0,1,0.355135,0.690083,0,"#ff7007"
988862056978886659,nabecitasube,55,0,5,5,0.649311,0.671809,0.001946,"#cb3f32"
727875505698054144,EgresadosFIC,55,14,0,14,0.660503,0.648476,0.006323,"#cb3f32"
764074078324023296,DeptoBiol,55,0,5,5,0.65817,0.667927,0.001946,"#cb3f32"
988206607493410816,Paulina22160300,55,0,1,1,0.677876,0.559308,0,"#cb3f32"
772440726085001217,Mancini_Epic,55,0,7,7,0.653065,0.663646,0.002918,"#cb3f32"
931906726424731649,Ds_Pol_As,31,10,6,16,0.555193,0.526526,0.007296,"#3e93ff"
925402082529742848,LPelaya,55,0,1,1,0.766956,0.635092,0,"#cb3f32"
717055881569959936,UT_HistDept,34,5,6,11,0.446304,0.445466,0.004864,"#ff0d69"
933833250740539392,lenguayciencia,58,1,0,1,0.56383,0.662589,0,"#005076"
959520639282446336,JimenaDuqueB,53,0,1,1,0.590406,0.7567,0,"#008bdd"
1024398395220393984,AEF_UdelaR,55,0,5,5,0.654398,0.663458,0.001946,"#cb3f32"
1498945219584221188,mhbeals,34,10,0,10,0.499285,0.481315,0.004377,"#ff0d69"
4774959796,RafaelaJaramani,42,0,4,4,0.677361,0.439918,0.001459,"#66e087"
1003249425144254464,GestoresU,55,0,1,1,0.645853,0.67253,0,"#cb3f32"
721810921702694913,GestionFarma,49,0,2,2,0.333903,0.579378,0.000486,"#ff7007"
997147935459627008,UBAposgrados,49,5,5,10,0.347387,0.568207,0.004377,"#ff7007"
876862123992895488,biblioravignani,49,0,1,1,0.314311,0.539863,0,"#ff7007"
980653330933473280,MarthaIsabelGm3,53,0,2,2,0.52202,0.719685,0.000486,"#008bdd"
709794770311376897,johnrbto,13,1,0,1,0.405259,0.425289,0,"#3bec00"
977186999227551745,AladaaArgentina,49,5,0,5,0.260438,0.534202,0.001946,"#ff7007"
746745388225470464,s_salas16,22,0,1,1,0.518851,0.666669,0,"#00e8b2"
740575410489004032,Jho_jhoadelgado,53,0,1,1,0.533205,0.761812,0,"#008bdd"
915008277615955969,phybrah,7,0,2,2,0.3811,0.348288,0.000486,"#ffb800"
831626471022149634,bloodravenlib,34,0,1,1,0.308299,0.418731,0,"#ff0d69"
4497416116,motolibrarian,34,0,1,1,0.309704,0.405707,0,"#ff0d69"
4578717256,predmedhub,58,0,2,2,0.471759,0.503997,0.000486,"#005076"
4923591933,GeoHistoUsal,58,1,1,2,0.511332,0.583715,0.000486,"#005076"
4927248976,MedicinaUsal,58,1,0,1,0.501826,0.610519,0,"#005076"
705830353630588929,filo_uba,49,1,0,1,0.296239,0.582251,0,"#ff7007"
786576462556127233,ULA_DTES,42,12,5,17,0.674912,0.412409,0.007782,"#66e087"
1250018230254604288,ZiziChan,42,24,0,24,0.676996,0.436302,0.011187,"#66e087"
4839876503,LindaBrandt23,49,0,3,3,0.44362,0.503591,0.000973,"#ff7007"
771333813779697664,crisetxeandia,31,0,1,1,0.648788,0.501336,0,"#3e93ff"
920240592235515905,DSDimensions,30,1,0,1,0.615107,0.685785,0,"#ff77ff"
907668867555758080,myanesp,19,0,1,1,0.686349,0.831375,0,"#00d3ff"
857031255677960193,IUDIGITAL,9,1,0,1,0.711954,0.755447,0,"#008f7b"
987412476496105472,barcosinaia,19,3,3,6,0.636949,0.654691,0.002432,"#00d3ff"
1000791860498063360,RafaelR2498,57,5,1,6,0.693179,0.521321,0.002432,"#b66f7a"
802539406242549760,RunaArchivos,49,0,1,1,0.385823,0.585062,0,"#ff7007"
1013755133023457280,Jesvel_412,58,0,1,1,0.451136,0.64795,0,"#005076"
4902060670,fomIoT,49,1,0,1,0.359556,0.602996,0,"#ff7007"
701794095920975873,argenopratula,42,0,1,1,0.707021,0.439514,0,"#66e087"
910652608599048192,web__topia,13,0,1,1,0.383412,0.421595,0,"#3bec00"
4781290467,teruriru_,42,1,0,1,0.724521,0.406966,0,"#66e087"
1008111805061844992,Claudet57773067,36,0,2,2,0.563697,0.209155,0.000486,"#825403"
870313301686857728,LuzHSarmiento,34,0,1,1,0.605145,0.316882,0,"#ff0d69"
901306180810756097,Helena77Hdez,34,0,1,1,0.602355,0.313411,0,"#ff0d69"
820685168646225920,ADELAALONSOGA,22,0,1,1,0.382902,0.191512,0,"#00e8b2"
974931204184117248,noeliagtoyos,22,0,1,1,0.391572,0.19638,0,"#00e8b2"
998366657222496256,Jaz18330340,30,0,1,1,0.682933,0.622795,0,"#ff77ff"
947184972485492736,Auxilia24292128,42,0,1,1,0.749002,0.417542,0,"#66e087"
1014538707288784896,tech_espanol,42,0,1,1,0.747687,0.412187,0,"#66e087"
910894473684676609,Julio90582535,30,0,1,1,0.683912,0.614389,0,"#ff77ff"
928568712311066624,Historisas,30,0,1,1,0.693839,0.605773,0,"#ff77ff"
4923178515,gcardax,34,0,4,4,0.44005,0.4705,0.001459,"#ff0d69"
727397578392875008,flavio_figallo,31,2,0,2,0.481565,0.605627,0.000486,"#3e93ff"
987372033712508928,VincentDebiais,30,0,1,1,0.651016,0.574772,0,"#ff77ff"
985550654943965189,jabrahamleon,42,0,1,1,0.715076,0.458599,0,"#66e087"
861956941693759490,seminariodhaula,42,0,1,1,0.705583,0.450562,0,"#66e087"
738037466276474880,AlexanderTurton,34,0,2,2,0.372206,0.436099,0.000486,"#ff0d69"
952988847012491265,vdelpentagrama,38,13,6,19,0.507636,0.501968,0.008755,"#662859"
769210120764923906,boell_etics,49,1,0,1,0.362675,0.647897,0,"#ff7007"
843865704805912576,mibibliotecarev,58,2,2,4,0.455899,0.627747,0.001459,"#005076"
1010530114696773635,MeGustaLaMsica2,38,0,2,2,0.566575,0.454832,0.000486,"#662859"
897806432359284740,Yazmary5,42,0,2,2,0.752202,0.450306,0.000486,"#66e087"
835113857706254336,RistoVilkko,13,0,1,1,0.39477,0.387116,0,"#3bec00"
923169106853007362,petroccoc17,42,0,2,2,0.648156,0.385267,0.000486,"#66e087"
751012035878612992,SpectralDH,14,0,1,1,0.302419,0.375869,0,"#00eeff"
737416794068025346,redeschilenas,49,0,4,4,0.366955,0.463405,0.001459,"#ff7007"
710516875894104064,alejzubeldia,31,0,1,1,0.639627,0.521646,0,"#3e93ff"
733320756206034945,raquel_riro,13,0,5,5,0.46123,0.414756,0.001946,"#3bec00"
804893018255859718,jaoh__,13,0,1,1,0.47672,0.387028,0,"#3bec00"
770988007209959425,lindsayvantine,34,0,5,5,0.480629,0.437046,0.001946,"#ff0d69"
977815143420743680,elaheh_yaseri,49,0,1,1,0.35993,0.48056,0,"#ff7007"
961019458142855168,lajular,22,1,2,3,0.571347,0.609104,0.000973,"#00e8b2"
923269061399674880,vilar_la,22,6,2,8,0.560753,0.59138,0.003405,"#00e8b2"
831573560313384966,CEHA2018,14,8,2,10,0.573764,0.559632,0.004377,"#00eeff"
847872828267536386,Franck_Akouete,22,0,1,1,0.590991,0.684125,0,"#00e8b2"
992104013758976000,almabar10,1,1,0,1,0.472897,0.622273,0,"#b6cb00"
728271798882729984,lydileyva,1,0,3,3,0.465171,0.607617,0.000973,"#b6cb00"
842143812701032449,RedeSaudeRS,36,0,1,1,0.556605,0.19334,0,"#825403"
953293605338263553,Jhonson_Catari,42,0,1,1,0.628958,0.668626,0,"#66e087"
1468877539607207939,jaimegilrobles,37,1,0,1,0.55696,0.76102,0,"#006032"
706547402338148352,FIJET_Spain,49,1,0,1,0.375341,0.62998,0,"#ff7007"
963462969408540673,25estrellafugaz,8,0,3,3,0.681218,0.294109,0.000973,"#00ed5d"
882563270539870208,StrategicWays,8,0,10,10,0.643314,0.339655,0.004377,"#00ed5d"
834206716216635393,ZaidaGa08304346,37,0,1,1,0.513637,0.900625,0,"#006032"
954386280946728961,Zaida56823640,37,0,1,1,0.510568,0.898585,0,"#006032"
804631178561069056,sussanna__,37,0,1,1,0.507734,0.896595,0,"#006032"
964291262248574976,gpdmx,13,0,1,1,0.418588,0.425966,0,"#3bec00"
924935619175952384,AgentisMK,49,1,0,1,0.362394,0.636128,0,"#ff7007"
757616743854604289,Manuel_emorales,49,3,0,3,0.446354,0.735595,0.000973,"#ff7007"
978302948320129026,Argeliaferrere,42,0,2,2,0.730993,0.39001,0.000486,"#66e087"
945708606409846784,profecerebrito,31,0,2,2,0.616489,0.500654,0.000486,"#3e93ff"
759604489951248384,tecnoanato_UBA,49,0,2,2,0.359317,0.565894,0.000486,"#ff7007"
850061556234817536,DLibatique10,34,0,3,3,0.482684,0.422921,0.000973,"#ff0d69"
971790355195678722,HumanidadesOrt,34,1,0,1,0.433374,0.426307,0,"#ff0d69"
956938693666922501,NancyRHernadez,49,1,0,1,0.418559,0.635877,0,"#ff7007"
957465361674272769,AlianzaJovenVer,10,0,2,2,0.325991,0.47713,0.000486,"#52d7c0"
1213445666732593153,egarciagarcia,8,2,0,2,0.658008,0.298594,0.000486,"#00ed5d"
800698962504130560,revistaeviterna,14,4,4,8,0.544492,0.480249,0.003405,"#00eeff"
737074151735709697,BiblioCowan,49,0,1,1,0.364898,0.494216,0,"#ff7007"
724972714201591808,EduHarlem,49,1,0,1,0.380279,0.522213,0,"#ff7007"
899818437362372608,aisera_ai,37,0,1,1,0.449983,0.612342,0,"#006032"
985449725276184576,ARTISbd,14,0,3,3,0.588801,0.509438,0.000973,"#00eeff"
741579771100995584,EnJarras,22,0,3,3,0.501378,0.578806,0.000973,"#00e8b2"
702579704042233856,JordanTzvetkov,22,0,1,1,0.583319,0.631311,0,"#00e8b2"
1445482112191123466,MedialabPrado,30,16,0,16,0.595393,0.573309,0.007296,"#ff77ff"
991842783836229635,wakanoticias1,42,0,1,1,0.989111,0.364383,0,"#66e087"
977033679867346944,LaVozDeClioUN,38,0,1,1,0.550077,0.354537,0,"#662859"
743091420202819584,MADIC_UAMC,13,1,0,1,0.544724,0.409397,0,"#3bec00"
769629395262771200,html_css_bot,30,0,1,1,0.566786,0.593165,0,"#ff77ff"
1466094633344196620,wornikay,19,1,0,1,0.58426,0.764506,0,"#00d3ff"
735165892426903552,informacionytic,49,0,8,8,0.439716,0.546054,0.003405,"#ff7007"
985275092912496640,viajesmexmiamor,13,0,1,1,0.753405,0.632764,0,"#3bec00"
921328266652405760,GcLegal_es,31,0,3,3,0.637454,0.546225,0.000973,"#3e93ff"
988847888234090502,Pobresdiablos80,38,0,1,1,0.752784,0.454881,0,"#662859"
818849058164973568,miguelhuertam,38,0,1,1,0.745113,0.4589,0,"#662859"
972584442928816130,CharoJi93710291,31,0,3,3,0.644502,0.545081,0.000973,"#3e93ff"
748058404313239552,TaniaSafuraAdam,8,8,3,11,0.629851,0.321886,0.004864,"#00ed5d"
941035279238025216,DH_at_Tufts,34,0,2,2,0.476946,0.399936,0.000486,"#ff0d69"
949162266708070400,UTEDerechoyCCSS,22,0,1,1,0.57192,0.840726,0,"#00e8b2"
831478754975309824,reinventharse,49,1,0,1,0.353591,0.657584,0,"#ff7007"
909697060823343104,pintofscienceMX,13,0,4,4,0.451092,0.391052,0.001459,"#3bec00"
878635037280923648,SocialCoachDACH,34,0,1,1,0.34405,0.400777,0,"#ff0d69"
733056822408581120,thinkdesignmcr,49,0,1,1,0.294824,0.640276,0,"#ff7007"
890741419777896450,ChicasTicAR,49,0,1,1,0.76461,0.82072,0,"#ff7007"
768631765456064512,_analema,38,0,2,2,0.559626,0.400253,0.000486,"#662859"
722343875315154944,ehualumni,22,1,0,1,0.544342,0.779499,0,"#00e8b2"
979322475497623552,pereirasergioba,37,0,2,2,0.542442,0.679847,0.000486,"#006032"
950544994661797888,sirmetalboy,38,1,0,1,0.145019,0.814443,0,"#662859"
4481327296,AgilitixToCloud,49,1,0,1,0.33825,0.670701,0,"#ff7007"
734160304301613056,wideinitiative,49,1,0,1,0.320591,0.666574,0,"#ff7007"
698226643232538624,CenturyHotelMx,7,0,4,4,0.448827,0.407309,0.001459,"#ffb800"
946202158889828352,_FromThePage_,49,1,1,2,0.449982,0.409894,0.000486,"#ff7007"
4803098175,apsanchez_,14,3,2,5,0.548567,0.449949,0.001946,"#00eeff"
866324865640534017,divulga_club,22,0,2,2,0.490661,0.676665,0.000486,"#00e8b2"
778413114790334464,mediber_digest,30,0,2,2,0.487187,0.599814,0.000486,"#ff77ff"
767026861104852992,micaligeia,49,0,1,1,0.384083,0.578677,0,"#ff7007"
991534452047216645,Van83241316,36,0,2,2,0.514492,0.323239,0.000486,"#825403"
859122675456847873,mcmartinezg,8,0,10,10,0.656158,0.335086,0.004377,"#00ed5d"
830094660815220736,Revolucio4,8,4,9,13,0.659429,0.284245,0.005837,"#00ed5d"
702547842649464834,Cambra_ee,8,2,0,2,0.534653,0.469525,0.000486,"#00ed5d"
834405799598366721,UHertsResearch,34,0,2,2,0.459683,0.388824,0.000486,"#ff0d69"
913096031809806342,CristofolT,8,2,0,2,0.676375,0.264319,0.000486,"#00ed5d"
918153998162714626,canalimasi,3,5,2,7,0.780529,0.744322,0.002918,"#ffb3ff"
835107281725341696,_gypsy16,3,0,1,1,0.842632,0.743269,0,"#ffb3ff"
905485960133177344,_Impaciencia_,31,5,10,15,0.62053,0.518276,0.006809,"#3e93ff"
711710800977604609,librariesval,34,0,2,2,0.375119,0.4514,0.000486,"#ff0d69"
791318842085605376,UdelarExtension,55,3,0,3,0.670635,0.632873,0.000973,"#cb3f32"
982366752532320256,IvanGarciaCale4,49,1,0,1,0.403638,0.669678,0,"#ff7007"
752533186622685185,HumanidadesM13,42,0,1,1,0.811527,0.451253,0,"#66e087"
807199955618332672,dhoy_web,22,0,2,2,0.587852,0.579463,0.000486,"#00e8b2"
841300935548764160,vicenurr,42,0,1,1,0.909591,0.434338,0,"#66e087"
891648414848569345,codex_lab,55,0,1,1,0.600525,0.430454,0,"#cb3f32"
790614393528737797,DavidSanchezTIC,49,1,0,1,0.332667,0.601326,0,"#ff7007"
746700659290939393,earlymusproject,22,8,4,12,0.642077,0.694442,0.00535,"#00e8b2"
847990438871093249,AnyelaAraque,42,0,1,1,0.715829,0.442003,0,"#66e087"
4857164218,Talentum,49,1,0,1,0.338054,0.661888,0,"#ff7007"
712506146410610688,namrathrock,49,1,0,1,0.336367,0.608873,0,"#ff7007"
987370454615838720,pbalbuenap,31,1,0,1,0.62815,0.504,0,"#3e93ff"
867300646839517184,medtec4susdev,22,0,2,2,0.670564,0.647758,0.000486,"#00e8b2"
759339672329940996,cantoriamusic,22,0,3,3,0.650917,0.699876,0.000973,"#00e8b2"
924256549635227648,Isabel2075,22,0,2,2,0.673198,0.640799,0.000486,"#00e8b2"
941830233509920771,MnicaBentez12,14,0,3,3,0.549627,0.50716,0.000973,"#00eeff"
834432423878336513,XarxaRecerCaixa,14,4,6,10,0.597177,0.574014,0.004377,"#00eeff"
783958646493437952,LegalibooPRO,49,2,0,2,0.42818,0.622272,0.000486,"#ff7007"
834518452232675338,puertasdemurcia,22,0,3,3,0.644611,0.702113,0.000973,"#00e8b2"
940526293090742272,DoctoratUB,22,0,3,3,0.553366,0.496785,0.000973,"#00e8b2"
981431762806018048,int3ns4m3nt3,13,0,2,2,0.494184,0.344195,0.000486,"#3bec00"
918748087195197440,Civihudi,30,5,4,9,0.505453,0.541155,0.003891,"#ff77ff"
4909252079,FundacionCEDCS,30,9,9,18,0.546159,0.466775,0.008268,"#ff77ff"
894563851139731458,21dejunioFeuu,55,0,1,1,0.706686,0.661683,0,"#cb3f32"
946237547834994689,historia_mora,7,0,1,1,0.394989,0.354883,0,"#ffb800"
4712275153,GeodinamicsInfo,49,1,0,1,0.36483,0.688846,0,"#ff7007"
839214983288344576,itxaso_deotazu,49,4,0,4,0.430387,0.588543,0.001459,"#ff7007"
826532634679443456,editorial_uci,49,1,0,1,0.359637,0.725767,0,"#ff7007"
925932472772149248,unsojo,34,0,2,2,0.469167,0.409724,0.000486,"#ff0d69"
933011580941488135,ACT_MX,34,0,2,2,0.501185,0.408614,0.000486,"#ff0d69"
865140893308907520,StefanieBll,22,0,2,2,0.594506,0.589842,0.000486,"#00e8b2"
755854671953080320,prf1z,30,6,3,9,0.476488,0.536014,0.003891,"#ff77ff"
843909056062459905,hipotecasingas1,49,1,0,1,0.42354,0.650607,0,"#ff7007"
864378011940003840,GTProgramari,22,1,1,2,0.592334,0.649011,0.000486,"#00e8b2"
737759344188624897,msdeandres5,30,0,1,1,0.678395,0.616123,0,"#ff77ff"
861128690188603392,welcomeylejws,49,1,0,1,0.384509,0.675333,0,"#ff7007"
932825404611727360,RoboticaUG,31,0,1,1,0.667511,0.54964,0,"#3e93ff"
4876577320,murielgpUOC,14,0,2,2,0.561575,0.483535,0.000486,"#00eeff"
885988160378982401,ed_coralnegro,1,3,7,10,0.488176,0.548023,0.004377,"#b6cb00"
758332604999430145,AmericanAffrs,0,1,0,1,0.528015,0.40583,0,"#8ecfec"
716980029108969472,movilnetcaleta,49,1,0,1,0.35888,0.694771,0,"#ff7007"
870339645372084226,marijovanni,38,0,2,2,0.56105,0.444738,0.000486,"#662859"
851073924670656512,ConstitucionalU,49,1,0,1,0.413183,0.641557,0,"#ff7007"
858977877324378112,CaribeNostrum,1,0,6,6,0.475232,0.555038,0.002432,"#b6cb00"
851570514267176961,GettMexico,49,1,0,1,0.413834,0.670576,0,"#ff7007"
885828374274469888,FrersSofia,49,1,0,1,0.329001,0.630507,0,"#ff7007"
744315056175874048,eugetsukino,34,0,4,4,0.494901,0.440269,0.001459,"#ff0d69"
705930570887520256,DrMartinSanto,13,0,4,4,0.470741,0.496192,0.001459,"#3bec00"
725385283802390531,Digital_HD_TIC,49,14,31,45,0.496499,0.540527,0.021401,"#ff7007"
910987778208366593,RDesaparecidosT,49,1,0,1,0.347527,0.677139,0,"#ff7007"
735036497058009088,pablo_uex,22,0,2,2,0.554212,0.575657,0.000486,"#00e8b2"
946013227355435008,lingsev,1,2,3,5,0.469458,0.595753,0.001946,"#b6cb00"
856140599220744192,elalaweb,22,0,1,1,0.593002,0.599776,0,"#00e8b2"
907381241397301248,RosiBraidotti,7,1,0,1,0.502022,0.695161,0,"#ffb800"
969507098525618176,MarthaHanold,30,0,1,1,0.432696,0.65567,0,"#ff77ff"
1187899069777285120,AndresOyanedel,49,1,0,1,0.418917,0.67882,0,"#ff7007"
695313583413030913,Arqus_3D,14,5,2,7,0.575404,0.491653,0.002918,"#00eeff"
841684449448337408,InstCamoes,36,0,1,1,0.60931,0.40769,0,"#825403"
911266702654083074,Africanus1Esc,49,3,0,3,0.432598,0.600581,0.000973,"#ff7007"
700398412689235968,SergioTerrera,49,3,2,5,0.415304,0.613656,0.001946,"#ff7007"
850618954515087361,xx_asjs5201314,49,1,0,1,0.42827,0.661502,0,"#ff7007"
905342062157078528,BelGoGar,14,0,3,3,0.69052,0.53666,0.000973,"#00eeff"
1300286168290869248,artnodes,14,2,0,2,0.57532,0.503125,0.000486,"#00eeff"
864079421636038657,EmpresaTTD_UMA,14,0,3,3,0.691419,0.539356,0.000973,"#00eeff"
730813453246464001,MConstituciones,13,6,4,10,0.451778,0.427034,0.004377,"#3bec00"
761657540836990976,SantaFeVincula,49,0,1,1,0.407831,0.512557,0,"#ff7007"
855353890509901825,JordiRiveraBiz,49,1,0,1,0.333476,0.67273,0,"#ff7007"
789951799268696064,patbernado,49,1,0,1,0.322668,0.647694,0,"#ff7007"
930576485940940800,raul_palazzo,49,1,0,1,0.319452,0.655598,0,"#ff7007"
824030340473688064,PedroAl23763281,7,0,1,1,0.421559,0.234395,0,"#ffb800"
850261939347378176,ScanPhase,8,0,1,1,0.737672,0.307756,0,"#00ed5d"
1286761072444108803,javiesca,49,1,0,1,0.354103,0.645954,0,"#ff7007"
912983849751269376,mgl_vn,22,0,1,1,0.535516,0.646237,0,"#00e8b2"
717696249542082560,XOBBCoop,14,0,1,1,0.657681,0.578367,0,"#00eeff"
951497747311611904,CienciaAteneu,14,0,1,1,0.643793,0.57624,0,"#00eeff"
850698599117856769,duttanjan84,14,4,0,4,0.603951,0.587227,0.001459,"#00eeff"
882820116634849280,CyrusJOBrien,34,0,2,2,0.468771,0.413504,0.000486,"#ff0d69"
800734061937315840,RevBanking,49,1,0,1,0.40374,0.659771,0,"#ff7007"
963828007696846851,Esocite2018,49,0,3,3,0.454293,0.556916,0.000973,"#ff7007"
1229205068655628290,NohemaTorres,49,1,0,1,0.321925,0.6536,0,"#ff7007"
930483592009887745,taiarrano,49,7,1,8,0.473637,0.524621,0.003405,"#ff7007"
855860783863001090,JFSmith434,49,1,0,1,0.383155,0.530601,0,"#ff7007"
753299973022834688,mfressoli,49,1,3,4,0.429799,0.515946,0.001459,"#ff7007"
1383063807698857993,ahencyclopedia,14,10,0,10,0.460048,0.648707,0.004377,"#00eeff"
911504414673969152,dwebwordpress,22,0,2,2,0.594378,0.577079,0.000486,"#00e8b2"
4853978344,revistaatalanta,1,3,3,6,0.487384,0.573668,0.002432,"#b6cb00"
884776861737390081,shicheng17,49,1,0,1,0.413945,0.660955,0,"#ff7007"
772549162298671105,Josantoniogrccm,49,2,0,2,0.398131,0.588075,0.000486,"#ff7007"
740300185016795137,EjercitoyFAM,49,1,0,1,0.379193,0.687523,0,"#ff7007"
871449168035926017,ArepaHerald,49,1,0,1,0.42338,0.673262,0,"#ff7007"
948985250507522049,histhub,13,1,0,1,0.545784,0.401799,0,"#3bec00"
949243980482580481,Jorge45973683,36,0,1,1,0.554187,0.286799,0,"#825403"
969492711127490560,StacksCom,34,0,2,2,0.467519,0.42358,0.000486,"#ff0d69"
856528663478665217,albriciasjones,49,1,0,1,0.354182,0.628831,0,"#ff7007"
781858709840334849,monterodelossa1,49,1,0,1,0.375613,0.6595,0,"#ff7007"
775067852701327362,meals4hope,49,1,0,1,0.322417,0.65019,0,"#ff7007"
838144744236646403,VerocortsC2,49,1,0,1,0.383112,0.63227,0,"#ff7007"
995994829657010176,dibam_cl,21,164,0,164,0.269971,0.275193,0.07928,"#c6cc85"
1304967569338699781,BNNoticias,49,1,0,1,0.331845,0.655173,0,"#ff7007"
737338479269416960,SolGOBRU,21,0,2,2,0.278543,0.232319,0.000486,"#c6cc85"
852287392606302209,patrimoniosur,21,0,2,2,0.237056,0.222559,0.000486,"#c6cc85"
4654584375,_N_SG_,58,0,6,6,0.50827,0.560902,0.002432,"#005076"
729897613538033664,ILegatvs,21,0,3,3,0.373632,0.395927,0.000973,"#c6cc85"
911200497264152577,Cecs_18,58,0,2,2,0.490386,0.567867,0.000486,"#005076"
778185733978849281,3Existe,8,0,1,1,0.684751,0.311774,0,"#00ed5d"
716064510755344384,PedroPsantisg,21,0,2,2,0.240743,0.246115,0.000486,"#c6cc85"
948311831038365696,PauCordovaAg,21,0,3,3,0.275713,0.279468,0.000973,"#c6cc85"
785171316655714306,amoraleszambra,21,0,2,2,0.205126,0.266917,0.000486,"#c6cc85"
954522340553056256,VanessaPazMonc2,21,0,2,2,0.262528,0.22566,0.000486,"#c6cc85"
4311992716,cristianleonlun,21,0,2,2,0.244687,0.244486,0.000486,"#c6cc85"
777542557614084096,FestGlobaleBog,38,0,1,1,0.61975,0.354898,0,"#662859"
872962795419074562,MinervaElenaGl2,7,0,1,1,0.358447,0.326077,0,"#ffb800"
856524820749660161,prodsuroriente,30,0,1,1,0.349601,0.440183,0,"#ff77ff"
800681683301253121,losandesonline1,21,0,1,1,0.169627,0.247245,0,"#c6cc85"
874796647976488960,ClaudiaLoretoS4,21,0,1,1,0.200509,0.225887,0,"#c6cc85"
961586688203087872,Miguelsilvamel2,21,0,2,2,0.254467,0.230971,0.000486,"#c6cc85"
915973858389299200,e_millapi,21,0,1,1,0.207168,0.195312,0,"#c6cc85"
830132441906044931,CSuenos,21,0,2,2,0.249679,0.246354,0.000486,"#c6cc85"
950503649930891265,JUrrutiap,21,0,1,1,0.183044,0.215296,0,"#c6cc85"
4824427481,Pauly2016U,21,0,1,1,0.22684,0.204021,0,"#c6cc85"
954513210857664512,LocalGlobal0,21,0,1,1,0.18469,0.235927,0,"#c6cc85"
746045705576390656,Bienestar_USTA,29,0,1,1,0.361878,0.152705,0,"#1fab00"
956724320390270976,nav59703434,21,0,2,2,0.213303,0.242946,0.000486,"#c6cc85"
771733532540563458,EvocandoValpo,21,0,2,2,0.24045,0.253238,0.000486,"#c6cc85"
1268350093041766400,lop_christian,49,1,0,1,0.409153,0.646245,0,"#ff7007"
880444778256748545,RegionalGaceta,38,0,1,1,0.59443,0.341926,0,"#662859"
707278302139052032,paolabanegas82,49,1,5,6,0.492025,0.588261,0.002432,"#ff7007"
887453041133277185,MiguelSilvaMel1,21,0,1,1,0.261775,0.211221,0,"#c6cc85"
735067555363164160,pclaverie_fr,13,0,1,1,0.567971,0.298732,0,"#3bec00"
957431696017756160,MariaCaroRain1,21,0,2,2,0.273612,0.218595,0.000486,"#c6cc85"
954667477346250752,zavala_valdes,21,0,2,2,0.21228,0.247522,0.000486,"#c6cc85"
4703190758,laesede_sergio,21,0,2,2,0.237588,0.23552,0.000486,"#c6cc85"
961179713359220736,ConsulCubaRoma,43,0,1,1,0.712678,0.555933,0,"#fcae7e"
860341121867812864,CSorienteRM,21,0,1,1,0.18826,0.234545,0,"#c6cc85"
924438117662195712,LosAstrosyyo,38,0,1,1,0.592873,0.357476,0,"#662859"
868616695786745856,MichCroqAgua,21,0,2,2,0.279228,0.220874,0.000486,"#c6cc85"
1051338133642665984,chikpsuv,49,1,0,1,0.372162,0.665153,0,"#ff7007"
948368878694010880,ClaudiaZambra1,21,0,1,1,0.161716,0.223213,0,"#c6cc85"
937485905832660994,SurivValentin,49,1,0,1,0.352683,0.697665,0,"#ff7007"
866061714353250304,medusaglo,21,0,1,1,0.179578,0.22654,0,"#c6cc85"
697213681986334721,zerreitug73,21,0,2,2,0.21779,0.254952,0.000486,"#c6cc85"
868928393613643776,labo_lamop,22,7,3,10,0.510227,0.575247,0.004377,"#00e8b2"
856723205586919424,sm_kaylor,34,0,2,2,0.356088,0.402924,0.000486,"#ff0d69"
954291417991598080,Anto_fva,21,0,1,1,0.197152,0.234089,0,"#c6cc85"
719714265624637441,AlexisnicolasGv,21,0,1,1,0.231156,0.219923,0,"#c6cc85"
871149213660446720,LionsOsorno,21,0,1,1,0.216487,0.190753,0,"#c6cc85"
802038139472773120,monitikin,21,0,1,1,0.229437,0.196976,0,"#c6cc85"
937379203028340736,PekeOlmedo2017,21,0,1,1,0.192136,0.205173,0,"#c6cc85"
962212001329176576,umassocial,21,0,1,1,0.170629,0.18359,0,"#c6cc85"
807690096715714560,CulturaIquique,21,0,2,2,0.214644,0.229556,0.000486,"#c6cc85"
814824185969176576,LilyCon97677852,21,0,2,2,0.231108,0.230222,0.000486,"#c6cc85"
900378886076289025,NataliaRuizRN,13,0,1,1,0.534045,0.465128,0,"#3bec00"
954126426130829312,Bianca77217751,21,0,1,1,0.167726,0.239129,0,"#c6cc85"
843834202214817792,borquezvera,21,0,1,1,0.241073,0.210504,0,"#c6cc85"
756451478538158080,firinfunflay,21,0,2,2,0.205626,0.25473,0.000486,"#c6cc85"
921561704546340865,Jessyvalgal19,21,0,1,1,0.182477,0.223838,0,"#c6cc85"
897861574685315079,Camiflohez,21,0,1,1,0.183861,0.213124,0,"#c6cc85"
777217747470151680,ClaudiaAnativia,21,0,1,1,0.160266,0.219659,0,"#c6cc85"
823698730335502338,celularoja,21,0,1,1,0.211764,0.204053,0,"#c6cc85"
821076746971869184,BarbTapia,21,0,1,1,0.173792,0.222743,0,"#c6cc85"
952268839592628224,lumacoturismo,21,0,1,1,0.186569,0.221664,0,"#c6cc85"
837291102344470530,Paraqnololvides,21,0,2,2,0.213556,0.239978,0.000486,"#c6cc85"
879589331547152385,Polynatp,21,0,2,2,0.21892,0.25853,0.000486,"#c6cc85"
829347136827449344,AlquilaunaVida,49,1,0,1,0.418239,0.691806,0,"#ff7007"
790302438284820481,guzmangonzalezr,49,0,1,1,0.372745,0.515811,0,"#ff7007"
4530494241,EdoMexTrans,49,1,0,1,0.350143,0.662822,0,"#ff7007"
874732482469539840,fredericksen_a,31,0,1,1,0.604686,0.724227,0,"#3e93ff"
937378694561239041,AsnesMariela,41,0,4,4,0.331582,0.416247,0.001459,"#697b00"
803117033252528128,RedLDU,13,0,1,1,0.397618,0.468917,0,"#3bec00"
764237102322024448,rlimonb,13,0,1,1,0.516395,0.316399,0,"#3bec00"
953627978432380928,lanamap_iqfr,14,0,2,2,0.502001,0.660027,0.000486,"#00eeff"
701519435442556929,grupolipo,13,0,1,1,0.51661,0.321017,0,"#3bec00"
1125243956575391744,tximeletalua,49,1,0,1,0.378224,0.646085,0,"#ff7007"
933409926160019457,AguasTacarigua,49,0,2,2,0.418459,0.527651,0.000486,"#ff7007"
892839497888669696,AlabanzaDios301,49,2,0,2,0.416006,0.568837,0.000486,"#ff7007"
751067944814338048,AniCapitalGto,10,0,1,1,0.676364,0.803623,0,"#52d7c0"
904779336426942465,DiWorkBsAs,31,0,2,2,0.622012,0.53971,0.000486,"#3e93ff"
773157806979551233,IsloalPpn,22,0,2,2,0.569991,0.586468,0.000486,"#00e8b2"
776027851854274561,dan19bv78,49,1,0,1,0.39141,0.692048,0,"#ff7007"
933300562094968833,VictoriaEM25,49,1,0,1,0.346444,0.626604,0,"#ff7007"
771276424607100928,incentis_es,49,1,0,1,0.334639,0.69178,0,"#ff7007"
788050637074403328,agnes_dober,36,0,2,2,0.447206,0.474461,0.000486,"#825403"
919846244868124672,a_sallent,14,0,1,1,0.594783,0.592048,0,"#00eeff"
850625759890767874,aiyulila,49,1,0,1,0.379138,0.631013,0,"#ff7007"
786880001270513669,MadridTerapeuta,49,1,0,1,0.398376,0.688256,0,"#ff7007"
1489820544900169730,Yahra3,49,1,0,1,0.388072,0.678621,0,"#ff7007"
702813129940537344,martaelias898,30,0,1,1,0.701484,0.60797,0,"#ff77ff"
882793915073613824,rickammen,49,2,0,2,0.367139,0.582397,0.000486,"#ff7007"
739837097620713472,Humanidades_UHU,31,3,0,3,0.74358,0.473088,0.000973,"#3e93ff"
776493810167771136,boniatofeliz,15,0,1,1,0.652341,0.714494,0,"#008ebb"
4763181797,ErcavicaRomana,15,0,1,1,0.633505,0.711622,0,"#008ebb"
748232543980371968,charoespinosaro,1,0,2,2,0.720732,0.56079,0.000486,"#b6cb00"
816302824871096320,Func_CaidosVzla,49,2,0,2,0.38934,0.582643,0.000486,"#ff7007"
842010330964344832,juliansmanzano,1,0,2,2,0.728528,0.549455,0.000486,"#b6cb00"
715279071811395584,EnmariaDiaz,1,0,2,2,0.734125,0.550852,0.000486,"#b6cb00"
777475690526572544,grepettok,1,0,1,1,0.366319,0.548428,0,"#b6cb00"
825340661499097088,souto53,1,0,2,2,0.734953,0.556035,0.000486,"#b6cb00"
847450125290975233,Vicentallorisv1,1,0,2,2,0.721961,0.551634,0.000486,"#b6cb00"
712695469663776769,pgpnzalo1,1,0,2,2,0.717141,0.558177,0.000486,"#b6cb00"
804313212418162688,esparticipe,1,0,2,2,0.73018,0.553856,0.000486,"#b6cb00"
889432692403695618,raulgomegor,1,0,1,1,0.372556,0.557841,0,"#b6cb00"
4360821376,musacces,30,3,3,6,0.569857,0.651357,0.002432,"#ff77ff"
863125455997743109,ru_dgtic,13,0,1,1,0.496869,0.314238,0,"#3bec00"
1102080079947980800,JavierPerz4,49,1,0,1,0.350478,0.620471,0,"#ff7007"
946839734290124800,CryptoPeter23,49,1,0,1,0.323616,0.666137,0,"#ff7007"
918573193585192960,educalidad115,17,0,1,1,0.925,0.364803,0,"#ff9cc7"
1227708533078097921,comunicaunirio,36,5,0,5,0.501604,0.156053,0.001946,"#825403"
805760877236457472,natsilvapra,13,0,3,3,0.439745,0.440143,0.000973,"#3bec00"
914314425720389632,SaulValdezZepe1,17,0,1,1,0.928898,0.359593,0,"#ff9cc7"
883042810596921345,yuanalicia2017,49,1,0,1,0.335713,0.624735,0,"#ff7007"
917568957430878208,derechos_online,13,0,1,1,0.412667,0.484111,0,"#3bec00"
860058474440515584,MlchiorA,49,1,0,1,0.36827,0.666757,0,"#ff7007"
809878553005326336,ule_sabina,49,1,0,1,0.343249,0.65788,0,"#ff7007"
830046468220268544,py_patagonia,49,0,1,1,0.227535,0.695818,0,"#ff7007"
833015735853137923,MLorenaM09,49,0,1,1,0.239422,0.697489,0,"#ff7007"
732738213400444929,f5noticiasok,49,0,1,1,0.226049,0.691108,0,"#ff7007"
830751987427835906,Margari54276523,13,0,1,1,0.397927,0.498708,0,"#3bec00"
735168867237003264,cienciaespanola,49,1,0,1,0.355569,0.652968,0,"#ff7007"
721366701762330624,rorogopedagoga1,30,0,1,1,0.502158,0.625543,0,"#ff77ff"
856071812509302784,Anda_Labs,31,4,2,6,0.640472,0.553901,0.002432,"#3e93ff"
4866617265,SectorBancario,49,3,0,3,0.442294,0.550146,0.000973,"#ff7007"
818074561212252160,GuillerTol,49,1,0,1,0.3134,0.683479,0,"#ff7007"
724900130349002752,bdt_systems,30,0,1,1,0.473879,0.649917,0,"#ff77ff"
4849998257,aka_toms,34,0,2,2,0.480676,0.41608,0.000486,"#ff0d69"
900012307555680256,cqq297,49,1,0,1,0.329846,0.63794,0,"#ff7007"
781512273185701888,uremplea,24,0,1,1,0.159753,0.6309,0,"#ff9b8f"
725045451939008514,jdronegi,49,1,0,1,0.402864,0.631953,0,"#ff7007"
722492564906106881,FELAFACS2017,49,1,0,1,0.443322,0.666699,0,"#ff7007"
781521249877065728,entresiglos2016,30,3,1,4,0.486576,0.613842,0.001459,"#ff77ff"
794514251767578624,mmartinezUNED,13,0,1,1,0.402884,0.481199,0,"#3bec00"
895403622275706882,3CREUS,49,1,0,1,0.351237,0.643588,0,"#ff7007"
933692977398140928,HugoCordovaQuer,49,1,0,1,0.361494,0.600981,0,"#ff7007"
739153836091138048,eldocpes,22,0,1,1,0.713842,0.354717,0,"#00e8b2"
849992682063712257,lasandri2014,49,1,0,1,0.336859,0.682231,0,"#ff7007"
870410157687283713,charliecamf4,3,0,1,1,0.703456,0.698647,0,"#ffb3ff"
943863966744436736,ComUniKGlobal,49,1,0,1,0.423792,0.680464,0,"#ff7007"
760283296060346368,katholikosfeed,49,1,0,1,0.379353,0.692283,0,"#ff7007"
838876550342852609,zhen05732066,49,1,0,1,0.407572,0.667579,0,"#ff7007"
742027584251236354,eguerreroforero,49,1,0,1,0.434152,0.683079,0,"#ff7007"
712641368124952579,Suiphos,49,1,0,1,0.411068,0.67158,0,"#ff7007"
4877558602,minsaitbyindra,30,2,0,2,0.493656,0.606414,0.000486,"#ff77ff"
4812613709,PaulaBeneito,31,0,1,1,0.461221,0.585066,0,"#3e93ff"
743355849557454848,AIPrensaESP,49,2,0,2,0.411774,0.626265,0.000486,"#ff7007"
910485609596276736,GuadalquivirEXP,19,0,1,1,0.637077,0.633913,0,"#00d3ff"
748596047811907585,lordvidu1981,49,1,0,1,0.406292,0.650667,0,"#ff7007"
879485910106222592,CrowdsourceJM,34,0,2,2,0.375053,0.4191,0.000486,"#ff0d69"
705436363038982144,EcoEstiloEs,49,1,0,1,0.351339,0.689887,0,"#ff7007"
862623754433810432,ExpertoCDDUS,31,0,1,1,0.637907,0.506591,0,"#3e93ff"
707936345231073280,ResisteCDTM,49,1,0,1,0.397816,0.628142,0,"#ff7007"
800234479658803205,Clauditabara,49,1,0,1,0.318156,0.656538,0,"#ff7007"
859792305045241858,CriptoTendencia,49,1,0,1,0.390586,0.655207,0,"#ff7007"
887342293858099201,lucy24441469,49,1,0,1,0.342142,0.618211,0,"#ff7007"
719944150804783106,Mirthacrr,49,1,0,1,0.366271,0.69608,0,"#ff7007"
826648058813353986,cvxcdmx,49,1,0,1,0.349736,0.620501,0,"#ff7007"
859410658206658561,MStBon,55,0,2,2,0.67787,0.418567,0.000486,"#cb3f32"
723548208530624516,SamuelScaceres,58,0,3,3,0.406464,0.596081,0.000973,"#005076"
894108282729705472,AdorarDios,49,1,0,1,0.383488,0.657515,0,"#ff7007"
842670591178170368,zerepolbap,2,0,2,2,0.64669,0.723933,0.000486,"#ffa64e"
802201929237594112,edcrking,13,0,1,1,0.400228,0.44006,0,"#3bec00"
720237811694182400,LUZMASLUZLAB,13,0,1,1,0.433876,0.414892,0,"#3bec00"
823580680793837572,BolaMartinn,49,1,0,1,0.375557,0.637664,0,"#ff7007"
831844699442933760,delg_ftyd,58,0,2,2,0.475633,0.639143,0.000486,"#005076"
775777424734912512,CatalinaRozoL,49,0,1,1,0.394686,0.412381,0,"#ff7007"
794624893241425920,PorteroTriano,49,1,0,1,0.387442,0.664516,0,"#ff7007"
930364182771503104,CAEPIAconf,31,0,1,1,0.68256,0.544532,0,"#3e93ff"
908011513117634561,janalisa1992,49,2,0,2,0.426143,0.614993,0.000486,"#ff7007"
836948237261099008,Publik_WC,49,1,0,1,0.315282,0.66886,0,"#ff7007"
706907499874484224,tachikomauriel,13,1,0,1,0.503616,0.398251,0,"#3bec00"
766315242930528260,pensadorvisual,31,1,0,1,0.63871,0.529132,0,"#3e93ff"
930766052795060224,DAluHumUHU,31,1,0,1,0.715717,0.515216,0,"#3e93ff"
931316129687068673,Reypcuba,49,1,0,1,0.307751,0.637965,0,"#ff7007"
860144751173140480,CoeliPlatform,14,1,2,3,0.61894,0.487889,0.000973,"#00eeff"
817912330419929092,resendeprof,36,0,1,1,0.451651,0.265162,0,"#825403"
826550383027900418,DHIBeirut,49,1,0,1,0.36768,0.567349,0,"#ff7007"
822080925236416512,Storytel_ES,49,1,0,1,0.345583,0.648661,0,"#ff7007"
854785839045513219,AbrittaAlmendra,49,0,1,1,0.443923,0.729484,0,"#ff7007"
783881877564174336,ba_gch,13,1,0,1,0.469666,0.391941,0,"#3bec00"
732639007746740225,lorna1000ena,49,1,0,1,0.35325,0.604097,0,"#ff7007"
847297933531684865,LRLMrX1,49,0,1,1,0.441791,0.721065,0,"#ff7007"
702498705786736641,labdig_bcn,1,0,2,2,0.525862,0.614957,0.000486,"#b6cb00"
842033838385709057,seepluex,36,0,5,5,0.653766,0.463443,0.001946,"#825403"
849989337911623681,jesiwaits,49,1,1,2,0.450852,0.579448,0.000486,"#ff7007"
848674517903912960,HafezAladeem,49,0,1,1,0.41985,0.726727,0,"#ff7007"
852061368295579648,guillep128,49,0,1,1,0.432384,0.727379,0,"#ff7007"
775474080715767808,pagina12,49,1,0,1,0.421706,0.683129,0,"#ff7007"
842793924829876224,AnitaCorts2,49,4,0,4,0.422501,0.590379,0.001459,"#ff7007"
833384419108982784,Lola_Alberdi,22,1,0,1,0.622025,0.69538,0,"#00e8b2"
849576979812818944,Antonio11787842,19,0,2,2,0.570448,0.478811,0.000486,"#00d3ff"
846512734363701248,simon_martz,49,0,1,1,0.448887,0.731954,0,"#ff7007"
847984306089848832,SoledadPuglies1,49,0,1,1,0.417667,0.731507,0,"#ff7007"
846083488323457026,revista_Lume,49,1,0,1,0.347683,0.644279,0,"#ff7007"
702630809367388160,gra_enriques,14,1,0,1,0.555949,0.4733,0,"#00eeff"
847830526627065856,AndreaMarielDZ,49,0,1,1,0.439561,0.729737,0,"#ff7007"
740178241445593088,SuemiHiguchi,36,7,0,7,0.456002,0.417485,0.002918,"#825403"
1034787315456069635,tomi_gan,31,2,0,2,0.455385,0.366332,0.000486,"#3e93ff"
4892748939,cmidoctic,31,0,1,1,0.659047,0.547742,0,"#3e93ff"
4619684853,big_data_flow,49,0,5,5,0.506161,0.526205,0.001946,"#ff7007"
890977654362570752,xqing9192,49,1,0,1,0.358858,0.613652,0,"#ff7007"
865644160426008576,ClovisRomoCar,49,1,0,1,0.411987,0.644458,0,"#ff7007"
792519880188764160,herediabort,49,3,0,3,0.453966,0.553977,0.000973,"#ff7007"
854075300300369922,Richardocacerez,49,2,1,3,0.450176,0.682662,0.000973,"#ff7007"
734396658595794944,EvaBaez20,49,0,1,1,0.430785,0.72503,0,"#ff7007"
868103332765851649,LUISGEREZ17,49,1,0,1,0.348322,0.622757,0,"#ff7007"
849662381471014912,Isabella12483,49,0,1,1,0.442211,0.72543,0,"#ff7007"
776415496723795968,irturxiescritor,49,1,0,1,0.339199,0.665977,0,"#ff7007"
840922216204234752,CdV_Uruguay,49,1,0,1,0.343582,0.629371,0,"#ff7007"
848932675532591104,joanafacultad,49,0,1,1,0.428002,0.736533,0,"#ff7007"
849278732351176704,MaleSiles,49,0,1,1,0.428935,0.720237,0,"#ff7007"
847695009495138305,Edrev_lobert,49,0,1,1,0.423429,0.722549,0,"#ff7007"
893255594982989824,CocolisoDelSur,49,1,0,1,0.392792,0.677546,0,"#ff7007"
847458065041375232,FLaura27,49,1,1,2,0.441023,0.685014,0.000486,"#ff7007"
849027304412131328,Guadaferru,49,1,1,2,0.447553,0.683739,0.000486,"#ff7007"
775416288881631234,YsabelAZ,34,0,2,2,0.521911,0.402921,0.000486,"#ff0d69"
847286109109276674,JoaquinResio,49,0,1,1,0.431321,0.731444,0,"#ff7007"
844092075750674432,ZurriableLaura,49,1,1,2,0.438879,0.676732,0.000486,"#ff7007"
721031747161468928,arqueo_lucia,30,3,1,4,0.542613,0.558873,0.001459,"#ff77ff"
799625332005470209,AMenendezDeLaC1,58,1,5,6,0.536753,0.540292,0.002432,"#005076"
4852676956,MarijeHristova,22,0,2,2,0.564618,0.577677,0.000486,"#00e8b2"
744635256574218240,paco_ferrandiz,22,5,3,8,0.547149,0.564735,0.003405,"#00e8b2"
768808208131588100,AleDomuz,14,0,2,2,0.671865,0.566388,0.000486,"#00eeff"
707878128643874816,carnetdlis,49,0,3,3,0.470671,0.471923,0.000973,"#ff7007"
885923429743984640,WTMZaragoza,30,1,2,3,0.551905,0.661807,0.000973,"#ff77ff"
875808615080316928,no9_estudio,14,0,1,1,0.675218,0.50105,0,"#00eeff"
834043213438664711,LabDePeriodismo,49,2,0,2,0.426759,0.648627,0.000486,"#ff7007"
757772869048893441,Bitdharma,49,2,0,2,0.429598,0.644236,0.000486,"#ff7007"
876038253945737216,Fran_mocaj,58,0,1,1,0.563193,0.658816,0,"#005076"
847895329227894784,meruddock,49,0,1,1,0.429012,0.732299,0,"#ff7007"
847423884211011584,alemeraki,49,1,1,2,0.445362,0.68301,0.000486,"#ff7007"
847334338521845760,asyrasinfo,14,0,5,5,0.510916,0.575158,0.001946,"#00eeff"
856893351865593857,sicc__,30,0,2,2,0.559685,0.574838,0.000486,"#ff77ff"
910605178746884097,mercecumu,15,0,1,1,0.574413,0.621824,0,"#008ebb"
847446730463256576,CORINA_IFTS13,49,1,1,2,0.446928,0.678848,0.000486,"#ff7007"
723463126600015872,TIyEmpresa,49,1,0,1,0.385656,0.679767,0,"#ff7007"
902311193372749825,_MEMEMX,13,3,3,6,0.382268,0.414502,0.002432,"#3bec00"
849546970028965889,lisaheidi1992,49,1,0,1,0.370926,0.620252,0,"#ff7007"
790370490930044928,MoniHerrNog,55,1,2,3,0.698443,0.672221,0.000973,"#cb3f32"
748650858896850944,gianello_s,49,0,1,1,0.445944,0.727655,0,"#ff7007"
864366638614814725,PepCasalsPuig,14,0,1,1,0.693817,0.484295,0,"#00eeff"
4747704460,GloriaG89668633,49,1,0,1,0.334788,0.620148,0,"#ff7007"
846547239539486720,Angeles010853,17,0,1,1,0.945765,0.379424,0,"#ff9cc7"
1491463564137226250,villarreal2008,49,1,0,1,0.340679,0.642084,0,"#ff7007"
890329789944541184,CuVimx,0,4,0,4,0.30087,0.506861,0.001459,"#8ecfec"
828089642020909058,DisenoPublicoMx,14,0,1,1,0.701018,0.477231,0,"#00eeff"
1384426984474824706,CompostelaTm,22,2,0,2,0.602401,0.639182,0.000486,"#00e8b2"
866377333875380227,josefinanelis,49,1,0,1,0.345425,0.692643,0,"#ff7007"
1227832470315421696,Pepemusica,49,1,0,1,0.428849,0.685084,0,"#ff7007"
901066814066655232,NevioMacias,49,1,0,1,0.332226,0.623429,0,"#ff7007"
4813827021,InfografiasAM,49,1,0,1,0.366401,0.622976,0,"#ff7007"
851192674694688769,HelenJo26670377,49,1,0,1,0.337226,0.653607,0,"#ff7007"
857812574884188162,chucho_h,49,1,0,1,0.381774,0.635931,0,"#ff7007"
725372434925379584,MLopezGaldos,49,1,0,1,0.38473,0.671207,0,"#ff7007"
776129585612099584,Signa_Lab,14,0,1,1,0.602145,0.396563,0,"#00eeff"
732701748440268800,carla_traduc,14,0,2,2,0.57684,0.55313,0.000486,"#00eeff"
718826241940459520,RaulPlataZ,49,1,0,1,0.348307,0.602582,0,"#ff7007"
841258317443944450,VectorAcademy,49,1,0,1,0.309706,0.646959,0,"#ff7007"
1290078643289497605,antrophistoria,30,17,0,17,0.355827,0.540458,0.007782,"#ff77ff"
1267582414118948868,vzlapalmundo,49,1,0,1,0.327762,0.668742,0,"#ff7007"
833407603061305344,LetyAlderete66,17,0,1,1,0.928457,0.371996,0,"#ff9cc7"
888573126577188864,ozambranod,14,0,2,2,0.578143,0.652682,0.000486,"#00eeff"
700373535555002368,gperezedith,14,0,2,2,0.581379,0.651539,0.000486,"#00eeff"
818595161466949632,Chorizo_Leon,49,1,0,1,0.395525,0.625701,0,"#ff7007"
908033922965090307,EstanAbi,49,0,3,3,0.419665,0.536126,0.000973,"#ff7007"
1301940274512490496,rianocarlosa,38,1,0,1,0.140751,0.802018,0,"#662859"
739842532939595776,pdigitalnono,49,0,1,1,0.413436,0.605,0,"#ff7007"
884842172041834497,bibliocosmonaut,13,0,1,1,0.392772,0.405605,0,"#3bec00"
773239666996834305,BNMMArgentina,7,0,3,3,0.535184,0.416561,0.000973,"#ffb800"
747539648470257664,cvsa12,49,1,0,1,0.377905,0.63318,0,"#ff7007"
734026770907828226,AsesoresLorono,49,1,0,1,0.319669,0.616638,0,"#ff7007"
836910172807258113,edumkdigital,49,1,0,1,0.405941,0.658715,0,"#ff7007"
907885245952876544,MatchingChina,14,5,0,5,0.554833,0.510918,0.001946,"#00eeff"
766325954440466433,pokemon_trucos,49,1,0,1,0.36293,0.631293,0,"#ff7007"
4308265937,IntegracionLAC,22,0,1,1,0.543699,0.81462,0,"#00e8b2"
1055167336582393857,jocantaro,13,2,0,2,0.5317,0.433962,0.000486,"#3bec00"
868833847634518016,miyanda_pie,49,1,0,1,0.401953,0.62325,0,"#ff7007"
870507243078172673,CarmenT10152038,49,1,0,1,0.405255,0.683357,0,"#ff7007"
793827754663825408,GTPJurCri,38,0,1,1,0.691959,0.486674,0,"#662859"
1156562556628156416,Negociodigital_,49,2,0,2,0.41163,0.567349,0.000486,"#ff7007"
1251201745872654337,Hericela,49,1,0,1,0.339229,0.596049,0,"#ff7007"
823707565091618816,taxurosario,37,0,1,1,0.646872,0.375519,0,"#006032"
778537340000202752,oskpeiz,49,1,0,1,0.337795,0.642977,0,"#ff7007"
866642893045366784,Horitzontal,49,2,0,2,0.399239,0.582896,0.000486,"#ff7007"
726104983838556165,Ociolab,14,1,1,2,0.553241,0.574559,0.000486,"#00eeff"
791596705464606720,portizs,49,1,0,1,0.304507,0.653567,0,"#ff7007"
717927353268232192,ScalarHumanity,0,0,2,2,0.500444,0.428049,0.000486,"#8ecfec"
778184819473776641,hazteatring,0,0,1,1,0.418235,0.396434,0,"#8ecfec"
869614684491657218,EinarMonroy,49,1,0,1,0.383225,0.694614,0,"#ff7007"
761582912223514624,DrDiegoClemente,22,0,1,1,0.629967,0.721992,0,"#00e8b2"
1463536871246426115,Amarok99,49,1,0,1,0.306161,0.609733,0,"#ff7007"
796894030500073472,latfemnoticias,49,2,0,2,0.437526,0.55852,0.000486,"#ff7007"
852714573861924865,bencetazil,55,0,2,2,0.66408,0.675078,0.000486,"#cb3f32"
847436437095972864,LeticiaBiblio,49,0,2,2,0.449321,0.691708,0.000486,"#ff7007"
822516479639724032,arqdillinger1,13,4,28,32,0.436322,0.374128,0.015078,"#3bec00"
730591475948490752,Demojusticia,49,0,2,2,0.441794,0.689581,0.000486,"#ff7007"
879296967171608576,javiervelarrhh,49,1,0,1,0.363834,0.639988,0,"#ff7007"
787389844016205828,DigitalTalento,49,1,0,1,0.377299,0.615515,0,"#ff7007"
890161029535215616,adek_formacion,49,1,0,1,0.390563,0.630189,0,"#ff7007"
899018131116617728,camrod01,13,0,2,2,0.526579,0.443342,0.000486,"#3bec00"
796111454604840961,acadberjim75,17,0,1,1,0.902538,0.362158,0,"#ff9cc7"
941595748143190016,GppeVassallo,49,1,0,1,0.344167,0.673821,0,"#ff7007"
745233702238720000,vladimir_OB,49,1,0,1,0.406825,0.69179,0,"#ff7007"
4519056312,LetGoTorres,49,1,0,1,0.405793,0.65451,0,"#ff7007"
4821874216,noriega_vinces,49,1,0,1,0.371374,0.680797,0,"#ff7007"
852176345601912834,Moebiuss73,49,1,0,1,0.405941,0.687182,0,"#ff7007"
843080932672397312,carmenmdetoda,49,1,0,1,0.354965,0.633915,0,"#ff7007"
727170830313074688,joseluiskeynos,49,1,0,1,0.363317,0.650312,0,"#ff7007"
877922772466511877,CIESTAAM_UACh,31,3,4,7,0.639205,0.542021,0.002918,"#3e93ff"
874715235537608707,CED_ENALLT,13,1,0,1,0.559056,0.437492,0,"#3bec00"
789138156020838400,PiedraBezoar,13,0,1,1,0.480336,0.38745,0,"#3bec00"
4755800948,LaberintosFFyL,7,1,0,1,0.627457,0.434208,0,"#ffb800"
737713476949315584,hist_sua,7,0,3,3,0.451975,0.364805,0.000973,"#ffb800"
897642100942028800,6_Congreso,49,1,0,1,0.36792,0.59616,0,"#ff7007"
1183938329072586752,RepublicanosV,49,1,0,1,0.374736,0.655658,0,"#ff7007"
897442416499798016,letrasypixeles,37,0,1,1,0.311028,0.316628,0,"#006032"
750838611965337600,adrianaenelsur1,49,1,0,1,0.378722,0.649442,0,"#ff7007"
897207926548348928,AImusic0213,13,0,1,1,0.535897,0.411949,0,"#3bec00"
1167483704937254912,Colciencias,13,2,0,2,0.454616,0.427845,0.000486,"#3bec00"
726914155790266368,scientificomm,13,1,0,1,0.420304,0.296187,0,"#3bec00"
748992388098654209,Nvera68,30,0,2,2,0.509699,0.592069,0.000486,"#ff77ff"
713654591129329664,PilarAstier,49,2,0,2,0.437233,0.607619,0.000486,"#ff7007"
805050917242421248,jchrroux3,3,2,0,2,0.319572,0.513442,0.000486,"#ffb3ff"
758597002489896960,DHASA2017,3,2,0,2,0.328227,0.516426,0.000486,"#ffb3ff"
716469303755706368,BiblioBenitos,13,0,1,1,0.495101,0.363565,0,"#3bec00"
827456096461807616,digitalnfluencr,49,2,0,2,0.396957,0.567337,0.000486,"#ff7007"
804875871207256064,PedrazAlejandro,0,0,1,1,0.275509,0.554447,0,"#8ecfec"
848951671485067265,VMConstruccion,49,1,0,1,0.317165,0.667308,0,"#ff7007"
788346432096985088,GetaActualidad,49,1,0,1,0.338331,0.650371,0,"#ff7007"
4448924381,WlSHARS,30,0,1,1,0.598676,0.508349,0,"#ff77ff"
701834895140716544,AOMDopp,49,1,0,1,0.395799,0.636057,0,"#ff7007"
815289129734930432,Sr_Grasshoper,30,3,6,9,0.481254,0.536826,0.003891,"#ff77ff"
750306074377453568,Cristilacoqueta,49,1,0,1,0.298453,0.628034,0,"#ff7007"
772945704616620032,Info_Regiones,21,0,1,1,0.783145,0.5229,0,"#c6cc85"
807379842987540480,ManuRosalesEV,49,1,0,1,0.400722,0.656317,0,"#ff7007"
890550172308164608,SEmocionalTodos,49,1,0,1,0.343266,0.594508,0,"#ff7007"
854980228178989056,wabogado_qa,49,1,0,1,0.365548,0.635563,0,"#ff7007"
777409730843119616,Daniel_Valles_M,0,0,1,1,0.420895,0.393851,0,"#8ecfec"
842486621522006016,Xchei4,49,1,0,1,0.377884,0.681106,0,"#ff7007"
888535950946705409,Eduardo58009014,22,0,1,1,0.683118,0.566735,0,"#00e8b2"
783202970057998336,RadiOlavide,1,0,1,1,0.39031,0.548142,0,"#b6cb00"
719614206971158528,MundoClicVE,49,1,0,1,0.316497,0.66361,0,"#ff7007"
803604934335856644,Museo_Malaga,13,0,3,3,0.508605,0.463273,0.000973,"#3bec00"
801483294932140032,pensaralsur,49,1,0,1,0.390732,0.63488,0,"#ff7007"
787925474366324736,emediterraneas,30,0,1,1,0.61886,0.613962,0,"#ff77ff"
880380240811491329,ineseUNOMAS,22,0,2,2,0.602809,0.525662,0.000486,"#00e8b2"
829271118913605633,ISSI_UNED,30,0,7,7,0.537159,0.564584,0.002918,"#ff77ff"
862660928977993730,XICongresoAISO,30,2,0,2,0.482213,0.587826,0.000486,"#ff77ff"
1241436270812946438,GastonGilabert,30,1,0,1,0.476251,0.635088,0,"#ff77ff"
763093245379407873,TEGO_es,58,0,1,1,0.228242,0.521128,0,"#005076"
826052209234296832,Begoablasco1,2,0,1,1,0.465518,0.512444,0,"#ffa64e"
878001913924653057,diegoparra10011,30,0,2,2,0.526879,0.667382,0.000486,"#ff77ff"
858657986792886272,JORGEIBAGUE1954,38,0,1,1,0.656731,0.343521,0,"#662859"
781447697282830337,ProjectBigData,49,2,0,2,0.392396,0.585612,0.000486,"#ff7007"
4786036942,dLoCaribbean,34,9,2,11,0.457922,0.25488,0.004864,"#ff0d69"
876253276324474880,uns_gott,49,1,0,1,0.333829,0.612558,0,"#ff7007"
4854421157,ArchivoCesar,38,0,1,1,0.65772,0.34783,0,"#662859"
812612476638470144,cobos1320,49,1,0,1,0.368618,0.605138,0,"#ff7007"
4806660015,Aisromar,31,0,1,1,0.653646,0.553969,0,"#3e93ff"
756219998809489408,GeografiaUCLM,22,0,2,2,0.54371,0.591436,0.000486,"#00e8b2"
833789723135078400,audioliteratura,30,0,1,1,0.627307,0.615756,0,"#ff77ff"
788109822826782720,MOlvidadas,30,0,1,1,0.616514,0.609261,0,"#ff77ff"
804668087433887744,OVTTenglish,31,1,2,3,0.578346,0.500217,0.000973,"#3e93ff"
4616619615,gabiricardes,49,1,0,1,0.398626,0.64535,0,"#ff7007"
4904934442,Learnandgrownow,49,1,0,1,0.423895,0.638692,0,"#ff7007"
807575637678358528,nesyrangel,17,0,1,1,0.915592,0.37383,0,"#ff9cc7"
4883271261,iOSMovil1,49,1,0,1,0.411953,0.648629,0,"#ff7007"
788638336424349696,estrellafugazfa,17,0,1,1,0.896343,0.376407,0,"#ff9cc7"
854663390333218816,ALSoberana,21,2,0,2,0.360382,0.538224,0.000486,"#c6cc85"
4425308297,mjesusye,22,0,1,1,0.577282,0.629648,0,"#00e8b2"
1454436282701160451,SoleSophia,49,1,0,1,0.347465,0.619829,0,"#ff7007"
821065763691921408,USReadyOrg,34,0,1,1,0.471656,0.190911,0,"#ff0d69"
800857822196092931,congresoageuam,22,0,1,1,0.656157,0.408685,0,"#00e8b2"
766775243314724864,HybrisMx,30,0,1,1,0.622743,0.615179,0,"#ff77ff"
838715023404969985,AprSinFronteras,49,1,0,1,0.383093,0.703564,0,"#ff7007"
968928033326460929,consejocultura,21,2,0,2,0.308294,0.452725,0.000486,"#c6cc85"
4689976094,luisgrigolatto2,49,0,3,3,0.408293,0.505334,0.000973,"#ff7007"
853112532965502976,LysGodecas,49,1,0,1,0.339795,0.670646,0,"#ff7007"
865761637000761344,PrimigeniosRC,38,0,1,1,0.613367,0.353038,0,"#662859"
4736089527,toniconejo72,22,0,1,1,0.527686,0.711892,0,"#00e8b2"
4484331509,FabriVGD,22,0,1,1,0.516747,0.713678,0,"#00e8b2"
724021489943629824,Albaaliq1,49,1,0,1,0.354569,0.624422,0,"#ff7007"
714874767904530432,ScratchBogota,38,0,2,2,0.498884,0.738118,0.000486,"#662859"
714862584957177857,ColombiaScratch,38,0,2,2,0.494016,0.735437,0.000486,"#662859"
4901992523,FunIxmatic,38,0,2,2,0.486681,0.737104,0.000486,"#662859"
4693356288,ShirleyGmezR2,38,0,2,2,0.501669,0.7102,0.000486,"#662859"
761964983018283008,CarlosASantanaV,38,0,1,1,0.42065,0.749927,0,"#662859"
4482351500,academicosdeba4,17,0,1,1,0.892712,0.370318,0,"#ff9cc7"
845086118991347712,CristinGranado,38,0,1,1,0.412522,0.774757,0,"#662859"
707651139475542016,BenetGimenez,49,1,0,1,0.395312,0.687929,0,"#ff7007"
842398993950867456,carlitross81,38,0,1,1,0.449422,0.769901,0,"#662859"
704764818352443393,FernandoLuisPi2,38,0,1,1,0.400169,0.758444,0,"#662859"
865356657001418753,jomirouve,38,0,1,1,0.44675,0.76111,0,"#662859"
717518059066540033,DaniloNunezGil,38,0,1,1,0.449519,0.780057,0,"#662859"
789662414346260480,Roegil22,38,0,1,1,0.46619,0.789805,0,"#662859"
868322483715411973,MrGroserito,38,0,1,1,0.421214,0.756012,0,"#662859"
812142045523509250,_sandymar88,38,0,1,1,0.431835,0.76254,0,"#662859"
775747664168292352,BDIMedieval,22,0,2,2,0.520405,0.589205,0.000486,"#00e8b2"
798717971233443840,SilviaNoble20,17,0,1,1,0.914559,0.360804,0,"#ff9cc7"
816285077432844289,QPEV_,49,1,0,1,0.354906,0.638596,0,"#ff7007"
792311374303129600,mastercompdig,14,0,2,2,0.583124,0.597027,0.000486,"#00eeff"
714551842240266241,_nitzaira,30,2,1,3,0.425589,0.583102,0.000973,"#ff77ff"
864945337160617984,lararrllrrhh,49,1,0,1,0.429657,0.689206,0,"#ff7007"
746721892510248964,RicardoOsunaEs,17,0,1,1,0.916278,0.369866,0,"#ff9cc7"
859741324060360704,DLGMA_CSIC,22,4,0,4,0.552341,0.579173,0.001459,"#00e8b2"
4864248826,AlulaDC,38,1,1,2,0.608561,0.349212,0.000486,"#662859"
794000553789521920,cercheguec,49,1,0,1,0.372839,0.670586,0,"#ff7007"
781484233311264768,MilagrosLetras,14,0,7,7,0.559769,0.520125,0.002918,"#00eeff"
845399399870160896,LuisalenCamach1,38,0,1,1,0.617289,0.364821,0,"#662859"
4527942557,ArchivaldoCali1,38,0,1,1,0.602256,0.35343,0,"#662859"
4863668801,Adriana85309773,49,1,0,1,0.33628,0.650682,0,"#ff7007"
699291195680432128,Catdelga2,19,1,1,2,0.615952,0.454463,0.000486,"#00d3ff"
817478777299050496,herna_santigo,22,0,4,4,0.647592,0.537035,0.001459,"#00e8b2"
1480483985402867714,saverome,22,3,0,3,0.640458,0.57126,0.000973,"#00e8b2"
824283486039273474,IsaacQuispeRoj2,0,0,2,2,0.441293,0.38142,0.000486,"#8ecfec"
751467875311947777,basque_design,22,2,0,2,0.554209,0.620942,0.000486,"#00e8b2"
732021373636362240,Noticias350,49,1,0,1,0.353221,0.670409,0,"#ff7007"
796466148866920448,eduardo_romanin,49,1,0,1,0.277858,0.64425,0,"#ff7007"
713785691185000448,creativa_la,49,1,0,1,0.377416,0.643982,0,"#ff7007"
782769466983591936,CLINICALTRIALSM,49,1,0,1,0.370748,0.698109,0,"#ff7007"
4872175437,SaraRepara,49,1,0,1,0.399917,0.698642,0,"#ff7007"
850548306891726848,zL5xo3MgbLFkxe1,49,1,0,1,0.33675,0.6374,0,"#ff7007"
1401155070583001091,jordi_casado,49,1,0,1,0.343069,0.606286,0,"#ff7007"
778682824492625921,isracontreras24,37,0,1,1,0.304671,0.321474,0,"#006032"
838879298178146305,FILU2017,13,1,0,1,0.404332,0.440796,0,"#3bec00"
857291074515193857,mpnaur,14,0,1,1,0.647076,0.595363,0,"#00eeff"
717392836094771201,Diversistemas,49,1,0,1,0.404599,0.679198,0,"#ff7007"
1325633905668608002,CulturalSanMar,49,19,0,19,0.444856,0.571664,0.008755,"#ff7007"
856754042638397440,histopublica,38,0,1,1,0.588654,0.46028,0,"#662859"
704656976710639617,OAStMarys,13,0,1,1,0.487702,0.360664,0,"#3bec00"
829780162971590656,JacobJo87195875,14,0,1,1,0.470134,0.726078,0,"#00eeff"
807589858831175680,XavierDapena,0,0,1,1,0.429897,0.382502,0,"#8ecfec"
719786945052811265,LiceusEmplea,30,1,0,1,0.556786,0.597858,0,"#ff77ff"
855127827267670021,DPI2017,36,0,1,1,0.401193,0.473717,0,"#825403"
821840498532958208,andrea_binsfeld,14,0,1,1,0.459781,0.723859,0,"#00eeff"
4847371541,VozRadioUV,13,2,0,2,0.421463,0.490506,0.000486,"#3bec00"
795928647706312704,LeidenDH,36,0,1,1,0.386989,0.484976,0,"#825403"
718181412264751104,vistahermosama1,13,5,6,11,0.389929,0.46944,0.004864,"#3bec00"
852538771828600832,mlbocanegra616,13,2,0,2,0.341935,0.457023,0.000486,"#3bec00"
780118482608324608,Juanjomartnez65,22,0,1,1,0.611579,0.596692,0,"#00e8b2"
763834843012567041,sarahvkemp,14,0,1,1,0.453983,0.725789,0,"#00eeff"
768452408108285952,ElObservadorWeb,49,4,0,4,0.444913,0.575125,0.001459,"#ff7007"
4593589425,HMPardo,49,1,0,1,0.319351,0.610043,0,"#ff7007"
750723632029130752,Electro_robot,49,1,0,1,0.369611,0.676206,0,"#ff7007"
786951537201381376,drha_uk,14,0,1,1,0.603749,0.488415,0,"#00eeff"
773299502514114560,JoseCas73595945,49,1,0,1,0.329253,0.643632,0,"#ff7007"
826516693979688960,increamento,49,1,0,1,0.404759,0.686362,0,"#ff7007"
848135427676569600,abogadocaldes,30,0,1,1,0.480277,0.648142,0,"#ff77ff"
750699783136899072,DiplomaLitUCH,49,0,2,2,0.384048,0.374723,0.000486,"#ff7007"
810816802552971264,ngmedel,49,1,0,1,0.399107,0.66578,0,"#ff7007"
735369648997335040,culturadigicat,31,0,1,1,0.651309,0.51276,0,"#3e93ff"
1185279558708162560,univ_paris13,14,1,0,1,0.322917,0.506305,0,"#00eeff"
1175180158992605184,Ceha5,2,1,0,1,0.484712,0.590794,0,"#ffa64e"
809866494683267073,ORAL_pub,13,0,1,1,0.431969,0.396128,0,"#3bec00"
800806042833518592,AinhoaRomeroRg1,49,1,0,1,0.306803,0.626651,0,"#ff7007"
821666958680719361,lsi_uned,30,11,3,14,0.535305,0.57857,0.006323,"#ff77ff"
729717485394595840,UNEDmasterInfor,30,11,0,11,0.54078,0.57992,0.004864,"#ff77ff"
841972470487871488,tll_UGR,31,0,1,1,0.655185,0.572396,0,"#3e93ff"
4847022646,roger_salmeron,8,0,1,1,0.603243,0.426455,0,"#00ed5d"
791197272902098944,CanalFONCE_UNED,30,0,4,4,0.534563,0.596989,0.001459,"#ff77ff"
4691873059,GCM_2016,49,1,0,1,0.390043,0.669051,0,"#ff7007"
743818785505820672,PaevExporta,49,1,0,1,0.335304,0.59018,0,"#ff7007"
793093764101255168,margot_suarezz,10,0,2,2,0.362389,0.521777,0.000486,"#52d7c0"
4533935619,_smartify,1,1,0,1,0.484661,0.793099,0,"#b6cb00"
787617680140357632,villa_subscribe,30,0,1,1,0.610161,0.648319,0,"#ff77ff"
838778915187539969,FloorKoeleman,22,0,1,1,0.597986,0.60974,0,"#00e8b2"
809124682888781824,Argentina2050,49,1,0,1,0.303183,0.64299,0,"#ff7007"
819325395019370496,PatriciaMeilan4,30,0,2,2,0.546452,0.633809,0.000486,"#ff77ff"
4449802275,pablorlMadrid,30,4,2,6,0.552341,0.611601,0.002432,"#ff77ff"
840899645761081345,trienioliberal,30,0,1,1,0.581687,0.676364,0,"#ff77ff"
718918213082419200,somostramontana,30,0,2,2,0.591891,0.594031,0.000486,"#ff77ff"
773468364593324036,sociocav_usal,58,0,1,1,0.259652,0.572219,0,"#005076"
802252005980930049,bibliojuande,30,0,1,1,0.606157,0.669962,0,"#ff77ff"
825834885642407936,upimeasda1971,49,1,0,1,0.397311,0.622076,0,"#ff7007"
749156600452149248,catherine_ccj,30,0,1,1,0.627598,0.682158,0,"#ff77ff"
711800924088492032,EncarnaValenzu1,30,0,1,1,0.579236,0.658488,0,"#ff77ff"
724048936084844544,asoccilniana,30,0,1,1,0.629671,0.685399,0,"#ff77ff"
4340153003,alfredopietraca,49,2,0,2,0.450087,0.588738,0.000486,"#ff7007"
828388748404674560,OriginOfDiana,13,0,1,1,0.481488,0.397647,0,"#3bec00"
4501457112,CerebroUrbanoMx,13,2,3,5,0.424669,0.475339,0.001946,"#3bec00"
836237326187560960,Educanal_es,22,0,1,1,0.584032,0.620771,0,"#00e8b2"
745923038907088898,ELevanteAlmeria,49,1,0,1,0.425854,0.676546,0,"#ff7007"
792049332090445824,DefLaCienArg,49,1,0,1,0.422359,0.650811,0,"#ff7007"
811220091182481408,JovenesDigital,49,1,0,1,0.308163,0.615542,0,"#ff7007"
740597963723046912,cultivarte21,14,0,2,2,0.571419,0.566616,0.000486,"#00eeff"
966134591051493377,CREOI_Senado,49,1,0,1,0.310173,0.634018,0,"#ff7007"
1245689624069980163,ManuelPascua,49,1,0,1,0.338765,0.620786,0,"#ff7007"
743258771435171840,namaste0104,49,1,0,1,0.335483,0.639701,0,"#ff7007"
4845124698,rsperez20161,49,1,0,1,0.311068,0.68562,0,"#ff7007"
1454453245657731077,MisteriosCo,49,1,0,1,0.367949,0.633735,0,"#ff7007"
777149576876793857,afmeuropa,49,2,0,2,0.401961,0.580716,0.000486,"#ff7007"
4698250537,enriquezabala68,49,1,0,1,0.309119,0.618763,0,"#ff7007"
4861240857,ovemundo,30,1,0,1,0.575209,0.74275,0,"#ff77ff"
825994415588200449,Arqueocarga,14,0,1,1,0.579286,0.595829,0,"#00eeff"
822241356336791553,Fendraliiz,49,1,0,1,0.35139,0.683077,0,"#ff7007"
832015834021240832,RedAmigos_Mx,49,0,1,1,0.358397,0.458745,0,"#ff7007"
741672109848416256,a_m_truitt,36,0,1,1,0.450127,0.595649,0,"#825403"
721282940018106368,Intajalimd,36,0,1,1,0.423309,0.57933,0,"#825403"
694890285101244416,PazFPalomeque,30,0,1,1,0.618714,0.653429,0,"#ff77ff"
740340062521593857,pablo_wegnerr80,49,1,0,1,0.309402,0.66983,0,"#ff7007"
770652249831923712,ElAcontecerCba,49,1,0,1,0.398849,0.699274,0,"#ff7007"
4500005659,profesoramador,49,1,0,1,0.327284,0.612202,0,"#ff7007"
809437758448107521,UCMJornadasDig,58,21,14,35,0.548861,0.568949,0.016537,"#005076"
1296559548568932353,JesusHoyos4,49,1,0,1,0.384032,0.642132,0,"#ff7007"
823598325563871233,RufeteRafael,30,0,1,1,0.617064,0.660234,0,"#ff77ff"
702491737256755200,LRoblesMacias,30,0,1,1,0.579557,0.66574,0,"#ff77ff"
4703907782,gemmagarfuertes,30,0,1,1,0.605372,0.659561,0,"#ff77ff"
751529501771833348,CMS_Law_Peru,49,1,0,1,0.404103,0.654938,0,"#ff7007"
4570351095,Ganoenlared,8,0,1,1,0.245538,0.277645,0,"#00ed5d"
745703935281930240,RitaMontelongo1,30,0,1,1,0.582317,0.660639,0,"#ff77ff"
819200745090273282,CulturaCubaVen,30,0,1,1,0.58094,0.667349,0,"#ff77ff"
4782521789,feetceuta,31,0,1,1,0.701704,0.511815,0,"#3e93ff"
827276374473740289,RuiOaxaca,22,0,4,4,0.416884,0.59584,0.001459,"#00e8b2"
804387181313855488,dartagio,49,1,0,1,0.356149,0.649356,0,"#ff7007"
754990081975410688,CRealConSusana,49,1,0,1,0.327042,0.622987,0,"#ff7007"
769315203636948992,elojonoticias,49,1,0,1,0.343117,0.603443,0,"#ff7007"
786682424545738752,LauraGCastaeda1,49,0,1,1,0.53693,0.736581,0,"#ff7007"
4912623718,EdicionesLiceus,49,1,0,1,0.388024,0.669856,0,"#ff7007"
1015227772686434305,EsHorizonte2020,31,1,0,1,0.652254,0.588749,0,"#3e93ff"
770724702847311872,Blas42262198,17,0,1,1,0.814978,0.233372,0,"#ff9cc7"
702309595432275969,Carlit0sPeanuts,17,0,1,1,0.814562,0.241402,0,"#ff9cc7"
826094041326559234,DynInvestment,17,0,1,1,0.821487,0.216689,0,"#ff9cc7"
819319460162961408,arturoarmando10,17,0,1,1,0.832244,0.225015,0,"#ff9cc7"
4764532092,GargolaDespier,14,0,1,1,0.618575,0.644124,0,"#00eeff"
4329351970,MariaTelegina,36,0,1,1,0.42971,0.592604,0,"#825403"
751504550566256642,steemiobot,49,1,0,1,0.34986,0.623025,0,"#ff7007"
821861314846785536,abev55,7,0,1,1,0.787414,0.315328,0,"#ffb800"
771428187951669249,ProspectivaAC,7,0,1,1,0.788644,0.322195,0,"#ffb800"
826490011377922049,ContornoUcec,17,0,1,1,0.800994,0.221396,0,"#ff9cc7"
762907536873762817,ZhakRdez,17,0,1,1,0.822204,0.223875,0,"#ff9cc7"
825463223679848448,dci_nuig,36,0,1,1,0.429561,0.585812,0,"#825403"
730111068480143361,Annvantgarde,36,0,1,1,0.427765,0.586923,0,"#825403"
4866908956,MayraElizondoC,7,0,1,1,0.40959,0.245048,0,"#ffb800"
4606646593,ShannaBressie,36,0,1,1,0.415625,0.588525,0,"#825403"
718636463932375042,henryblanco00,7,0,2,2,0.582547,0.398254,0.000486,"#ffb800"
703232689797767168,TNCDOPP,49,2,0,2,0.394922,0.566713,0.000486,"#ff7007"
4427445202,DHLab_UW,36,0,1,1,0.423448,0.568307,0,"#825403"
4660545148,VitalentConsul,49,1,0,1,0.427495,0.645317,0,"#ff7007"
795428989485645824,hlfavoritolibro,30,0,2,2,0.596663,0.637664,0.000486,"#ff77ff"
736319703526805505,algangui,49,1,0,1,0.357136,0.628908,0,"#ff7007"
702873572058992641,proyectoaglaya,15,0,1,1,0.556614,0.668385,0,"#008ebb"
762596447518810112,bloom0625,49,1,0,1,0.410507,0.66234,0,"#ff7007"
4774631422,MuseoMBC,58,0,2,2,0.665074,0.695179,0.000486,"#005076"
1322540947041705984,ClauuML,30,3,0,3,0.541476,0.565833,0.000973,"#ff77ff"
782860647621095424,evamaoliv,58,6,3,9,0.549195,0.560784,0.003891,"#005076"
1245978212695511040,labella_antonio,30,1,0,1,0.539363,0.620272,0,"#ff77ff"
799629835110907904,JordiAPT21,49,1,0,1,0.330197,0.613973,0,"#ff7007"
804791500664143873,PSpensiones,30,0,1,1,0.409637,0.582332,0,"#ff77ff"
777506966793052160,mexicoxsegundo,49,1,0,1,0.427041,0.689485,0,"#ff7007"
715799687605968896,HastenGroup,30,0,1,1,0.415546,0.584787,0,"#ff77ff"
795616618286092288,humanosdigitale,49,6,1,7,0.411314,0.55048,0.002918,"#ff7007"
724973454919917568,AnaCarretero37,15,0,2,2,0.584714,0.647224,0.000486,"#008ebb"
734682433413644288,pedagogiacuriel,22,0,1,1,0.581677,0.592209,0,"#00e8b2"
4491341113,victortovar56,1,0,1,1,0.435073,0.640133,0,"#b6cb00"
705857447848763392,CorunaBloggers,55,4,2,6,0.617026,0.551848,0.002432,"#cb3f32"
736999961620058113,_sophiegrimaldi,30,4,0,4,0.536118,0.560291,0.001459,"#ff77ff"
776924991619227648,oidocoruna,55,0,2,2,0.629095,0.550324,0.000486,"#cb3f32"
778209552504414208,3DYyanguas,2,0,3,3,0.673734,0.585536,0.000973,"#ffa64e"
781898002508095488,ElObservatorioD,22,0,1,1,0.578617,0.685226,0,"#00e8b2"
775725541605384192,p_indomita,30,1,0,1,0.540951,0.627225,0,"#ff77ff"
4830027369,huma_nun,49,5,0,5,0.468611,0.575148,0.001946,"#ff7007"
745862498306428928,silmendez027,2,0,2,2,0.662651,0.658809,0.000486,"#ffa64e"
798250674081398784,VCampanacho,2,0,2,2,0.672384,0.670688,0.000486,"#ffa64e"
791019037232885760,karabalgasum144,2,0,2,2,0.67817,0.658387,0.000486,"#ffa64e"
794999123611152384,Miguelgl7103,2,0,2,2,0.695028,0.637076,0.000486,"#ffa64e"
779229423149154304,jovenespuntales,30,0,2,2,0.576196,0.606148,0.000486,"#ff77ff"
707899199094964224,ProgArqDigital,30,8,7,15,0.485913,0.56153,0.006809,"#ff77ff"
796277974119092224,Ggames_group,31,0,1,1,0.673462,0.553583,0,"#3e93ff"
735503570620055552,CYCHerder,30,2,0,2,0.522434,0.651109,0.000486,"#ff77ff"
4928042417,EaD_UART,3,0,1,1,0.435944,0.646393,0,"#ffb3ff"
716807664785833984,TEDxRecoleta,49,0,1,1,0.249047,0.681608,0,"#ff7007"
783682057050460160,GladysBarrien11,49,0,1,1,0.245984,0.669459,0,"#ff7007"
789934699649044480,RevMusAntrop,30,0,2,2,0.455636,0.633605,0.000486,"#ff77ff"
4443230782,adelmagc,49,0,1,1,0.24684,0.679308,0,"#ff7007"
718074772761001985,PrensaCCCoop,49,3,0,3,0.419386,0.531848,0.000973,"#ff7007"
784536545726459904,artypens_uned,30,1,1,2,0.503952,0.596774,0.000486,"#ff77ff"
722492034515353600,Silvia_Folk,30,0,2,2,0.565436,0.564503,0.000486,"#ff77ff"
745315925113573376,ddmag_es,1,4,1,5,0.493206,0.627513,0.001946,"#b6cb00"
4505616131,davimar1307,7,0,2,2,0.402913,0.270481,0.000486,"#ffb800"
4858132510,libroensevilla,1,6,2,8,0.46352,0.630668,0.003405,"#b6cb00"
753043186587697154,AppStoreES,30,2,0,2,0.545851,0.595392,0.000486,"#ff77ff"
761425780228366336,tccsunq,49,0,1,1,0.41655,0.520517,0,"#ff7007"
778631747487592448,LuisaLoisM,30,5,1,6,0.516671,0.614116,0.002432,"#ff77ff"
778725727894052869,Ro_CLas,2,0,1,1,0.688684,0.674154,0,"#ffa64e"
739849159637893120,tek_fest,55,2,3,5,0.614601,0.549245,0.001946,"#cb3f32"
1446835175384653836,AtramH,30,1,0,1,0.440616,0.543816,0,"#ff77ff"
763348667927556096,ForgeSystem,38,0,1,1,0.629912,0.364254,0,"#662859"
730147718979584001,AngostaEditores,38,0,1,1,0.611607,0.35566,0,"#662859"
4913825430,ExpoIndiaMX,10,0,1,1,0.661803,0.810228,0,"#52d7c0"
864878781022052353,Castillo_tuiter,7,3,0,3,0.570011,0.518792,0.000973,"#ffb800"
4808605970,fermerol,7,0,2,2,0.435879,0.369794,0.000486,"#ffb800"
774360460330209280,TICEVale,7,0,4,4,0.439981,0.409397,0.001459,"#ffb800"
751708078748364800,haritonovmaria2,49,0,1,1,0.296252,0.588943,0,"#ff7007"
732925547378958341,PIAEscuela,38,1,1,2,0.588509,0.379695,0.000486,"#662859"
735049214988853248,EvaTuledoco,36,0,1,1,0.57574,0.422696,0,"#825403"
1374053055877033991,FabricaCultural,1,1,0,1,0.392455,0.53543,0,"#b6cb00"
763015357263122433,juanolo_,22,0,2,2,0.500797,0.601871,0.000486,"#00e8b2"
760356437763756032,msbercegeay,36,0,2,2,0.425716,0.508215,0.000486,"#825403"
763020221997350913,ToralVargas,12,0,2,2,0.824276,0.654608,0.000486,"#00a04a"
763019265259831296,JannyBeltranA,12,0,1,1,0.844526,0.591857,0,"#00a04a"
1303820631948099584,paau_ag,12,1,0,1,0.876292,0.510972,0,"#00a04a"
761435174148018177,Juan_Ramro,7,0,2,2,0.459672,0.403921,0.000486,"#ffb800"
4846684161,KostTa60,13,0,1,1,0.414661,0.424283,0,"#3bec00"
709432862827810816,mboschte,14,0,3,3,0.564573,0.55733,0.000973,"#00eeff"
4830847824,ceciliacirdero3,27,1,0,1,0.077756,0.671359,0,"#7e8b76"
719839363752992768,lydiagavilan,14,0,1,1,0.690426,0.576309,0,"#00eeff"
4642314976,openaccess_tp,36,0,1,1,0.409541,0.578158,0,"#825403"
700387969908101120,ElCiudadanoCdMx,7,1,0,1,0.403603,0.209896,0,"#ffb800"
4314948922,SoyEficazz,13,0,1,1,0.437135,0.344148,0,"#3bec00"
745972119113207808,martab_lib,14,0,4,4,0.483938,0.544883,0.001459,"#00eeff"
1358554256383627267,akatoxkatl,13,11,0,11,0.472967,0.45338,0.004864,"#3bec00"
725734388521144324,karins42,36,0,1,1,0.427332,0.591214,0,"#825403"
747474927759007745,e_LITEMAD,37,2,3,5,0.540749,0.722356,0.001946,"#006032"
937997865418358784,SilviaEGT,13,30,0,30,0.478216,0.474244,0.014105,"#3bec00"
4826062843,Silviaperezsali,7,0,2,2,0.384413,0.358004,0.000486,"#ffb800"
733313242890543104,fercasmx,7,0,2,2,0.389603,0.346652,0.000486,"#ffb800"
729776611265024000,lourdes73284785,7,0,2,2,0.386056,0.353106,0.000486,"#ffb800"
740013809620787200,PutlaGobMx,7,0,2,2,0.385581,0.351098,0.000486,"#ffb800"
738041558591639552,brokenenglishsi,30,0,2,2,0.434092,0.48238,0.000486,"#ff77ff"
4454417472,johanao06624754,49,0,3,3,0.732936,0.74867,0.000973,"#ff7007"
4572212902,novembermara,30,0,1,1,0.491317,0.636479,0,"#ff77ff"
823187349228154881,UAB_info,14,12,0,12,0.567263,0.542651,0.00535,"#00eeff"
700489489584562176,SocArgLing,49,0,4,4,0.47465,0.543563,0.001459,"#ff7007"
721672405463277572,unitotcat,14,0,1,1,0.648037,0.569774,0,"#00eeff"
700449779965435905,Museosconvida,49,0,1,1,0.487713,0.687914,0,"#ff7007"
4871194606,sofistaserfista,49,0,1,1,0.290018,0.596371,0,"#ff7007"
4647323446,UC3M_Business,37,0,1,1,0.665196,0.605803,0,"#006032"
896724917458272256,urosarionews,34,1,0,1,0.662426,0.308838,0,"#ff0d69"
4382400921,AlbEsquivel,36,0,1,1,0.43534,0.593509,0,"#825403"
1252642134714388480,UnRosario,49,3,0,3,0.449887,0.576037,0.000973,"#ff7007"
4758901641,ariboumarco,30,0,3,3,0.472216,0.469252,0.000973,"#ff77ff"
718486553333473281,noeliawebsoc,49,0,1,1,0.433007,0.625124,0,"#ff7007"
703999276393893888,dge_fcd,31,0,2,2,0.623934,0.526091,0.000486,"#3e93ff"
716298254925840384,dewildeliliana,49,0,1,1,0.429778,0.626413,0,"#ff7007"
4861231253,ReyMariajesus,30,0,1,1,0.586224,0.679451,0,"#ff77ff"
708079444599111680,grabiluc,49,0,1,1,0.426821,0.627135,0,"#ff7007"
4614161794,AndersCamin,0,0,2,2,0.579424,0.649772,0.000486,"#8ecfec"
4334572235,MesaDomingo,31,0,1,1,0.65171,0.599224,0,"#3e93ff"
711960900190785537,GeneracionCode,30,0,3,3,0.540641,0.539024,0.000973,"#ff77ff"
4847165937,SolerCremades,31,0,3,3,0.620509,0.559626,0.000973,"#3e93ff"
4748380119,digitalario,30,2,1,3,0.539169,0.517369,0.000973,"#ff77ff"
4910006211,aliciatsanchez8,8,0,1,1,0.520855,0.810816,0,"#00ed5d"
4913083228,CUdigitalnet,36,0,1,1,0.40866,0.578035,0,"#825403"
4787023593,TEOYDA_IHCM,19,0,1,1,0.660971,0.633657,0,"#00d3ff"
826184672384200704,Joven_y_Alocada,34,1,0,1,0.357379,0.520661,0,"#ff0d69"
4508442794,BordovskyM,30,0,1,1,0.517053,0.637416,0,"#ff77ff"
710106109676281857,epfldh,36,0,2,2,0.431852,0.499747,0.000486,"#825403"
4874219339,frisco_man,19,0,3,3,0.594206,0.581667,0.000973,"#00d3ff"
4859911738,MScDataScience,22,0,1,1,0.329439,0.583318,0,"#00e8b2"
4830827233,dhwg_tamu,13,0,4,4,0.448233,0.445252,0.001459,"#3bec00"
704393516869287936,EdulabIlce,3,0,6,6,0.466137,0.56809,0.002432,"#ffb3ff"
4747654239,Eva_cosmopolita,15,0,2,2,0.558217,0.559629,0.000486,"#008ebb"
699773353033203712,ebautistri,7,0,2,2,0.42486,0.366907,0.000486,"#ffb800"
4892407864,RankingUnis,30,0,1,1,0.517522,0.633473,0,"#ff77ff"
4527152596,SchulbaumO,14,11,1,12,0.60528,0.456905,0.00535,"#00eeff"
4872057309,t4networking,14,0,2,2,0.683197,0.741786,0.000486,"#00eeff"
4895661975,make_theway,31,0,1,1,0.679266,0.501572,0,"#3e93ff"
4474760415,JA_Mondejar,15,0,1,1,0.581267,0.709774,0,"#008ebb"
4923953953,stewartbbrand,3,6,0,6,0.452917,0.56591,0.002432,"#ffb3ff"
4851787154,CSAAustralasia,36,0,1,1,0.401526,0.476807,0,"#825403"
4502751255,AiroaChantada,14,0,1,1,0.682985,0.508021,0,"#00eeff"
4675509422,AnnaMOr17,7,0,2,2,0.586218,0.544741,0.000486,"#ffb800"
4625474429,Ana_Gea_Sanchez,1,0,1,1,0.485747,0.680546,0,"#b6cb00"
4511502134,mr_ruperez,30,0,1,1,0.525681,0.635176,0,"#ff77ff"
4342037242,uvic_diversity,14,2,1,3,0.54144,0.570954,0.000973,"#00eeff"
1235649794221264897,FGSole,3,1,0,1,0.519268,0.665954,0,"#ffb3ff"
4421838020,preguntasfre,13,0,1,1,0.530063,0.409142,0,"#3bec00"
840171313608183809,univpompeufabra,34,1,0,1,0.328011,0.528496,0,"#ff0d69"
1162093568682582017,HelyanaChirinos,22,1,0,1,0.667371,0.605737,0,"#00e8b2"
867099356876472320,UISenlinea,34,1,0,1,0.648595,0.170001,0,"#ff0d69"
832939472564031488,gisela_pda,13,1,0,1,0.374817,0.389595,0,"#3bec00"
4873919206,gustavo_parada,13,1,0,1,0.584619,0.431438,0,"#3bec00"
1308368152263360512,losmirones,49,1,0,1,0.252235,0.638641,0,"#ff7007"
1063298192878592000,sima_garcia,0,2,0,2,0.565919,0.56113,0.000486,"#8ecfec"
799557600564150272,InstitutF,30,8,0,8,0.514284,0.580419,0.003405,"#ff77ff"
1137786673943605248,theprcoach,22,1,0,1,0.626572,0.612073,0,"#00e8b2"
840203622105378816,MaritzaEstrell1,22,1,0,1,0.755349,0.554119,0,"#00e8b2"
1374062819755257858,fer76,30,1,0,1,0.714551,0.64455,0,"#ff77ff"
855506065957560321,AntonioCruces4,14,4,0,4,0.561726,0.504131,0.001459,"#00eeff"
